PokerStars Hand #223356478629:  Hold'em No Limit ($0.25/$0.50 USD) - 2021/02/02 17:36:14 ET
Table 'Olbersia IV' 6-max Seat #5 is the button
Seat 1: KingHighBluf ($44.09 in chips)
Seat 2: DUICA611 ($53.70 in chips)
Seat 4: rand81 ($131.60 in chips)
Seat 5: gorgia61 ($75.81 in chips)
KingHighBluf: posts small blind $0.25
DUICA611: posts big blind $0.50
*** HOLE CARDS ***
ArcticBearDK joins the table at seat #6
rand81: folds
gorgia61: raises $0.75 to $1.25
KingHighBluf: raises $3 to $4.25
DUICA611: folds
gorgia61: calls $3
*** FLOP *** [7s 5h Kd]
KingHighBluf: bets $4.36
gorgia61: calls $4.36
*** TURN *** [7s 5h Kd] [Qs]
KingHighBluf: checks
gorgia61: checks
*** RIVER *** [7s 5h Kd Qs] [9s]
KingHighBluf: checks
gorgia61: bets $12.73
KingHighBluf: calls $12.73
*** SHOW DOWN ***
gorgia61: shows [Ks Js] (a flush, King high)
KingHighBluf: mucks hand
gorgia61 collected $42.43 from pot
*** SUMMARY ***
Total pot $43.18 | Rake $0.75
Board [7s 5h Kd Qs 9s]
Seat 1: KingHighBluf (small blind) mucked
Seat 2: DUICA611 (big blind) folded before Flop
Seat 4: rand81 folded before Flop (didn't bet)
Seat 5: gorgia61 (button) showed [Ks Js] and won ($42.43) with a flush, King high


PokerStars Hand #223356573955:  Hold'em No Limit ($0.25/$0.50 USD) - 2021/02/02 17:38:40 ET
Table 'Olbersia IV' 6-max Seat #5 is the button
Seat 1: KingHighBluf ($24.86 in chips)
Seat 2: DUICA611 ($52.95 in chips)
Seat 4: rand81 ($130.85 in chips)
Seat 5: gorgia61 ($92.65 in chips)
Seat 6: ArcticBearDK ($52.70 in chips)
ArcticBearDK: posts small blind $0.25
KingHighBluf: posts big blind $0.50
*** HOLE CARDS ***
DUICA611: raises $0.75 to $1.25
rand81: folds
gorgia61: folds
ArcticBearDK: folds
KingHighBluf: calls $0.75
*** FLOP *** [6h Jc 2d]
KingHighBluf: checks
DUICA611: bets $0.86
KingHighBluf: calls $0.86
*** TURN *** [6h Jc 2d] [Qc]
KingHighBluf: checks
DUICA611: checks
*** RIVER *** [6h Jc 2d Qc] [5h]
KingHighBluf: checks
DUICA611: bets $2.13
KingHighBluf: calls $2.13
*** SHOW DOWN ***
DUICA611: shows [Th Qh] (a pair of Queens)
KingHighBluf: mucks hand
DUICA611 collected $8.29 from pot
*** SUMMARY ***
Total pot $8.73 | Rake $0.44
Board [6h Jc 2d Qc 5h]
Seat 1: KingHighBluf (big blind) mucked
Seat 2: DUICA611 showed [Th Qh] and won ($8.29) with a pair of Queens
Seat 4: rand81 folded before Flop (didn't bet)
Seat 5: gorgia61 (button) folded before Flop (didn't bet)
Seat 6: ArcticBearDK (small blind) folded before Flop


PokerStars Hand #225215718074:  Hold'em No Limit ($0.25/$0.50 USD) - 2021/03/26 19:05:50 ET
Table 'Naef VI' 6-max Seat #6 is the button
Seat 1: Little_Twin7 ($30.05 in chips)
Seat 2: wanax777 ($54.50 in chips)
Seat 4: WINDTOY ($79.02 in chips)
Seat 5: Jskodronnie ($52.02 in chips)
Seat 6: kfcsekirata ($52.60 in chips)
Little_Twin7: posts small blind $0.25
wanax777: posts big blind $0.50
ArcticBearDK: sits out
*** HOLE CARDS ***
WINDTOY: folds
Jskodronnie: folds
kfcsekirata: raises $0.75 to $1.25
Little_Twin7: folds
wanax777: calls $0.75
*** FLOP *** [Js Qd Ts]
wanax777: checks
kfcsekirata: checks
*** TURN *** [Js Qd Ts] [Ac]
wanax777: checks
kfcsekirata: checks
*** RIVER *** [Js Qd Ts Ac] [5s]
wanax777: bets $1.07
kfcsekirata: calls $1.07
*** SHOW DOWN ***
wanax777: shows [8c Tc] (a pair of Tens)
kfcsekirata: shows [Ah 7d] (a pair of Aces)
kfcsekirata collected $4.65 from pot
*** SUMMARY ***
Total pot $4.89 | Rake $0.24
Board [Js Qd Ts Ac 5s]
Seat 1: Little_Twin7 (small blind) folded before Flop
Seat 2: wanax777 (big blind) showed [8c Tc] and lost with a pair of Tens
Seat 4: WINDTOY folded before Flop (didn't bet)
Seat 5: Jskodronnie folded before Flop (didn't bet)
Seat 6: kfcsekirata (button) showed [Ah 7d] and won ($4.65) with a pair of Aces


PokerStars Hand #225215770246:  Hold'em No Limit ($0.25/$0.50 USD) - 2021/03/26 19:07:18 ET
Table 'Naef VI' 6-max Seat #2 is the button
Seat 1: Little_Twin7 ($35.05 in chips)
Seat 2: wanax777 ($51.93 in chips)
Seat 3: ArcticBearDK ($50 in chips)
Seat 4: WINDTOY ($79.02 in chips)
Seat 5: Jskodronnie ($50 in chips)
Seat 6: kfcsekirata ($54.93 in chips)
ArcticBearDK: posts small blind $0.25
WINDTOY: posts big blind $0.50
*** HOLE CARDS ***
Jskodronnie: folds
kfcsekirata: folds
Little_Twin7: calls $0.50
wanax777: raises $1.50 to $2
ArcticBearDK: folds
WINDTOY: calls $1.50
Little_Twin7: calls $1.50
*** FLOP *** [5s Kd Ac]
WINDTOY: checks
Little_Twin7: checks
wanax777: checks
*** TURN *** [5s Kd Ac] [7d]
WINDTOY: checks
Little_Twin7: bets $1.97
wanax777: folds
WINDTOY: calls $1.97
*** RIVER *** [5s Kd Ac 7d] [Ks]
WINDTOY: checks
Little_Twin7: checks
*** SHOW DOWN ***
WINDTOY: shows [As Td] (two pair, Aces and Kings)
Little_Twin7: mucks hand
WINDTOY collected $9.68 from pot
*** SUMMARY ***
Total pot $10.19 | Rake $0.51
Board [5s Kd Ac 7d Ks]
Seat 1: Little_Twin7 mucked
Seat 2: wanax777 (button) folded on the Turn
Seat 3: ArcticBearDK (small blind) folded before Flop
Seat 4: WINDTOY (big blind) showed [As Td] and won ($9.68) with two pair, Aces and Kings
Seat 5: Jskodronnie folded before Flop (didn't bet)
Seat 6: kfcsekirata folded before Flop (didn't bet)


PokerStars Hand #225215807558:  Hold'em No Limit ($0.25/$0.50 USD) - 2021/03/26 19:08:16 ET
Table 'Naef VI' 6-max Seat #3 is the button
Seat 1: Little_Twin7 ($31.08 in chips)
Seat 2: wanax777 ($49.93 in chips)
Seat 3: ArcticBearDK ($50 in chips)
Seat 4: WINDTOY ($84.73 in chips)
Seat 5: Jskodronnie ($50 in chips)
Seat 6: kfcsekirata ($54.93 in chips)
WINDTOY: posts small blind $0.25
Jskodronnie: posts big blind $0.50
*** HOLE CARDS ***
kfcsekirata: folds
Little_Twin7: calls $0.50
wanax777: folds
ArcticBearDK: folds
WINDTOY: folds
Jskodronnie: raises $2 to $2.50
Little_Twin7: calls $2
*** FLOP *** [As 9s 8h]
Jskodronnie: checks
Little_Twin7: bets $1.49
Jskodronnie: calls $1.49
*** TURN *** [As 9s 8h] [Jc]
Jskodronnie: checks
Little_Twin7: bets $2.50
Jskodronnie: calls $2.50
*** RIVER *** [As 9s 8h Jc] [Ts]
Jskodronnie: checks
Little_Twin7: checks
*** SHOW DOWN ***
Jskodronnie: shows [Qc Qd] (a straight, Eight to Queen)
Little_Twin7: mucks hand
Jskodronnie collected $12.57 from pot
*** SUMMARY ***
Total pot $13.23 | Rake $0.66
Board [As 9s 8h Jc Ts]
Seat 1: Little_Twin7 mucked
Seat 2: wanax777 folded before Flop (didn't bet)
Seat 3: ArcticBearDK (button) folded before Flop (didn't bet)
Seat 4: WINDTOY (small blind) folded before Flop
Seat 5: Jskodronnie (big blind) showed [Qc Qd] and won ($12.57) with a straight, Eight to Queen
Seat 6: kfcsekirata folded before Flop (didn't bet)


PokerStars Hand #225216139499:  Hold'em No Limit ($0.25/$0.50 USD) - 2021/03/26 19:17:33 ET
Table 'Naef VI' 6-max Seat #4 is the button
Seat 1: Little_Twin7 ($49.01 in chips)
Seat 2: wanax777 ($55.61 in chips)
Seat 3: ArcticBearDK ($50.35 in chips)
Seat 4: WINDTOY ($77.73 in chips)
Seat 5: Jskodronnie ($50 in chips)
Seat 6: kfcsekirata ($50 in chips)
Jskodronnie: posts small blind $0.25
kfcsekirata: posts big blind $0.50
*** HOLE CARDS ***
Little_Twin7: calls $0.50
wanax777: folds
ArcticBearDK: raises $1.50 to $2
WINDTOY: folds
Jskodronnie: folds
kfcsekirata: folds
Little_Twin7: calls $1.50
*** FLOP *** [5d Ts 2s]
Little_Twin7: checks
ArcticBearDK: checks
*** TURN *** [5d Ts 2s] [3c]
Little_Twin7: checks
ArcticBearDK: bets $2
Little_Twin7: calls $2
*** RIVER *** [5d Ts 2s 3c] [As]
Little_Twin7: checks
ArcticBearDK: checks
*** SHOW DOWN ***
Little_Twin7: shows [7h 6h] (high card Ace)
ArcticBearDK: shows [Js Ac] (a pair of Aces)
ArcticBearDK collected $8.31 from pot
*** SUMMARY ***
Total pot $8.75 | Rake $0.44
Board [5d Ts 2s 3c As]
Seat 1: Little_Twin7 showed [7h 6h] and lost with high card Ace
Seat 2: wanax777 folded before Flop (didn't bet)
Seat 3: ArcticBearDK showed [Js Ac] and won ($8.31) with a pair of Aces
Seat 4: WINDTOY (button) folded before Flop (didn't bet)
Seat 5: Jskodronnie (small blind) folded before Flop
Seat 6: kfcsekirata (big blind) folded before Flop


PokerStars Hand #225216209782:  Hold'em No Limit ($0.25/$0.50 USD) - 2021/03/26 19:19:21 ET
Table 'Naef VI' 6-max Seat #1 is the button
Seat 1: Little_Twin7 ($44.26 in chips)
Seat 2: wanax777 ($56.97 in chips)
Seat 3: ArcticBearDK ($53.16 in chips)
Seat 4: WINDTOY ($79.98 in chips)
Seat 5: Jskodronnie ($50 in chips)
Seat 6: kfcsekirata ($50 in chips)
wanax777: posts small blind $0.25
ArcticBearDK: posts big blind $0.50
*** HOLE CARDS ***
WINDTOY: raises $0.75 to $1.25
Jskodronnie: folds
kfcsekirata: folds
Little_Twin7: folds
wanax777: folds
ArcticBearDK: calls $0.75
*** FLOP *** [Kh 6h Qh]
ArcticBearDK: checks
WINDTOY: bets $0.86
ArcticBearDK: calls $0.86
*** TURN *** [Kh 6h Qh] [9h]
ArcticBearDK: checks
WINDTOY: checks
*** RIVER *** [Kh 6h Qh 9h] [Th]
ArcticBearDK: checks
WINDTOY: checks
*** SHOW DOWN ***
ArcticBearDK: shows [Qc Kd] (a flush, King high)
WINDTOY: shows [Tc Kc] (a flush, King high)
ArcticBearDK collected $2.13 from pot
WINDTOY collected $2.12 from pot
*** SUMMARY ***
Total pot $4.47 | Rake $0.22
Board [Kh 6h Qh 9h Th]
Seat 1: Little_Twin7 (button) folded before Flop (didn't bet)
Seat 2: wanax777 (small blind) folded before Flop
Seat 3: ArcticBearDK (big blind) showed [Qc Kd] and won ($2.13) with a flush, King high
Seat 4: WINDTOY showed [Tc Kc] and won ($2.12) with a flush, King high
Seat 5: Jskodronnie folded before Flop (didn't bet)
Seat 6: kfcsekirata folded before Flop (didn't bet)


PokerStars Hand #225216253703:  Hold'em No Limit ($0.25/$0.50 USD) - 2021/03/26 19:20:39 ET
Table 'Naef VI' 6-max Seat #4 is the button
Seat 1: Little_Twin7 ($45.01 in chips)
Seat 2: wanax777 ($56.72 in chips)
Seat 3: ArcticBearDK ($52.93 in chips)
Seat 4: WINDTOY ($79.24 in chips)
Seat 5: Jskodronnie ($50.25 in chips)
Seat 6: kfcsekirata ($50 in chips)
Jskodronnie: posts small blind $0.25
kfcsekirata: posts big blind $0.50
*** HOLE CARDS ***
Little_Twin7: calls $0.50
wanax777: folds
ArcticBearDK: folds
WINDTOY: folds
Jskodronnie: folds
kfcsekirata: checks
*** FLOP *** [Qs Td 9h]
kfcsekirata: checks
Little_Twin7: checks
*** TURN *** [Qs Td 9h] [2s]
kfcsekirata: checks
Little_Twin7: checks
*** RIVER *** [Qs Td 9h 2s] [Jh]
kfcsekirata: checks
Little_Twin7: checks
*** SHOW DOWN ***
kfcsekirata: shows [2d 6c] (a pair of Deuces)
Little_Twin7: mucks hand
kfcsekirata collected $1.19 from pot
*** SUMMARY ***
Total pot $1.25 | Rake $0.06
Board [Qs Td 9h 2s Jh]
Seat 1: Little_Twin7 mucked
Seat 2: wanax777 folded before Flop (didn't bet)
Seat 3: ArcticBearDK folded before Flop (didn't bet)
Seat 4: WINDTOY (button) folded before Flop (didn't bet)
Seat 5: Jskodronnie (small blind) folded before Flop
Seat 6: kfcsekirata (big blind) showed [2d 6c] and won ($1.19) with a pair of Deuces


PokerStars Hand #225216289065:  Hold'em No Limit ($0.25/$0.50 USD) - 2021/03/26 19:21:43 ET
Table 'Naef VI' 6-max Seat #1 is the button
Seat 1: Little_Twin7 ($44.51 in chips)
Seat 2: wanax777 ($56.22 in chips)
Seat 4: WINDTOY ($74.74 in chips)
Seat 5: Jskodronnie ($50 in chips)
Seat 6: kfcsekirata ($50.44 in chips)
wanax777: posts small blind $0.25
ArcticBearDK: is sitting out
ArcticBearDK leaves the table
WINDTOY: posts big blind $0.50
*** HOLE CARDS ***
Jskodronnie: folds
kfcsekirata: folds
Ma1n1 joins the table at seat #3
Little_Twin7: calls $0.50
wanax777: folds
WINDTOY: checks
*** FLOP *** [9s 2d 2c]
WINDTOY: checks
Little_Twin7: checks
*** TURN *** [9s 2d 2c] [9d]
WINDTOY: checks
Little_Twin7: checks
*** RIVER *** [9s 2d 2c 9d] [Jd]
WINDTOY: checks
Little_Twin7: checks
*** SHOW DOWN ***
WINDTOY: shows [4h 7s] (two pair, Nines and Deuces)
Little_Twin7: shows [4s 5c] (two pair, Nines and Deuces)
WINDTOY collected $0.60 from pot
Little_Twin7 collected $0.59 from pot
*** SUMMARY ***
Total pot $1.25 | Rake $0.06
Board [9s 2d 2c 9d Jd]
Seat 1: Little_Twin7 (button) showed [4s 5c] and won ($0.59) with two pair, Nines and Deuces
Seat 2: wanax777 (small blind) folded before Flop
Seat 4: WINDTOY (big blind) showed [4h 7s] and won ($0.60) with two pair, Nines and Deuces
Seat 5: Jskodronnie folded before Flop (didn't bet)
Seat 6: kfcsekirata folded before Flop (didn't bet)


PokerStars Hand #223556832450:  Hold'em No Limit ($0.25/$0.50 USD) - 2021/02/07 18:58:22 ET
Table 'Galilea IV' 6-max Seat #1 is the button
Seat 1: shameShamee ($52.75 in chips)
Seat 2: sarcasmpoker ($118.34 in chips)
Seat 3: Laziness[Ru] ($51.75 in chips)
Seat 4: albertt2 ($112.12 in chips)
Seat 5: Rocbis ($62.96 in chips)
sarcasmpoker: posts small blind $0.25
Laziness[Ru]: posts big blind $0.50
ArcticBearDK: sits out
*** HOLE CARDS ***
albertt2: calls $0.50
Rocbis: folds
shameShamee: folds
sarcasmpoker: folds
Laziness[Ru]: checks
*** FLOP *** [2s 7h Kd]
Laziness[Ru]: checks
albertt2: checks
*** TURN *** [2s 7h Kd] [Js]
Laziness[Ru]: checks
albertt2: checks
*** RIVER *** [2s 7h Kd Js] [6s]
Laziness[Ru]: checks
albertt2: checks
*** SHOW DOWN ***
Laziness[Ru]: shows [As 4c] (high card Ace)
albertt2: shows [5c Ah] (high card Ace)
Laziness[Ru] collected $0.60 from pot
albertt2 collected $0.59 from pot
*** SUMMARY ***
Total pot $1.25 | Rake $0.06
Board [2s 7h Kd Js 6s]
Seat 1: shameShamee (button) folded before Flop (didn't bet)
Seat 2: sarcasmpoker (small blind) folded before Flop
Seat 3: Laziness[Ru] (big blind) showed [As 4c] and won ($0.60) with high card Ace
Seat 4: albertt2 showed [5c Ah] and won ($0.59) with high card Ace
Seat 5: Rocbis folded before Flop (didn't bet)


PokerStars Hand #214647477577:  Hold'em No Limit ($0.25/$0.50 USD) - 2020/05/29 20:50:22 ET
Table 'Ostenia V' 6-max Seat #1 is the button
Seat 1: krilli85 ($38.42 in chips)
Seat 3: Maxi Goldman ($155.63 in chips)
Seat 4: ArcticBearDK ($50 in chips)
Seat 5: YarlJamal ($59.58 in chips)
Maxi Goldman: posts small blind $0.25
ArcticBearDK: posts big blind $0.50
*** HOLE CARDS ***
YarlJamal: folds
krilli85: raises $1 to $1.50
Ma1n1 joins the table at seat #2
Maxi Goldman: raises $2.50 to $4
ArcticBearDK: folds
krilli85: calls $2.50
*** FLOP *** [7c Qs 5s]
Maxi Goldman: bets $8.48
krilli85: raises $25.94 to $34.42 and is all-in
Maxi Goldman: calls $25.94
*** TURN *** [7c Qs 5s] [9s]
*** RIVER *** [7c Qs 5s 9s] [4d]
*** SHOW DOWN ***
Maxi Goldman: shows [Qd Ks] (a pair of Queens)
krilli85: shows [Jc Ad] (high card Ace)
Maxi Goldman collected $76.59 from pot
krilli85 cashed out the hand for $9.19 | Cash Out Fee $0.09
*** SUMMARY ***
Total pot $77.34 | Rake $0.75
Board [7c Qs 5s 9s 4d]
Seat 1: krilli85 (button) showed [Jc Ad] and lost with high card Ace (cashed out).
Seat 3: Maxi Goldman (small blind) showed [Qd Ks] and won ($76.59) with a pair of Queens
Seat 4: ArcticBearDK (big blind) folded before Flop
Seat 5: YarlJamal folded before Flop (didn't bet)


PokerStars Hand #214647524301:  Hold'em No Limit ($0.25/$0.50 USD) - 2020/05/29 20:51:48 ET
Table 'Ostenia V' 6-max Seat #4 is the button
Seat 1: krilli85 ($9.94 in chips)
Seat 3: Maxi Goldman ($193.80 in chips)
Seat 4: ArcticBearDK ($50 in chips)
Seat 5: YarlJamal ($59.08 in chips)
YarlJamal: posts small blind $0.25
krilli85: posts big blind $0.50
Ma1n1: sits out
*** HOLE CARDS ***
Maxi Goldman: folds
ArcticBearDK: raises $1 to $1.50
YarlJamal: folds
krilli85: raises $1 to $2.50
ArcticBearDK: raises $2.35 to $4.85
krilli85: calls $2.35
*** FLOP *** [Kc 3s Kd]
krilli85: bets $5.09 and is all-in
ArcticBearDK: calls $5.09
*** TURN *** [Kc 3s Kd] [9c]
*** RIVER *** [Kc 3s Kd 9c] [3h]
*** SHOW DOWN ***
krilli85: shows [As 3d] (a full house, Threes full of Kings)
ArcticBearDK: shows [6c Ah] (two pair, Kings and Threes)
krilli85 collected $19.38 from pot
*** SUMMARY ***
Total pot $20.13 | Rake $0.75
Board [Kc 3s Kd 9c 3h]
Seat 1: krilli85 (big blind) showed [As 3d] and won ($19.38) with a full house, Threes full of Kings
Seat 3: Maxi Goldman folded before Flop (didn't bet)
Seat 4: ArcticBearDK (button) showed [6c Ah] and lost with two pair, Kings and Threes
Seat 5: YarlJamal (small blind) folded before Flop


PokerStars Hand #214647600853:  Hold'em No Limit ($0.25/$0.50 USD) - 2020/05/29 20:54:08 ET
Table 'Ostenia V' 6-max Seat #4 is the button
Seat 1: krilli85 ($19.13 in chips)
Seat 2: Ma1n1 ($50 in chips)
Seat 3: Maxi Goldman ($189.90 in chips)
Seat 4: ArcticBearDK ($51.75 in chips)
Seat 5: YarlJamal ($61.65 in chips)
Seat 6: Ext.HuliGan ($50 in chips)
YarlJamal: posts small blind $0.25
Ext.HuliGan: posts big blind $0.50
*** HOLE CARDS ***
krilli85: raises $0.50 to $1
Ma1n1: folds
Maxi Goldman: folds
ArcticBearDK: folds
YarlJamal: calls $0.75
Ext.HuliGan: calls $0.50
*** FLOP *** [8c 6s 8d]
YarlJamal: checks
Ext.HuliGan: bets $1.85
krilli85: raises $1.85 to $3.70
YarlJamal: folds
Ext.HuliGan: calls $1.85
*** TURN *** [8c 6s 8d] [5c]
Ext.HuliGan: checks
krilli85: checks
*** RIVER *** [8c 6s 8d 5c] [9s]
Ext.HuliGan: bets $6.52
krilli85: calls $6.52
*** SHOW DOWN ***
Ext.HuliGan: shows [9d 9c] (a full house, Nines full of Eights)
krilli85: mucks hand
Ext.HuliGan collected $22.27 from pot
*** SUMMARY ***
Total pot $23.44 | Rake $1.17
Board [8c 6s 8d 5c 9s]
Seat 1: krilli85 mucked
Seat 2: Ma1n1 folded before Flop (didn't bet)
Seat 3: Maxi Goldman folded before Flop (didn't bet)
Seat 4: ArcticBearDK (button) folded before Flop (didn't bet)
Seat 5: YarlJamal (small blind) folded on the Flop
Seat 6: Ext.HuliGan (big blind) showed [9d 9c] and won ($22.27) with a full house, Nines full of Eights


PokerStars Hand #214647650355:  Hold'em No Limit ($0.25/$0.50 USD) - 2020/05/29 20:55:50 ET
Table 'Ostenia V' 6-max Seat #6 is the button
Seat 1: krilli85 ($9.95 in chips)
Seat 2: Ma1n1 ($50 in chips)
Seat 3: Maxi Goldman ($189.90 in chips)
Seat 4: ArcticBearDK ($51.75 in chips)
Seat 5: YarlJamal ($58.65 in chips)
Seat 6: Ext.HuliGan ($60.80 in chips)
krilli85: posts small blind $0.25
Ma1n1: posts big blind $0.50
*** HOLE CARDS ***
Maxi Goldman: folds
ArcticBearDK: folds
YarlJamal: raises $0.50 to $1
Ext.HuliGan: folds
krilli85: calls $0.75
Ma1n1: calls $0.50
*** FLOP *** [Ts 8d Kh]
krilli85: bets $8.95 and is all-in
Ma1n1: folds
YarlJamal: calls $8.95
*** TURN *** [Ts 8d Kh] [Ah]
*** RIVER *** [Ts 8d Kh Ah] [Kc]
*** SHOW DOWN ***
krilli85: shows [4s 9s] (a pair of Kings)
YarlJamal: shows [9d Th] (two pair, Kings and Tens)
YarlJamal collected $19.86 from pot
*** SUMMARY ***
Total pot $20.90 | Rake $1.04
Board [Ts 8d Kh Ah Kc]
Seat 1: krilli85 (small blind) showed [4s 9s] and lost with a pair of Kings
Seat 2: Ma1n1 (big blind) folded on the Flop
Seat 3: Maxi Goldman folded before Flop (didn't bet)
Seat 4: ArcticBearDK folded before Flop (didn't bet)
Seat 5: YarlJamal showed [9d Th] and won ($19.86) with two pair, Kings and Tens
Seat 6: Ext.HuliGan (button) folded before Flop (didn't bet)


PokerStars Hand #214647679206:  Hold'em No Limit ($0.25/$0.50 USD) - 2020/05/29 20:56:58 ET
Table 'Ostenia V' 6-max Seat #2 is the button
Seat 2: Ma1n1 ($50 in chips)
Seat 3: Maxi Goldman ($189.90 in chips)
Seat 4: ArcticBearDK ($51.75 in chips)
Seat 5: YarlJamal ($68.56 in chips)
Seat 6: Ext.HuliGan ($60.80 in chips)
Maxi Goldman: posts small blind $0.25
ArcticBearDK: posts big blind $0.50
*** HOLE CARDS ***
YarlJamal: raises $0.50 to $1
Ext.HuliGan: folds
Ma1n1: folds
Maxi Goldman: folds
ArcticBearDK: calls $0.50
*** FLOP *** [8c 4c 9d]
krilli85 leaves the table
ArcticBearDK: checks
Ma1n1 leaves the table
YarlJamal: checks
*** TURN *** [8c 4c 9d] [3c]
ArcticBearDK: checks
YarlJamal: checks
*** RIVER *** [8c 4c 9d 3c] [Ah]
Ext.HuliGan leaves the table
ArcticBearDK: checks
YarlJamal: checks
*** SHOW DOWN ***
ArcticBearDK: shows [5d Qd] (high card Ace)
YarlJamal: shows [Jh Ks] (high card Ace - King kicker)
YarlJamal collected $2.14 from pot
*** SUMMARY ***
Total pot $2.25 | Rake $0.11
Board [8c 4c 9d 3c Ah]
Seat 2: Ma1n1 (button) folded before Flop (didn't bet)
Seat 3: Maxi Goldman (small blind) folded before Flop
Seat 4: ArcticBearDK (big blind) showed [5d Qd] and lost with high card Ace
Seat 5: YarlJamal showed [Jh Ks] and won ($2.14) with high card Ace
Seat 6: Ext.HuliGan folded before Flop (didn't bet)


PokerStars Hand #214649003729:  Hold'em No Limit ($0.25/$0.50 USD) - 2020/05/29 21:36:44 ET
Table 'Ostenia V' 6-max Seat #5 is the button
Seat 1: Ma1n1 ($50 in chips)
Seat 2: tilttea ($111.19 in chips)
Seat 3: OF22527 ($24.74 in chips)
Seat 4: Jampera12 ($53.75 in chips)
Seat 5: ArcticBearDK ($57.53 in chips)
Seat 6: ThoSanSuTu ($50.69 in chips)
ThoSanSuTu: posts small blind $0.25
Ma1n1: posts big blind $0.50
*** HOLE CARDS ***
tilttea: folds
OF22527: calls $0.50
Jampera12: calls $0.50
ArcticBearDK: raises $2.25 to $2.75
ThoSanSuTu: folds
Ma1n1: folds
OF22527: calls $2.25
Jampera12: raises $2.25 to $5
ArcticBearDK: raises $7 to $12
OF22527: folds
Jampera12: calls $7
*** FLOP *** [2c Td 5d]
Jampera12: checks
ArcticBearDK: bets $9
Jampera12: calls $9
*** TURN *** [2c Td 5d] [Ah]
Jampera12: bets $32.75 and is all-in
ArcticBearDK: calls $32.75
*** RIVER *** [2c Td 5d Ah] [2d]
*** SHOW DOWN ***
Jampera12: shows [5h 8s] (two pair, Fives and Deuces)
ArcticBearDK: shows [Ac Ad] (a full house, Aces full of Deuces)
ArcticBearDK collected $109 from pot
*** SUMMARY ***
Total pot $111 | Rake $2
Board [2c Td 5d Ah 2d]
Seat 1: Ma1n1 (big blind) folded before Flop
Seat 2: tilttea folded before Flop (didn't bet)
Seat 3: OF22527 folded before Flop
Seat 4: Jampera12 showed [5h 8s] and lost with two pair, Fives and Deuces
Seat 5: ArcticBearDK (button) showed [Ac Ad] and won ($109) with a full house, Aces full of Deuces
Seat 6: ThoSanSuTu (small blind) folded before Flop


PokerStars Hand #220357033433:  Hold'em No Limit ($0.25/$0.50 USD) - 2020/11/13 15:38:51 ET
Table 'Wisibada III' 6-max Seat #6 is the button
Seat 1: juancho0007 ($53.38 in chips)
Seat 2: p0kernepro ($52.39 in chips)
Seat 4: Soulfrozz ($52.88 in chips)
Seat 5: HerneTheHunter ($27.08 in chips)
Seat 6: Furbzzzzz ($50.75 in chips)
juancho0007: posts small blind $0.25
p0kernepro: posts big blind $0.50
ArcticBearDK: sits out
*** HOLE CARDS ***
Soulfrozz: folds
HerneTheHunter: folds
Furbzzzzz: raises $0.75 to $1.25
juancho0007: folds
p0kernepro: calls $0.75
*** FLOP *** [6d As 4c]
p0kernepro: checks
Furbzzzzz: bets $1.62
p0kernepro: calls $1.62
*** TURN *** [6d As 4c] [7h]
p0kernepro: checks
Furbzzzzz: bets $3.53
p0kernepro: calls $3.53
*** RIVER *** [6d As 4c 7h] [5h]
p0kernepro: checks
Furbzzzzz: bets $9.55
p0kernepro: calls $9.55
*** SHOW DOWN ***
Furbzzzzz: shows [Ks Qd] (high card Ace)
p0kernepro: shows [4h 8h] (a straight, Four to Eight)
p0kernepro collected $30.54 from pot
*** SUMMARY ***
Total pot $32.15 | Rake $1.61
Board [6d As 4c 7h 5h]
Seat 1: juancho0007 (small blind) folded before Flop
Seat 2: p0kernepro (big blind) showed [4h 8h] and won ($30.54) with a straight, Four to Eight
Seat 4: Soulfrozz folded before Flop (didn't bet)
Seat 5: HerneTheHunter folded before Flop (didn't bet)
Seat 6: Furbzzzzz (button) showed [Ks Qd] and lost with high card Ace


PokerStars Hand #220357091445:  Hold'em No Limit ($0.25/$0.50 USD) - 2020/11/13 15:40:07 ET
Table 'Wisibada III' 6-max Seat #1 is the button
Seat 1: juancho0007 ($53.13 in chips)
Seat 2: p0kernepro ($66.98 in chips)
Seat 3: ArcticBearDK ($50 in chips)
Seat 4: Soulfrozz ($52.88 in chips)
Seat 5: HerneTheHunter ($27.08 in chips)
Seat 6: Furbzzzzz ($50 in chips)
p0kernepro: posts small blind $0.25
ArcticBearDK: posts big blind $0.50
*** HOLE CARDS ***
Soulfrozz: folds
HerneTheHunter: folds
Furbzzzzz: folds
juancho0007: raises $0.50 to $1
p0kernepro: folds
ArcticBearDK: raises $3 to $4
juancho0007: calls $3
*** FLOP *** [Ad 3s Ts]
ArcticBearDK: bets $3.50
juancho0007: calls $3.50
*** TURN *** [Ad 3s Ts] [Kh]
ArcticBearDK: checks
juancho0007: checks
*** RIVER *** [Ad 3s Ts Kh] [2s]
ArcticBearDK: checks
juancho0007: checks
*** SHOW DOWN ***
ArcticBearDK: shows [Qh As] (a pair of Aces)
juancho0007: shows [Qs Ah] (a pair of Aces)
ArcticBearDK collected $7.25 from pot
juancho0007 collected $7.24 from pot
*** SUMMARY ***
Total pot $15.25 | Rake $0.76
Board [Ad 3s Ts Kh 2s]
Seat 1: juancho0007 (button) showed [Qs Ah] and won ($7.24) with a pair of Aces
Seat 2: p0kernepro (small blind) folded before Flop
Seat 3: ArcticBearDK (big blind) showed [Qh As] and won ($7.25) with a pair of Aces
Seat 4: Soulfrozz folded before Flop (didn't bet)
Seat 5: HerneTheHunter folded before Flop (didn't bet)
Seat 6: Furbzzzzz folded before Flop (didn't bet)


PokerStars Hand #221546352572:  Hold'em No Limit ($0.25/$0.50 USD) - 2020/12/17 14:37:35 ET
Table 'Sigrid III' 6-max Seat #5 is the button
Seat 1: MaxOnKorolko ($42.88 in chips)
Seat 3: jarcauuu ($53.11 in chips)
Seat 4: oldbulldog1954 ($17.50 in chips)
Seat 5: santa88188 ($93.33 in chips)
Seat 6: Rezzonner ($50.90 in chips)
Rezzonner: posts small blind $0.25
MaxOnKorolko: posts big blind $0.50
ArcticBearDK: sits out
*** HOLE CARDS ***
jarcauuu: raises $0.75 to $1.25
oldbulldog1954: folds
santa88188: folds
Rezzonner: folds
MaxOnKorolko: calls $0.75
*** FLOP *** [7d 2h 3d]
MaxOnKorolko: bets $0.50
jarcauuu: raises $3 to $3.50
MaxOnKorolko: calls $3
*** TURN *** [7d 2h 3d] [Jh]
MaxOnKorolko: bets $0.50
jarcauuu: raises $8.50 to $9
MaxOnKorolko: raises $29.13 to $38.13 and is all-in
jarcauuu: calls $29.13
MaxOnKorolko has timed out
*** RIVER *** [7d 2h 3d Jh] [3c]
*** SHOW DOWN ***
MaxOnKorolko: shows [4s 7h] (two pair, Sevens and Threes)
jarcauuu: shows [Ad 8d] (a pair of Threes)
MaxOnKorolko collected $84.01 from pot
*** SUMMARY ***
Total pot $86.01 | Rake $2
Board [7d 2h 3d Jh 3c]
Seat 1: MaxOnKorolko (big blind) showed [4s 7h] and won ($84.01) with two pair, Sevens and Threes
Seat 3: jarcauuu showed [Ad 8d] and lost with a pair of Threes
Seat 4: oldbulldog1954 folded before Flop (didn't bet)
Seat 5: santa88188 (button) folded before Flop (didn't bet)
Seat 6: Rezzonner (small blind) folded before Flop


PokerStars Hand #221546437918:  Hold'em No Limit ($0.25/$0.50 USD) - 2020/12/17 14:39:46 ET
Table 'Sigrid III' 6-max Seat #3 is the button
Seat 1: MaxOnKorolko ($66.96 in chips)
Seat 2: ArcticBearDK ($66.75 in chips)
Seat 3: jarcauuu ($50 in chips)
Seat 4: oldbulldog1954 ($21.38 in chips)
Seat 5: santa88188 ($91.83 in chips)
Seat 6: Rezzonner ($50.65 in chips)
oldbulldog1954: posts small blind $0.25
santa88188: posts big blind $0.50
*** HOLE CARDS ***
Rezzonner: folds
MaxOnKorolko: calls $0.50
ArcticBearDK: folds
jarcauuu: raises $2.50 to $3
oldbulldog1954: folds
santa88188: folds
MaxOnKorolko: calls $2.50
*** FLOP *** [4d 5h 8h]
MaxOnKorolko: checks
jarcauuu: checks
*** TURN *** [4d 5h 8h] [3d]
MaxOnKorolko: checks
jarcauuu: checks
*** RIVER *** [4d 5h 8h 3d] [4s]
MaxOnKorolko: bets $0.50
jarcauuu: calls $0.50
*** SHOW DOWN ***
MaxOnKorolko: shows [Js 7h] (a pair of Fours)
jarcauuu: shows [Jc Qd] (a pair of Fours - Queen kicker)
jarcauuu collected $7.36 from pot
*** SUMMARY ***
Total pot $7.75 | Rake $0.39
Board [4d 5h 8h 3d 4s]
Seat 1: MaxOnKorolko showed [Js 7h] and lost with a pair of Fours
Seat 2: ArcticBearDK folded before Flop (didn't bet)
Seat 3: jarcauuu (button) showed [Jc Qd] and won ($7.36) with a pair of Fours
Seat 4: oldbulldog1954 (small blind) folded before Flop
Seat 5: santa88188 (big blind) folded before Flop
Seat 6: Rezzonner folded before Flop (didn't bet)


PokerStars Hand #221546521518:  Hold'em No Limit ($0.25/$0.50 USD) - 2020/12/17 14:41:54 ET
Table 'Sigrid III' 6-max Seat #6 is the button
Seat 1: MaxOnKorolko ($69.44 in chips)
Seat 2: ArcticBearDK ($65.75 in chips)
Seat 3: jarcauuu ($52.86 in chips)
Seat 4: oldbulldog1954 ($21.13 in chips)
Seat 5: santa88188 ($90.33 in chips)
Seat 6: Rezzonner ($50 in chips)
MaxOnKorolko: posts small blind $0.25
ArcticBearDK: posts big blind $0.50
*** HOLE CARDS ***
jarcauuu: raises $0.75 to $1.25
oldbulldog1954: folds
santa88188: folds
Rezzonner: calls $1.25
MaxOnKorolko: raises $0.75 to $2
ArcticBearDK: folds
jarcauuu: calls $0.75
Rezzonner: calls $0.75
*** FLOP *** [9s 7h 3d]
MaxOnKorolko: checks
jarcauuu: checks
Rezzonner: checks
*** TURN *** [9s 7h 3d] [4s]
MaxOnKorolko: checks
jarcauuu: checks
Rezzonner: checks
*** RIVER *** [9s 7h 3d 4s] [Kh]
MaxOnKorolko: bets $0.50
jarcauuu: calls $0.50
Rezzonner: calls $0.50
*** SHOW DOWN ***
MaxOnKorolko: shows [Jh 5c] (high card King)
jarcauuu: shows [2d Ad] (high card Ace)
Rezzonner: shows [Kc Tc] (a pair of Kings)
Rezzonner collected $7.60 from pot
*** SUMMARY ***
Total pot $8 | Rake $0.40
Board [9s 7h 3d 4s Kh]
Seat 1: MaxOnKorolko (small blind) showed [Jh 5c] and lost with high card King
Seat 2: ArcticBearDK (big blind) folded before Flop
Seat 3: jarcauuu showed [2d Ad] and lost with high card Ace
Seat 4: oldbulldog1954 folded before Flop (didn't bet)
Seat 5: santa88188 folded before Flop (didn't bet)
Seat 6: Rezzonner (button) showed [Kc Tc] and won ($7.60) with a pair of Kings


PokerStars Hand #221546556823:  Hold'em No Limit ($0.25/$0.50 USD) - 2020/12/17 14:42:48 ET
Table 'Sigrid III' 6-max Seat #1 is the button
Seat 1: MaxOnKorolko ($66.94 in chips)
Seat 2: ArcticBearDK ($65.25 in chips)
Seat 3: jarcauuu ($50.36 in chips)
Seat 4: oldbulldog1954 ($21.13 in chips)
Seat 5: santa88188 ($90.33 in chips)
Seat 6: Rezzonner ($55.10 in chips)
ArcticBearDK: posts small blind $0.25
jarcauuu: posts big blind $0.50
*** HOLE CARDS ***
oldbulldog1954: raises $1 to $1.50
santa88188: folds
Rezzonner: folds
MaxOnKorolko: raises $1 to $2.50
ArcticBearDK: folds
jarcauuu: folds
oldbulldog1954: raises $18.63 to $21.13 and is all-in
MaxOnKorolko: calls $18.63
*** FLOP *** [7h Ac 8s]
*** TURN *** [7h Ac 8s] [Kd]
*** RIVER *** [7h Ac 8s Kd] [Th]
*** SHOW DOWN ***
oldbulldog1954: shows [Kc Ah] (two pair, Aces and Kings)
MaxOnKorolko: shows [Tc 9d] (a pair of Tens)
oldbulldog1954 collected $41.01 from pot
*** SUMMARY ***
Total pot $43.01 | Rake $2
Board [7h Ac 8s Kd Th]
Seat 1: MaxOnKorolko (button) showed [Tc 9d] and lost with a pair of Tens
Seat 2: ArcticBearDK (small blind) folded before Flop
Seat 3: jarcauuu (big blind) folded before Flop
Seat 4: oldbulldog1954 showed [Kc Ah] and won ($41.01) with two pair, Aces and Kings
Seat 5: santa88188 folded before Flop (didn't bet)
Seat 6: Rezzonner folded before Flop (didn't bet)


PokerStars Hand #221546575912:  Hold'em No Limit ($0.25/$0.50 USD) - 2020/12/17 14:43:18 ET
Table 'Sigrid III' 6-max Seat #2 is the button
Seat 1: MaxOnKorolko ($45.81 in chips)
Seat 2: ArcticBearDK ($65 in chips)
Seat 3: jarcauuu ($50 in chips)
Seat 4: oldbulldog1954 ($41.01 in chips)
Seat 5: santa88188 ($90.33 in chips)
Seat 6: Rezzonner ($55.10 in chips)
jarcauuu: posts small blind $0.25
oldbulldog1954: posts big blind $0.50
*** HOLE CARDS ***
santa88188: folds
Rezzonner: raises $0.75 to $1.25
MaxOnKorolko: raises $44.56 to $45.81 and is all-in
ArcticBearDK: raises $19.19 to $65 and is all-in
jarcauuu: folds
oldbulldog1954: folds
Rezzonner: folds
Uncalled bet ($19.19) returned to ArcticBearDK
*** FLOP *** [8h Th 2d]
*** TURN *** [8h Th 2d] [6c]
*** RIVER *** [8h Th 2d 6c] [Js]
*** SHOW DOWN ***
MaxOnKorolko: shows [Kh Ah] (high card Ace)
ArcticBearDK: shows [Qs Ac] (high card Ace - lower kicker)
MaxOnKorolko collected $91.62 from pot
*** SUMMARY ***
Total pot $93.62 | Rake $2
Board [8h Th 2d 6c Js]
Seat 1: MaxOnKorolko showed [Kh Ah] and won ($91.62) with high card Ace
Seat 2: ArcticBearDK (button) showed [Qs Ac] and lost with high card Ace
Seat 3: jarcauuu (small blind) folded before Flop
Seat 4: oldbulldog1954 (big blind) folded before Flop
Seat 5: santa88188 folded before Flop (didn't bet)
Seat 6: Rezzonner folded before Flop


PokerStars Hand #221546628668:  Hold'em No Limit ($0.25/$0.50 USD) - 2020/12/17 14:44:38 ET
Table 'Sigrid III' 6-max Seat #5 is the button
Seat 1: MaxOnKorolko ($89.87 in chips)
Seat 2: ArcticBearDK ($54.21 in chips)
Seat 3: jarcauuu ($51.25 in chips)
Seat 4: oldbulldog1954 ($40.26 in chips)
Seat 5: santa88188 ($89.58 in chips)
Seat 6: Rezzonner ($52.10 in chips)
Rezzonner: posts small blind $0.25
MaxOnKorolko: posts big blind $0.50
*** HOLE CARDS ***
ArcticBearDK: folds
jarcauuu: raises $0.75 to $1.25
oldbulldog1954: folds
santa88188: calls $1.25
Rezzonner: folds
MaxOnKorolko: raises $0.75 to $2
jarcauuu: raises $49.25 to $51.25 and is all-in
santa88188: folds
MaxOnKorolko: calls $49.25
*** FLOP *** [7d 4s 8h]
*** TURN *** [7d 4s 8h] [4d]
*** RIVER *** [7d 4s 8h 4d] [6s]
*** SHOW DOWN ***
MaxOnKorolko: shows [Th 9h] (a straight, Six to Ten)
jarcauuu: shows [Tc Ac] (a pair of Fours)
MaxOnKorolko collected $102 from pot
*** SUMMARY ***
Total pot $104 | Rake $2
Board [7d 4s 8h 4d 6s]
Seat 1: MaxOnKorolko (big blind) showed [Th 9h] and won ($102) with a straight, Six to Ten
Seat 2: ArcticBearDK folded before Flop (didn't bet)
Seat 3: jarcauuu showed [Tc Ac] and lost with a pair of Fours
Seat 4: oldbulldog1954 folded before Flop (didn't bet)
Seat 5: santa88188 (button) folded before Flop
Seat 6: Rezzonner (small blind) folded before Flop


PokerStars Hand #221546691259:  Hold'em No Limit ($0.25/$0.50 USD) - 2020/12/17 14:46:13 ET
Table 'Sigrid III' 6-max Seat #1 is the button
Seat 1: MaxOnKorolko ($132.62 in chips)
Seat 2: ArcticBearDK ($63.79 in chips)
Seat 3: jarcauuu ($50 in chips)
Seat 5: santa88188 ($85.83 in chips)
Seat 6: Rezzonner ($51.85 in chips)
ArcticBearDK: posts small blind $0.25
jarcauuu: posts big blind $0.50
*** HOLE CARDS ***
santa88188: folds
Rezzonner: folds
MaxOnKorolko: raises $0.50 to $1
ArcticBearDK: folds
yzuk joins the table at seat #4
jarcauuu: calls $0.50
*** FLOP *** [7h Qs Td]
jarcauuu: checks
MaxOnKorolko: bets $0.50
jarcauuu: raises $48.50 to $49 and is all-in
MaxOnKorolko: calls $48.50
*** TURN *** [7h Qs Td] [Th]
*** RIVER *** [7h Qs Td Th] [4h]
*** SHOW DOWN ***
jarcauuu: shows [2c Qc] (two pair, Queens and Tens)
MaxOnKorolko: shows [Jc Ah] (a pair of Tens)
jarcauuu collected $98.25 from pot
*** SUMMARY ***
Total pot $100.25 | Rake $2
Board [7h Qs Td Th 4h]
Seat 1: MaxOnKorolko (button) showed [Jc Ah] and lost with a pair of Tens
Seat 2: ArcticBearDK (small blind) folded before Flop
Seat 3: jarcauuu (big blind) showed [2c Qc] and won ($98.25) with two pair, Queens and Tens
Seat 5: santa88188 folded before Flop (didn't bet)
Seat 6: Rezzonner folded before Flop (didn't bet)


PokerStars Hand #221546725072:  Hold'em No Limit ($0.25/$0.50 USD) - 2020/12/17 14:47:05 ET
Table 'Sigrid III' 6-max Seat #3 is the button
Seat 1: MaxOnKorolko ($83.37 in chips)
Seat 2: ArcticBearDK ($63.54 in chips)
Seat 3: jarcauuu ($98 in chips)
Seat 4: yzuk ($50 in chips)
Seat 6: Rezzonner ($51.85 in chips)
yzuk: posts small blind $0.25
santa88188: is sitting out
Rezzonner: posts big blind $0.50
*** HOLE CARDS ***
MaxOnKorolko: calls $0.50
ArcticBearDK: folds
jarcauuu: raises $2 to $2.50
yzuk: raises $5 to $7.50
Rezzonner: folds
MaxOnKorolko: raises $75.87 to $83.37 and is all-in
jarcauuu: folds
yzuk: calls $42.50 and is all-in
Uncalled bet ($33.37) returned to MaxOnKorolko
*** FLOP *** [Ks 3s 5s]
*** TURN *** [Ks 3s 5s] [3c]
*** RIVER *** [Ks 3s 5s 3c] [Td]
*** SHOW DOWN ***
yzuk: shows [Ac Qh] (a pair of Threes)
MaxOnKorolko: shows [9h 6s] (a pair of Threes - lower kicker)
yzuk collected $101 from pot
*** SUMMARY ***
Total pot $103 | Rake $2
Board [Ks 3s 5s 3c Td]
Seat 1: MaxOnKorolko showed [9h 6s] and lost with a pair of Threes
Seat 2: ArcticBearDK folded before Flop (didn't bet)
Seat 3: jarcauuu (button) folded before Flop
Seat 4: yzuk (small blind) showed [Ac Qh] and won ($101) with a pair of Threes
Seat 6: Rezzonner (big blind) folded before Flop


PokerStars Hand #221546749422:  Hold'em No Limit ($0.25/$0.50 USD) - 2020/12/17 14:47:42 ET
Table 'Sigrid III' 6-max Seat #6 is the button
Seat 1: MaxOnKorolko ($33.62 in chips)
Seat 2: ArcticBearDK ($63.54 in chips)
Seat 3: jarcauuu ($95.50 in chips)
Seat 4: yzuk ($101 in chips)
Seat 6: Rezzonner ($51.10 in chips)
MaxOnKorolko: posts small blind $0.25
ArcticBearDK: posts big blind $0.50
*** HOLE CARDS ***
jarcauuu: folds
yzuk: folds
Rezzonner: raises $0.75 to $1.25
MaxOnKorolko: raises $32.37 to $33.62 and is all-in
ArcticBearDK: raises $29.92 to $63.54 and is all-in
Rezzonner: folds
Uncalled bet ($29.92) returned to ArcticBearDK
*** FLOP *** [8d Js Td]
*** TURN *** [8d Js Td] [Th]
Rezzonner said, ":D"
*** RIVER *** [8d Js Td Th] [Jd]
*** SHOW DOWN ***
MaxOnKorolko: shows [Ah Kc] (two pair, Jacks and Tens)
ArcticBearDK: shows [Ad 3c] (two pair, Jacks and Tens)
MaxOnKorolko collected $33.25 from pot
ArcticBearDK collected $33.24 from pot
*** SUMMARY ***
Total pot $68.49 | Rake $2
Board [8d Js Td Th Jd]
Seat 1: MaxOnKorolko (small blind) showed [Ah Kc] and won ($33.25) with two pair, Jacks and Tens
Seat 2: ArcticBearDK (big blind) showed [Ad 3c] and won ($33.24) with two pair, Jacks and Tens
Seat 3: jarcauuu folded before Flop (didn't bet)
Seat 4: yzuk folded before Flop (didn't bet)
Seat 6: Rezzonner (button) folded before Flop


PokerStars Hand #221546808725:  Hold'em No Limit ($0.25/$0.50 USD) - 2020/12/17 14:49:12 ET
Table 'Sigrid III' 6-max Seat #4 is the button
Seat 1: MaxOnKorolko ($34 in chips)
Seat 2: ArcticBearDK ($63.66 in chips)
Seat 3: jarcauuu ($91.50 in chips)
Seat 4: yzuk ($103.90 in chips)
Seat 6: Rezzonner ($50 in chips)
Rezzonner: posts small blind $0.25
MaxOnKorolko: posts big blind $0.50
*** HOLE CARDS ***
ArcticBearDK: raises $1 to $1.50
jarcauuu: folds
yzuk: folds
Rezzonner: folds
MaxOnKorolko: raises $32.50 to $34 and is all-in
ArcticBearDK: calls $32.50
*** FLOP *** [7c 5c 8h]
*** TURN *** [7c 5c 8h] [8d]
*** RIVER *** [7c 5c 8h 8d] [Qd]
*** SHOW DOWN ***
MaxOnKorolko: shows [Qs Ah] (two pair, Queens and Eights)
ArcticBearDK: shows [Jd Kh] (a pair of Eights)
MaxOnKorolko collected $66.25 from pot
*** SUMMARY ***
Total pot $68.25 | Rake $2
Board [7c 5c 8h 8d Qd]
Seat 1: MaxOnKorolko (big blind) showed [Qs Ah] and won ($66.25) with two pair, Queens and Eights
Seat 2: ArcticBearDK showed [Jd Kh] and lost with a pair of Eights
Seat 3: jarcauuu folded before Flop (didn't bet)
Seat 4: yzuk (button) folded before Flop (didn't bet)
Seat 6: Rezzonner (small blind) folded before Flop


PokerStars Hand #221546863957:  Hold'em No Limit ($0.25/$0.50 USD) - 2020/12/17 14:50:29 ET
Table 'Sigrid III' 6-max Seat #2 is the button
Seat 1: MaxOnKorolko ($65.75 in chips)
Seat 2: ArcticBearDK ($50 in chips)
Seat 3: jarcauuu ($93.31 in chips)
Seat 4: gitarist74 ($50 in chips)
Seat 6: Rezzonner ($50 in chips)
jarcauuu: posts small blind $0.25
gitarist74: posts big blind $0.50
*** HOLE CARDS ***
Rezzonner: folds
MaxOnKorolko: folds
ArcticBearDK: raises $0.85 to $1.35
jarcauuu: folds
gitarist74: calls $0.85
*** FLOP *** [3c 6s 6c]
gitarist74: checks
ArcticBearDK: checks
*** TURN *** [3c 6s 6c] [Th]
gitarist74: bets $2.10
ArcticBearDK: calls $2.10
*** RIVER *** [3c 6s 6c Th] [3s]
gitarist74: bets $4.75
ArcticBearDK: calls $4.75
*** SHOW DOWN ***
gitarist74: shows [7d 6h] (a full house, Sixes full of Threes)
ArcticBearDK: mucks hand
gitarist74 collected $15.82 from pot
*** SUMMARY ***
Total pot $16.65 | Rake $0.83
Board [3c 6s 6c Th 3s]
Seat 1: MaxOnKorolko folded before Flop (didn't bet)
Seat 2: ArcticBearDK (button) mucked
Seat 3: jarcauuu (small blind) folded before Flop
Seat 4: gitarist74 (big blind) showed [7d 6h] and won ($15.82) with a full house, Sixes full of Threes
Seat 6: Rezzonner folded before Flop (didn't bet)


PokerStars Hand #221546879523:  Hold'em No Limit ($0.25/$0.50 USD) - 2020/12/17 14:50:53 ET
Table 'Sigrid III' 6-max Seat #3 is the button
Seat 1: MaxOnKorolko ($65.75 in chips)
Seat 2: ArcticBearDK ($50 in chips)
Seat 3: jarcauuu ($93.06 in chips)
Seat 4: gitarist74 ($57.62 in chips)
Seat 5: santa88188 ($85.83 in chips)
Seat 6: Rezzonner ($50 in chips)
gitarist74: posts small blind $0.25
santa88188: posts big blind $0.50
*** HOLE CARDS ***
Rezzonner: folds
MaxOnKorolko: calls $0.50
ArcticBearDK: raises $1.50 to $2
jarcauuu: calls $2
gitarist74: folds
santa88188: folds
MaxOnKorolko: raises $63.75 to $65.75 and is all-in
ArcticBearDK: folds
jarcauuu: calls $63.75
*** FLOP *** [Kc 3s 7h]
*** TURN *** [Kc 3s 7h] [5c]
*** RIVER *** [Kc 3s 7h 5c] [Ah]
*** SHOW DOWN ***
MaxOnKorolko: shows [8h Qs] (high card Ace)
jarcauuu: shows [Th As] (a pair of Aces)
jarcauuu collected $132.25 from pot
*** SUMMARY ***
Total pot $134.25 | Rake $2
Board [Kc 3s 7h 5c Ah]
Seat 1: MaxOnKorolko showed [8h Qs] and lost with high card Ace
Seat 2: ArcticBearDK folded before Flop
Seat 3: jarcauuu (button) showed [Th As] and won ($132.25) with a pair of Aces
Seat 4: gitarist74 (small blind) folded before Flop
Seat 5: santa88188 (big blind) folded before Flop
Seat 6: Rezzonner folded before Flop (didn't bet)


PokerStars Hand #222235818284:  Hold'em No Limit ($0.25/$0.50 USD) - 2021/01/04 15:58:42 ET
Table 'Deira IV' 6-max Seat #1 is the button
Seat 1: chis94 ($69.27 in chips)
Seat 2: Zeeshka ($50.25 in chips)
Seat 3: ArcticBearDK ($50 in chips)
Seat 4: MonsieurK6nO ($52.13 in chips)
Seat 5: haribri186 ($16.25 in chips)
Seat 6: BarnyukAV ($50 in chips)
Zeeshka: posts small blind $0.25
ArcticBearDK: posts big blind $0.50
*** HOLE CARDS ***
MonsieurK6nO: folds
haribri186: calls $0.50
BarnyukAV: folds
chis94: folds
Zeeshka: calls $0.25
ArcticBearDK: checks
*** FLOP *** [2d 6d Ts]
Zeeshka: bets $1.14
ArcticBearDK: folds
haribri186: raises $1.36 to $2.50
Zeeshka: raises $2.50 to $5
haribri186: calls $2.50
*** TURN *** [2d 6d Ts] [Ah]
Zeeshka: bets $3.82
haribri186: calls $3.82
*** RIVER *** [2d 6d Ts Ah] [7c]
Zeeshka: bets $12.73
haribri186: calls $6.93 and is all-in
Uncalled bet ($5.80) returned to Zeeshka
*** SHOW DOWN ***
Zeeshka: shows [2c 2s] (three of a kind, Deuces)
haribri186: shows [Ac Td] (two pair, Aces and Tens)
Zeeshka collected $31.35 from pot
*** SUMMARY ***
Total pot $33 | Rake $1.65
Board [2d 6d Ts Ah 7c]
Seat 1: chis94 (button) folded before Flop (didn't bet)
Seat 2: Zeeshka (small blind) showed [2c 2s] and won ($31.35) with three of a kind, Deuces
Seat 3: ArcticBearDK (big blind) folded on the Flop
Seat 4: MonsieurK6nO folded before Flop (didn't bet)
Seat 5: haribri186 showed [Ac Td] and lost with two pair, Aces and Tens
Seat 6: BarnyukAV folded before Flop (didn't bet)


PokerStars Hand #214305744722:  Hold'em No Limit ($0.25/$0.50 USD) - 2020/05/22 19:59:37 ET
Table 'Onnie V' 6-max Seat #5 is the button
Seat 1: shaykee ($50 in chips)
Seat 2: ArcticBearDK ($50.49 in chips)
Seat 3: koekiemonstaa ($48.15 in chips)
Seat 4: pj2805 ($16.32 in chips)
Seat 5: BookWorm78 ($160.43 in chips)
Seat 6: Becks Baker ($66.87 in chips)
Becks Baker: posts small blind $0.25
shaykee: posts big blind $0.50
*** HOLE CARDS ***
ArcticBearDK: folds
koekiemonstaa: calls $0.50
pj2805: folds
BookWorm78: folds
Becks Baker: folds
shaykee: checks
*** FLOP *** [8d Ad 6s]
shaykee: checks
koekiemonstaa: checks
*** TURN *** [8d Ad 6s] [8c]
shaykee: checks
koekiemonstaa: checks
*** RIVER *** [8d Ad 6s 8c] [Ac]
shaykee: checks
koekiemonstaa: checks
*** SHOW DOWN ***
shaykee: shows [2s 7s] (two pair, Aces and Eights)
koekiemonstaa: mucks hand
shaykee collected $1.19 from pot
*** SUMMARY ***
Total pot $1.25 | Rake $0.06
Board [8d Ad 6s 8c Ac]
Seat 1: shaykee (big blind) showed [2s 7s] and won ($1.19) with two pair, Aces and Eights
Seat 2: ArcticBearDK folded before Flop (didn't bet)
Seat 3: koekiemonstaa mucked
Seat 4: pj2805 folded before Flop (didn't bet)
Seat 5: BookWorm78 (button) folded before Flop (didn't bet)
Seat 6: Becks Baker (small blind) folded before Flop


PokerStars Hand #214305821025:  Hold'em No Limit ($0.25/$0.50 USD) - 2020/05/22 20:01:46 ET
Table 'Onnie V' 6-max Seat #2 is the button
Seat 1: shaykee ($50.44 in chips)
Seat 2: ArcticBearDK ($50 in chips)
Seat 3: koekiemonstaa ($46.65 in chips)
Seat 4: pj2805 ($17.46 in chips)
Seat 5: BookWorm78 ($161.18 in chips)
Seat 6: Becks Baker ($66.62 in chips)
koekiemonstaa: posts small blind $0.25
pj2805: posts big blind $0.50
*** HOLE CARDS ***
BookWorm78: folds
Becks Baker: raises $0.75 to $1.25
shaykee: folds
ArcticBearDK: calls $1.25
koekiemonstaa: folds
pj2805: raises $4 to $5.25
Becks Baker: raises $9.75 to $15
ArcticBearDK: folds
pj2805: raises $2.46 to $17.46 and is all-in
Becks Baker: calls $2.46
*** FLOP *** [As Kc Kd]
*** TURN *** [As Kc Kd] [4s]
*** RIVER *** [As Kc Kd 4s] [4c]
*** SHOW DOWN ***
pj2805: shows [Qh Ac] (two pair, Aces and Kings)
Becks Baker: shows [Qd Ah] (two pair, Aces and Kings)
pj2805 collected $17.30 from pot
Becks Baker collected $17.30 from pot
*** SUMMARY ***
Total pot $36.42 | Rake $1.82
Board [As Kc Kd 4s 4c]
Seat 1: shaykee folded before Flop (didn't bet)
Seat 2: ArcticBearDK (button) folded before Flop
Seat 3: koekiemonstaa (small blind) folded before Flop
Seat 4: pj2805 (big blind) showed [Qh Ac] and won ($17.30) with two pair, Aces and Kings
Seat 5: BookWorm78 folded before Flop (didn't bet)
Seat 6: Becks Baker showed [Qd Ah] and won ($17.30) with two pair, Aces and Kings


PokerStars Hand #222927743039:  Hold'em No Limit ($0.25/$0.50 USD) - 2021/01/22 15:26:12 ET
Table 'Sumiana III' 6-max Seat #4 is the button
Seat 1: Akeli4_by ($85.54 in chips)
Seat 2: Exotik13 ($69.12 in chips)
Seat 3: Reg1N55 ($117.29 in chips)
Seat 4: Xomera22 ($64.53 in chips)
Seat 5: ArcticBearDK ($50 in chips)
ArcticBearDK: posts small blind $0.25
Akeli4_by: posts big blind $0.50
*** HOLE CARDS ***
Exotik13: folds
Reg1N55: raises $0.75 to $1.25
Xomera22: folds
ArcticBearDK: folds
Akeli4_by: calls $0.75
*** FLOP *** [Qc 2h 4c]
Akeli4_by: checks
Reg1N55: checks
*** TURN *** [Qc 2h 4c] [3c]
Akeli4_by: checks
Reg1N55: checks
*** RIVER *** [Qc 2h 4c 3c] [Jd]
Akeli4_by: checks
Reg1N55: checks
*** SHOW DOWN ***
Akeli4_by: shows [9s Jh] (a pair of Jacks)
Reg1N55: mucks hand
Akeli4_by collected $2.61 from pot
*** SUMMARY ***
Total pot $2.75 | Rake $0.14
Board [Qc 2h 4c 3c Jd]
Seat 1: Akeli4_by (big blind) showed [9s Jh] and won ($2.61) with a pair of Jacks
Seat 2: Exotik13 folded before Flop (didn't bet)
Seat 3: Reg1N55 mucked
Seat 4: Xomera22 (button) folded before Flop (didn't bet)
Seat 5: ArcticBearDK (small blind) folded before Flop


PokerStars Hand #222927778454:  Hold'em No Limit ($0.25/$0.50 USD) - 2021/01/22 15:26:56 ET
Table 'Sumiana III' 6-max Seat #1 is the button
Seat 1: Akeli4_by ($87.40 in chips)
Seat 3: Reg1N55 ($115.54 in chips)
Seat 4: Xomera22 ($64.53 in chips)
Seat 5: ArcticBearDK ($50 in chips)
Reg1N55: posts small blind $0.25
Xomera22: posts big blind $0.50
*** HOLE CARDS ***
ArcticBearDK: raises $0.60 to $1.10
Akeli4_by: folds
Reg1N55: folds
Akeli4_by leaves the table
Xomera22: calls $0.60
*** FLOP *** [Jc Qd 9h]
Xomera22: checks
ArcticBearDK: checks
*** TURN *** [Jc Qd 9h] [Ts]
Xomera22: checks
ArcticBearDK: checks
*** RIVER *** [Jc Qd 9h Ts] [6h]
Xomera22: checks
ArcticBearDK: checks
*** SHOW DOWN ***
Xomera22: shows [7c 7s] (a pair of Sevens)
ArcticBearDK: mucks hand
Xomera22 collected $2.33 from pot
*** SUMMARY ***
Total pot $2.45 | Rake $0.12
Board [Jc Qd 9h Ts 6h]
Seat 1: Akeli4_by (button) folded before Flop (didn't bet)
Seat 3: Reg1N55 (small blind) folded before Flop
Seat 4: Xomera22 (big blind) showed [7c 7s] and won ($2.33) with a pair of Sevens
Seat 5: ArcticBearDK mucked


PokerStars Hand #232192589552:  Hold'em No Limit ($0.25/$0.50 USD) - 2021/12/13 15:43:47 ET
Table 'Kressida II' 6-max Seat #5 is the button
Seat 1: tugboat2008 ($56.69 in chips)
Seat 2: Slumzke ($50 in chips)
Seat 3: Natã Proença ($40 in chips)
Seat 4: zmakers ($50 in chips)
Seat 5: costelakw ($50.50 in chips)
Seat 6: Shved1502 ($52.75 in chips)
Shved1502: posts small blind $0.25
tugboat2008: posts big blind $0.50
*** HOLE CARDS ***
Slumzke: folds
Natã Proença: calls $0.50
zmakers: folds
costelakw: folds
Shved1502: raises $2 to $2.50
tugboat2008: raises $5 to $7.50
Natã Proença: raises $32.50 to $40 and is all-in
Shved1502: folds
tugboat2008: calls $32.50
Slumzke leaves the table
*** FLOP *** [Td 2c 4c]
*** TURN *** [Td 2c 4c] [6d]
*** RIVER *** [Td 2c 4c 6d] [Qc]
*** SHOW DOWN ***
tugboat2008: shows [Ks Ac] (high card Ace)
Natã Proença: shows [Ah Ad] (a pair of Aces)
ArcticBearDK joins the table at seat #2
Natã Proença collected $80.50 from pot
*** SUMMARY ***
Total pot $82.50 | Rake $2
Board [Td 2c 4c 6d Qc]
Seat 1: tugboat2008 (big blind) showed [Ks Ac] and lost with high card Ace
Seat 2: Slumzke folded before Flop (didn't bet)
Seat 3: Natã Proença showed [Ah Ad] and won ($80.50) with a pair of Aces
Seat 4: zmakers folded before Flop (didn't bet)
Seat 5: costelakw (button) folded before Flop (didn't bet)
Seat 6: Shved1502 (small blind) folded before Flop


PokerStars Hand #232192681702:  Hold'em No Limit ($0.25/$0.50 USD) - 2021/12/13 15:46:39 ET
Table 'Kressida II' 6-max Seat #5 is the button
Seat 1: tugboat2008 ($28.45 in chips)
Seat 2: ArcticBearDK ($50.50 in chips)
Seat 3: Natã Proença ($87.08 in chips)
Seat 4: zmakers ($50 in chips)
Seat 5: costelakw ($50.50 in chips)
Seat 6: Shved1502 ($50 in chips)
Shved1502: posts small blind $0.25
tugboat2008: posts big blind $0.50
*** HOLE CARDS ***
ArcticBearDK: folds
Natã Proença: calls $0.50
zmakers: folds
costelakw: folds
Shved1502: folds
tugboat2008: checks
*** FLOP *** [5h Js 5c]
tugboat2008: checks
Natã Proença: checks
*** TURN *** [5h Js 5c] [Qd]
tugboat2008: checks
Natã Proença: checks
*** RIVER *** [5h Js 5c Qd] [Jc]
tugboat2008: checks
Natã Proença: checks
*** SHOW DOWN ***
tugboat2008: shows [4c 4s] (two pair, Jacks and Fives)
Natã Proença: shows [3h Kc] (two pair, Jacks and Fives - King kicker)
Natã Proença collected $1.19 from pot
*** SUMMARY ***
Total pot $1.25 | Rake $0.06
Board [5h Js 5c Qd Jc]
Seat 1: tugboat2008 (big blind) showed [4c 4s] and lost with two pair, Jacks and Fives
Seat 2: ArcticBearDK folded before Flop (didn't bet)
Seat 3: Natã Proença showed [3h Kc] and won ($1.19) with two pair, Jacks and Fives
Seat 4: zmakers folded before Flop (didn't bet)
Seat 5: costelakw (button) folded before Flop (didn't bet)
Seat 6: Shved1502 (small blind) folded before Flop


PokerStars Hand #232192750482:  Hold'em No Limit ($0.25/$0.50 USD) - 2021/12/13 15:48:46 ET
Table 'Kressida II' 6-max Seat #4 is the button
Seat 1: tugboat2008 ($27.70 in chips)
Seat 2: ArcticBearDK ($50.75 in chips)
Seat 3: Natã Proença ($92.26 in chips)
Seat 4: zmakers ($50 in chips)
Seat 6: Shved1502 ($50 in chips)
Shved1502: posts small blind $0.25
tugboat2008: posts big blind $0.50
*** HOLE CARDS ***
ArcticBearDK: folds
Natã Proença: calls $0.50
zmakers: folds
Shved1502: folds
tugboat2008: checks
*** FLOP *** [Qs 5c As]
tugboat2008: checks
Natã Proença: checks
*** TURN *** [Qs 5c As] [Th]
tugboat2008: checks
Natã Proença: checks
*** RIVER *** [Qs 5c As Th] [2h]
tugboat2008: checks
Natã Proença: bets $0.50
tugboat2008: calls $0.50
*** SHOW DOWN ***
Natã Proença: shows [7d Jh] (high card Ace)
tugboat2008: shows [Ts Kd] (a pair of Tens)
tugboat2008 collected $2.14 from pot
*** SUMMARY ***
Total pot $2.25 | Rake $0.11
Board [Qs 5c As Th 2h]
Seat 1: tugboat2008 (big blind) showed [Ts Kd] and won ($2.14) with a pair of Tens
Seat 2: ArcticBearDK folded before Flop (didn't bet)
Seat 3: Natã Proença showed [7d Jh] and lost with high card Ace
Seat 4: zmakers (button) folded before Flop (didn't bet)
Seat 6: Shved1502 (small blind) folded before Flop


PokerStars Hand #232192794429:  Hold'em No Limit ($0.25/$0.50 USD) - 2021/12/13 15:50:08 ET
Table 'Kressida II' 6-max Seat #2 is the button
Seat 1: tugboat2008 ($28.59 in chips)
Seat 2: ArcticBearDK ($52.31 in chips)
Seat 3: Natã Proença ($91.71 in chips)
Seat 4: zmakers ($50 in chips)
Seat 6: Shved1502 ($50 in chips)
Natã Proença: posts small blind $0.25
zmakers: posts big blind $0.50
wanax777: sits out
*** HOLE CARDS ***
Shved1502: raises $1 to $1.50
tugboat2008 has timed out
tugboat2008: folds
ArcticBearDK: folds
Natã Proença: calls $1.25
zmakers: calls $1
*** FLOP *** [9s Td 2d]
Natã Proença: bets $1.50
zmakers: calls $1.50
Shved1502: calls $1.50
*** TURN *** [9s Td 2d] [6c]
Natã Proença: bets $3
zmakers: calls $3
Shved1502: folds
*** RIVER *** [9s Td 2d 6c] [Qd]
Natã Proença: bets $4.50
zmakers: calls $4.50
*** SHOW DOWN ***
Natã Proença: shows [8h 7c] (a straight, Six to Ten)
zmakers: mucks hand
Natã Proença collected $22.80 from pot
*** SUMMARY ***
Total pot $24 | Rake $1.20
Board [9s Td 2d 6c Qd]
Seat 1: tugboat2008 folded before Flop (didn't bet)
Seat 2: ArcticBearDK (button) folded before Flop (didn't bet)
Seat 3: Natã Proença (small blind) showed [8h 7c] and won ($22.80) with a straight, Six to Ten
Seat 4: zmakers (big blind) mucked
Seat 6: Shved1502 folded on the Turn


PokerStars Hand #232192822946:  Hold'em No Limit ($0.25/$0.50 USD) - 2021/12/13 15:51:01 ET
Table 'Kressida II' 6-max Seat #3 is the button
Seat 1: tugboat2008 ($28.59 in chips)
Seat 2: ArcticBearDK ($52.31 in chips)
Seat 3: Natã Proença ($104.01 in chips)
Seat 4: zmakers ($50 in chips)
Seat 5: wanax777 ($50 in chips)
Seat 6: Shved1502 ($50 in chips)
zmakers: posts small blind $0.25
wanax777: posts big blind $0.50
*** HOLE CARDS ***
Shved1502: folds
tugboat2008: raises $1 to $1.50
ArcticBearDK: folds
Natã Proença: calls $1.50
zmakers: folds
wanax777: folds
*** FLOP *** [8c 8h 4d]
tugboat2008: checks
Natã Proença: bets $1
tugboat2008: calls $1
*** TURN *** [8c 8h 4d] [Ah]
tugboat2008: checks
Natã Proença: bets $1
tugboat2008: calls $1
*** RIVER *** [8c 8h 4d Ah] [Ts]
tugboat2008: checks
Natã Proença: bets $3
tugboat2008: calls $3
*** SHOW DOWN ***
Natã Proença: shows [6d 3h] (a pair of Eights)
tugboat2008: shows [2c Ac] (two pair, Aces and Eights)
tugboat2008 collected $13.06 from pot
*** SUMMARY ***
Total pot $13.75 | Rake $0.69
Board [8c 8h 4d Ah Ts]
Seat 1: tugboat2008 showed [2c Ac] and won ($13.06) with two pair, Aces and Eights
Seat 2: ArcticBearDK folded before Flop (didn't bet)
Seat 3: Natã Proença (button) showed [6d 3h] and lost with a pair of Eights
Seat 4: zmakers (small blind) folded before Flop
Seat 5: wanax777 (big blind) folded before Flop
Seat 6: Shved1502 folded before Flop (didn't bet)


PokerStars Hand #232192852967:  Hold'em No Limit ($0.25/$0.50 USD) - 2021/12/13 15:51:57 ET
Table 'Kressida II' 6-max Seat #4 is the button
Seat 1: tugboat2008 ($35.15 in chips)
Seat 2: ArcticBearDK ($52.31 in chips)
Seat 3: Natã Proença ($97.51 in chips)
Seat 4: zmakers ($50 in chips)
Seat 5: wanax777 ($50 in chips)
Seat 6: Shved1502 ($50 in chips)
wanax777: posts small blind $0.25
Shved1502: posts big blind $0.50
*** HOLE CARDS ***
tugboat2008: folds
ArcticBearDK: folds
Natã Proença: calls $0.50
zmakers: folds
wanax777: folds
Shved1502: raises $1.50 to $2
Natã Proença: calls $1.50
*** FLOP *** [9d 3s 6d]
Shved1502: bets $0.50
Natã Proença: raises $3.50 to $4
Shved1502: calls $3.50
*** TURN *** [9d 3s 6d] [Tc]
Shved1502: checks
Natã Proença: bets $4
Shved1502: calls $4
*** RIVER *** [9d 3s 6d Tc] [4s]
Shved1502: checks
Natã Proença: bets $5
Shved1502: calls $5
*** SHOW DOWN ***
Natã Proença: shows [5h As] (high card Ace)
Shved1502: shows [6s 7s] (a pair of Sixes)
Shved1502 collected $28.74 from pot
*** SUMMARY ***
Total pot $30.25 | Rake $1.51
Board [9d 3s 6d Tc 4s]
Seat 1: tugboat2008 folded before Flop (didn't bet)
Seat 2: ArcticBearDK folded before Flop (didn't bet)
Seat 3: Natã Proença showed [5h As] and lost with high card Ace
Seat 4: zmakers (button) folded before Flop (didn't bet)
Seat 5: wanax777 (small blind) folded before Flop
Seat 6: Shved1502 (big blind) showed [6s 7s] and won ($28.74) with a pair of Sixes


PokerStars Hand #232192905859:  Hold'em No Limit ($0.25/$0.50 USD) - 2021/12/13 15:53:18 ET
Table 'Kressida II' 6-max Seat #6 is the button
Seat 1: tugboat2008 ($34.65 in chips)
Seat 2: ArcticBearDK ($52.31 in chips)
Seat 3: Natã Proença ($79.01 in chips)
Seat 4: zmakers ($53.86 in chips)
Seat 5: wanax777 ($50 in chips)
Seat 6: Shved1502 ($63.49 in chips)
tugboat2008: posts small blind $0.25
ArcticBearDK: posts big blind $0.50
*** HOLE CARDS ***
Natã Proença: folds
zmakers: folds
wanax777: folds
Shved1502 has timed out
Shved1502: folds
tugboat2008: raises $1 to $1.50
ArcticBearDK: calls $1
*** FLOP *** [9h Js 7c]
tugboat2008: checks
ArcticBearDK: bets $1.50
tugboat2008: calls $1.50
*** TURN *** [9h Js 7c] [9s]
tugboat2008: checks
ArcticBearDK: checks
*** RIVER *** [9h Js 7c 9s] [Ac]
tugboat2008: checks
ArcticBearDK: checks
*** SHOW DOWN ***
tugboat2008: shows [Qd Jd] (two pair, Jacks and Nines)
ArcticBearDK: mucks hand
tugboat2008 collected $5.70 from pot
*** SUMMARY ***
Total pot $6 | Rake $0.30
Board [9h Js 7c 9s Ac]
Seat 1: tugboat2008 (small blind) showed [Qd Jd] and won ($5.70) with two pair, Jacks and Nines
Seat 2: ArcticBearDK (big blind) mucked
Seat 3: Natã Proença folded before Flop (didn't bet)
Seat 4: zmakers folded before Flop (didn't bet)
Seat 5: wanax777 folded before Flop (didn't bet)
Seat 6: Shved1502 (button) folded before Flop (didn't bet)


PokerStars Hand #232192971251:  Hold'em No Limit ($0.25/$0.50 USD) - 2021/12/13 15:55:25 ET
Table 'Kressida II' 6-max Seat #1 is the button
Seat 1: tugboat2008 ($38.60 in chips)
Seat 2: ArcticBearDK ($52.25 in chips)
Seat 3: Natã Proença ($77.45 in chips)
Seat 4: zmakers ($53.86 in chips)
Seat 5: wanax777 ($50 in chips)
Seat 6: Shved1502 ($62.24 in chips)
ArcticBearDK: posts small blind $0.25
Natã Proença: posts big blind $0.50
*** HOLE CARDS ***
zmakers: folds
wanax777: folds
Shved1502: raises $1 to $1.50
tugboat2008: folds
ArcticBearDK: folds
Natã Proença: calls $1
*** FLOP *** [4h 4d Js]
Natã Proença: checks
Shved1502: checks
*** TURN *** [4h 4d Js] [3d]
Natã Proença: checks
Shved1502: checks
*** RIVER *** [4h 4d Js 3d] [5d]
Natã Proença: bets $1
Shved1502: calls $1
*** SHOW DOWN ***
Natã Proença: shows [5h 6h] (two pair, Fives and Fours)
Shved1502: mucks hand
Natã Proença collected $4.99 from pot
*** SUMMARY ***
Total pot $5.25 | Rake $0.26
Board [4h 4d Js 3d 5d]
Seat 1: tugboat2008 (button) folded before Flop (didn't bet)
Seat 2: ArcticBearDK (small blind) folded before Flop
Seat 3: Natã Proença (big blind) showed [5h 6h] and won ($4.99) with two pair, Fives and Fours
Seat 4: zmakers folded before Flop (didn't bet)
Seat 5: wanax777 folded before Flop (didn't bet)
Seat 6: Shved1502 mucked


PokerStars Hand #232193021933:  Hold'em No Limit ($0.25/$0.50 USD) - 2021/12/13 15:57:35 ET
Table 'Kressida II' 6-max Seat #6 is the button
Seat 1: tugboat2008 ($38.85 in chips)
Seat 2: ArcticBearDK ($52 in chips)
Seat 3: Natã Proença ($79.63 in chips)
Seat 4: zmakers ($54.51 in chips)
Seat 5: wanax777 ($50 in chips)
Seat 6: Shved1502 ($59.74 in chips)
tugboat2008: posts small blind $0.25
ArcticBearDK: posts big blind $0.50
*** HOLE CARDS ***
Natã Proença: raises $0.50 to $1
zmakers: folds
wanax777: folds
Shved1502: folds
tugboat2008: folds
ArcticBearDK: calls $0.50
*** FLOP *** [Tc 5c 5s]
ArcticBearDK: checks
Natã Proença: bets $1
ArcticBearDK: calls $1
*** TURN *** [Tc 5c 5s] [9h]
ArcticBearDK: checks
Natã Proença: bets $3
ArcticBearDK: raises $6 to $9
Natã Proença: calls $6
*** RIVER *** [Tc 5c 5s 9h] [3h]
ArcticBearDK: checks
Natã Proença: checks
*** SHOW DOWN ***
ArcticBearDK: shows [3c 5d] (a full house, Fives full of Threes)
Natã Proença: mucks hand
ArcticBearDK collected $21.14 from pot
*** SUMMARY ***
Total pot $22.25 | Rake $1.11
Board [Tc 5c 5s 9h 3h]
Seat 1: tugboat2008 (small blind) folded before Flop
Seat 2: ArcticBearDK (big blind) showed [3c 5d] and won ($21.14) with a full house, Fives full of Threes
Seat 3: Natã Proença mucked
Seat 4: zmakers folded before Flop (didn't bet)
Seat 5: wanax777 folded before Flop (didn't bet)
Seat 6: Shved1502 (button) folded before Flop (didn't bet)


PokerStars Hand #232670040125:  Hold'em No Limit (£0.25/£0.50 GBP) - 2021/12/30 16:31:07 ET
Table 'Matra IV' 6-max Seat #2 is the button
Seat 1: ArcticBearDK (£50 in chips)
Seat 2: Bailey Dew (£50 in chips)
Seat 6: Cift99 (£33.37 in chips)
MuUkR joins the table at seat #5
T1GR13 has timed out
T1GR13: is sitting out
Cift99: posts small blind £0.25
ArcticBearDK: posts big blind £0.50
*** HOLE CARDS ***
asdkochka joins the table at seat #4
Bailey Dew: raises £1 to £1.50
Cift99: calls £1.25
ArcticBearDK: folds
*** FLOP *** [6d 4d 9d]
Cift99: checks
Bailey Dew: bets £1
Cift99: calls £1
*** TURN *** [6d 4d 9d] [4h]
Cift99: bets £0.50
Bailey Dew: calls £0.50
*** RIVER *** [6d 4d 9d 4h] [8c]
Cift99: bets £0.50
Bailey Dew: calls £0.50
*** SHOW DOWN ***
Cift99: shows [Qc 9c] (two pair, Nines and Fours)
Bailey Dew: mucks hand
Cift99 collected £7.12 from pot
*** SUMMARY ***
Total pot £7.50 | Rake £0.38
Board [6d 4d 9d 4h 8c]
Seat 1: ArcticBearDK (big blind) folded before Flop
Seat 2: Bailey Dew (button) mucked
Seat 6: Cift99 (small blind) showed [Qc 9c] and won (£7.12) with two pair, Nines and Fours


PokerStars Hand #232670156922:  Hold'em No Limit (£0.25/£0.50 GBP) - 2021/12/30 16:34:23 ET
Table 'Matra IV' 6-max Seat #3 is the button
Seat 1: ArcticBearDK (£60.84 in chips)
Seat 2: Bailey Dew (£50 in chips)
Seat 3: T1GR13 (£50 in chips)
Seat 4: asdkochka (£50 in chips)
Seat 5: MuUkR (£50 in chips)
Seat 6: Cift99 (£39 in chips)
asdkochka: posts small blind £0.25
MuUkR: posts big blind £0.50
*** HOLE CARDS ***
Cift99: calls £0.50
ArcticBearDK: folds
Bailey Dew: raises £1.71 to £2.21
T1GR13: folds
asdkochka: folds
MuUkR: folds
Cift99: calls £1.71
*** FLOP *** [4h Qh Th]
Cift99: bets £0.50
Bailey Dew: calls £0.50
*** TURN *** [4h Qh Th] [2d]
Cift99: bets £0.50
Bailey Dew: calls £0.50
*** RIVER *** [4h Qh Th 2d] [9h]
Cift99: bets £0.50
Bailey Dew: calls £0.50
*** SHOW DOWN ***
Cift99: shows [9s 7c] (a pair of Nines)
Bailey Dew: shows [Jc 8c] (a straight, Eight to Queen)
Bailey Dew collected £7.76 from pot
*** SUMMARY ***
Total pot £8.17 | Rake £0.41
Board [4h Qh Th 2d 9h]
Seat 1: ArcticBearDK folded before Flop (didn't bet)
Seat 2: Bailey Dew showed [Jc 8c] and won (£7.76) with a straight, Eight to Queen
Seat 3: T1GR13 (button) folded before Flop (didn't bet)
Seat 4: asdkochka (small blind) folded before Flop
Seat 5: MuUkR (big blind) folded before Flop
Seat 6: Cift99 showed [9s 7c] and lost with a pair of Nines


PokerStars Hand #232670186352:  Hold'em No Limit (£0.25/£0.50 GBP) - 2021/12/30 16:35:13 ET
Table 'Matra IV' 6-max Seat #4 is the button
Seat 1: ArcticBearDK (£60.84 in chips)
Seat 2: Bailey Dew (£54.05 in chips)
Seat 3: T1GR13 (£50 in chips)
Seat 4: asdkochka (£50 in chips)
Seat 5: MuUkR (£50 in chips)
Seat 6: Cift99 (£35.29 in chips)
MuUkR: posts small blind £0.25
Cift99: posts big blind £0.50
*** HOLE CARDS ***
ArcticBearDK: folds
Bailey Dew: folds
T1GR13: folds
asdkochka: folds
MuUkR: raises £1 to £1.50
Cift99: calls £1
*** FLOP *** [As Qc Jc]
MuUkR: checks
Cift99: checks
*** TURN *** [As Qc Jc] [3s]
MuUkR: bets £1.90
Cift99: calls £1.90
*** RIVER *** [As Qc Jc 3s] [4c]
MuUkR: checks
Cift99: bets £0.50
MuUkR: calls £0.50
*** SHOW DOWN ***
Cift99: shows [7h 7c] (a pair of Sevens)
MuUkR: shows [Js 6s] (a pair of Jacks)
MuUkR collected £7.41 from pot
*** SUMMARY ***
Total pot £7.80 | Rake £0.39
Board [As Qc Jc 3s 4c]
Seat 1: ArcticBearDK folded before Flop (didn't bet)
Seat 2: Bailey Dew folded before Flop (didn't bet)
Seat 3: T1GR13 folded before Flop (didn't bet)
Seat 4: asdkochka (button) folded before Flop (didn't bet)
Seat 5: MuUkR (small blind) showed [Js 6s] and won (£7.41) with a pair of Jacks
Seat 6: Cift99 (big blind) showed [7h 7c] and lost with a pair of Sevens


PokerStars Hand #232670389619:  Hold'em No Limit (£0.25/£0.50 GBP) - 2021/12/30 16:41:01 ET
Table 'Matra IV' 6-max Seat #2 is the button
Seat 1: ArcticBearDK (£59.87 in chips)
Seat 2: Bailey Dew (£50 in chips)
Seat 3: T1GR13 (£50 in chips)
Seat 4: asdkochka (£50.44 in chips)
Seat 5: MuUkR (£57.31 in chips)
Seat 6: Cift99 (£43.62 in chips)
T1GR13: posts small blind £0.25
asdkochka: posts big blind £0.50
*** HOLE CARDS ***
MuUkR: folds
Cift99: calls £0.50
ArcticBearDK: folds
Bailey Dew: raises £1.71 to £2.21
T1GR13: folds
asdkochka: raises £4.54 to £6.75
Cift99: folds
Bailey Dew: raises £7.01 to £13.76
asdkochka: calls £7.01
*** FLOP *** [7d 3h Th]
asdkochka: checks
Bailey Dew: checks
*** TURN *** [7d 3h Th] [3c]
asdkochka: bets £8.87
Bailey Dew: calls £8.87
*** RIVER *** [7d 3h Th 3c] [Ad]
asdkochka: checks
Bailey Dew: bets £27.37 and is all-in
asdkochka: calls £27.37
*** SHOW DOWN ***
Bailey Dew: shows [Ah Kd] (two pair, Aces and Threes)
asdkochka: shows [Qc Ac] (two pair, Aces and Threes - lower kicker)
Bailey Dew collected £99.35 from pot
*** SUMMARY ***
Total pot £100.75 | Rake £1.40
Board [7d 3h Th 3c Ad]
Seat 1: ArcticBearDK folded before Flop (didn't bet)
Seat 2: Bailey Dew (button) showed [Ah Kd] and won (£99.35) with two pair, Aces and Threes
Seat 3: T1GR13 (small blind) folded before Flop
Seat 4: asdkochka (big blind) showed [Qc Ac] and lost with two pair, Aces and Threes
Seat 5: MuUkR folded before Flop (didn't bet)
Seat 6: Cift99 folded before Flop


PokerStars Hand #232670690770:  Hold'em No Limit (£0.25/£0.50 GBP) - 2021/12/30 16:49:16 ET
Table 'Matra IV' 6-max Seat #1 is the button
Seat 1: ArcticBearDK (£62.24 in chips)
Seat 2: Bailey Dew (£94.25 in chips)
Seat 3: T1GR13 (£57.51 in chips)
Seat 4: asdkochka (£50 in chips)
Seat 5: MuUkR (£52.39 in chips)
Seat 6: Cift99 (£41.78 in chips)
Bailey Dew: posts small blind £0.25
T1GR13: posts big blind £0.50
*** HOLE CARDS ***
asdkochka: folds
MuUkR: folds
Cift99: calls £0.50
ArcticBearDK: folds
Bailey Dew: folds
T1GR13: checks
*** FLOP *** [9c 7s Ts]
T1GR13: checks
Cift99: checks
*** TURN *** [9c 7s Ts] [Kc]
T1GR13: bets £2
Cift99: calls £2
*** RIVER *** [9c 7s Ts Kc] [6h]
T1GR13: bets £1.65
Cift99: calls £1.65
*** SHOW DOWN ***
T1GR13: shows [9h 7h] (two pair, Nines and Sevens)
Cift99: mucks hand
T1GR13 collected £8.12 from pot
*** SUMMARY ***
Total pot £8.55 | Rake £0.43
Board [9c 7s Ts Kc 6h]
Seat 1: ArcticBearDK (button) folded before Flop (didn't bet)
Seat 2: Bailey Dew (small blind) folded before Flop
Seat 3: T1GR13 (big blind) showed [9h 7h] and won (£8.12) with two pair, Nines and Sevens
Seat 4: asdkochka folded before Flop (didn't bet)
Seat 5: MuUkR folded before Flop (didn't bet)
Seat 6: Cift99 mucked


PokerStars Hand #232670865469:  Hold'em No Limit (£0.25/£0.50 GBP) - 2021/12/30 16:54:09 ET
Table 'Matra IV' 6-max Seat #2 is the button
Seat 1: ArcticBearDK (£61.49 in chips)
Seat 2: Bailey Dew (£98.31 in chips)
Seat 3: T1GR13 (£62.54 in chips)
Seat 4: asdkochka (£50 in chips)
Seat 5: MuUkR (£51.84 in chips)
Seat 6: Cift99 (£34.49 in chips)
T1GR13: posts small blind £0.25
asdkochka: posts big blind £0.50
*** HOLE CARDS ***
MuUkR: folds
Cift99: calls £0.50
ArcticBearDK: folds
Bailey Dew: folds
T1GR13: folds
asdkochka: checks
*** FLOP *** [Qh 6s 9c]
asdkochka: checks
Cift99: checks
*** TURN *** [Qh 6s 9c] [Th]
asdkochka: bets £0.79
Cift99: calls £0.79
*** RIVER *** [Qh 6s 9c Th] [2d]
asdkochka: checks
Cift99: bets £0.50
asdkochka: calls £0.50
*** SHOW DOWN ***
Cift99: shows [5s Td] (a pair of Tens)
asdkochka: mucks hand
Cift99 collected £3.64 from pot
*** SUMMARY ***
Total pot £3.83 | Rake £0.19
Board [Qh 6s 9c Th 2d]
Seat 1: ArcticBearDK folded before Flop (didn't bet)
Seat 2: Bailey Dew (button) folded before Flop (didn't bet)
Seat 3: T1GR13 (small blind) folded before Flop
Seat 4: asdkochka (big blind) mucked
Seat 5: MuUkR folded before Flop (didn't bet)
Seat 6: Cift99 showed [5s Td] and won (£3.64) with a pair of Tens


PokerStars Hand #232670909977:  Hold'em No Limit (£0.25/£0.50 GBP) - 2021/12/30 16:55:30 ET
Table 'Matra IV' 6-max Seat #4 is the button
Seat 1: ArcticBearDK (£61.49 in chips)
Seat 2: Bailey Dew (£98.31 in chips)
Seat 3: T1GR13 (£62.29 in chips)
Seat 4: asdkochka (£50 in chips)
Seat 5: MuUkR (£51.34 in chips)
Seat 6: Cift99 (£37.03 in chips)
MuUkR: posts small blind £0.25
Cift99: posts big blind £0.50
*** HOLE CARDS ***
ArcticBearDK: folds
Bailey Dew: raises £1 to £1.50
T1GR13: raises £3 to £4.50
asdkochka: folds
MuUkR: folds
Cift99: calls £4
Bailey Dew: folds
*** FLOP *** [Td 4h 8s]
Cift99: bets £0.50
T1GR13: calls £0.50
*** TURN *** [Td 4h 8s] [2c]
Cift99: bets £0.50
T1GR13: calls £0.50
*** RIVER *** [Td 4h 8s 2c] [4c]
Cift99: bets £0.50
T1GR13: calls £0.50
*** SHOW DOWN ***
Cift99: shows [Jc Ah] (a pair of Fours)
T1GR13: shows [As Kc] (a pair of Fours - Ace+King kicker)
T1GR13 collected £13.06 from pot
*** SUMMARY ***
Total pot £13.75 | Rake £0.69
Board [Td 4h 8s 2c 4c]
Seat 1: ArcticBearDK folded before Flop (didn't bet)
Seat 2: Bailey Dew folded before Flop
Seat 3: T1GR13 showed [As Kc] and won (£13.06) with a pair of Fours
Seat 4: asdkochka (button) folded before Flop (didn't bet)
Seat 5: MuUkR (small blind) folded before Flop
Seat 6: Cift99 (big blind) showed [Jc Ah] and lost with a pair of Fours


PokerStars Hand #228594579171:  Hold'em No Limit ($0.25/$0.50 USD) - 2021/07/26 18:06:37 ET
Table 'Tokai II' 6-max Seat #6 is the button
Seat 1: cCc89 ($50.25 in chips)
Seat 2: N1leon ($50 in chips)
Seat 5: EmilDef ($47.35 in chips)
Seat 6: manu7899 ($62.90 in chips)
cCc89: posts small blind $0.25
N1leon: posts big blind $0.50
ArcticBearDK: sits out
*** HOLE CARDS ***
EmilDef: calls $0.50
manu7899: folds
cCc89: calls $0.25
N1leon: checks
*** FLOP *** [Tc Kd 4c]
cCc89: checks
N1leon: checks
EmilDef: checks
*** TURN *** [Tc Kd 4c] [Jc]
cCc89: checks
N1leon: checks
EmilDef: checks
*** RIVER *** [Tc Kd 4c Jc] [4d]
cCc89: checks
N1leon: bets $1.42
EmilDef: calls $1.42
cCc89: folds
*** SHOW DOWN ***
N1leon: shows [3s 7h] (a pair of Fours)
EmilDef: shows [Js Qd] (two pair, Jacks and Fours)
EmilDef collected $4.12 from pot
*** SUMMARY ***
Total pot $4.34 | Rake $0.22
Board [Tc Kd 4c Jc 4d]
Seat 1: cCc89 (small blind) folded on the River
Seat 2: N1leon (big blind) showed [3s 7h] and lost with a pair of Fours
Seat 5: EmilDef showed [Js Qd] and won ($4.12) with two pair, Jacks and Fours
Seat 6: manu7899 (button) folded before Flop (didn't bet)


PokerStars Hand #228594691283:  Hold'em No Limit ($0.25/$0.50 USD) - 2021/07/26 18:11:16 ET
Table 'Tokai II' 6-max Seat #2 is the button
Seat 1: cCc89 ($61.50 in chips)
Seat 2: N1leon ($50 in chips)
Seat 4: ArcticBearDK ($50 in chips)
Seat 5: EmilDef ($48.80 in chips)
ArcticBearDK: posts small blind $0.25
EmilDef: posts big blind $0.50
manu7899: sits out
*** HOLE CARDS ***
cCc89: folds
N1leon: raises $1 to $1.50
ArcticBearDK: folds
EmilDef: calls $1
*** FLOP *** [Kd 2s 5s]
EmilDef: checks
N1leon: bets $1.55
EmilDef: raises $1.55 to $3.10
mixailll99 joins the table at seat #3
N1leon: calls $1.55
*** TURN *** [Kd 2s 5s] [3c]
EmilDef: bets $8.98
N1leon: calls $8.98
*** RIVER *** [Kd 2s 5s 3c] [6h]
EmilDef: checks
N1leon: checks
*** SHOW DOWN ***
EmilDef: shows [Ah Td] (high card Ace)
N1leon: shows [Jc Ac] (high card Ace - King+Jack kicker)
N1leon collected $26.66 from pot
*** SUMMARY ***
Total pot $27.41 | Rake $0.75
Board [Kd 2s 5s 3c 6h]
Seat 1: cCc89 folded before Flop (didn't bet)
Seat 2: N1leon (button) showed [Jc Ac] and won ($26.66) with high card Ace
Seat 4: ArcticBearDK (small blind) folded before Flop
Seat 5: EmilDef (big blind) showed [Ah Td] and lost with high card Ace


PokerStars Hand #228594751401:  Hold'em No Limit ($0.25/$0.50 USD) - 2021/07/26 18:13:48 ET
Table 'Tokai II' 6-max Seat #1 is the button
Seat 1: cCc89 ($61.50 in chips)
Seat 2: N1leon ($62.58 in chips)
Seat 3: mixailll99 ($50 in chips)
Seat 4: ArcticBearDK ($50 in chips)
Seat 5: EmilDef ($39.38 in chips)
Seat 6: manu7899 ($59.54 in chips)
N1leon: posts small blind $0.25
mixailll99: posts big blind $0.50
*** HOLE CARDS ***
ArcticBearDK: folds
EmilDef: folds
manu7899: raises $1 to $1.50
cCc89: folds
N1leon: folds
mixailll99: calls $1
*** FLOP *** [3d 2d 7c]
mixailll99: checks
manu7899: checks
*** TURN *** [3d 2d 7c] [9h]
mixailll99: checks
manu7899: checks
*** RIVER *** [3d 2d 7c 9h] [Kc]
mixailll99: checks
manu7899: checks
*** SHOW DOWN ***
mixailll99: shows [Ac 6c] (high card Ace)
manu7899: shows [Ah Jd] (high card Ace - King+Jack kicker)
manu7899 collected $3.09 from pot
*** SUMMARY ***
Total pot $3.25 | Rake $0.16
Board [3d 2d 7c 9h Kc]
Seat 1: cCc89 (button) folded before Flop (didn't bet)
Seat 2: N1leon (small blind) folded before Flop
Seat 3: mixailll99 (big blind) showed [Ac 6c] and lost with high card Ace
Seat 4: ArcticBearDK folded before Flop (didn't bet)
Seat 5: EmilDef folded before Flop (didn't bet)
Seat 6: manu7899 showed [Ah Jd] and won ($3.09) with high card Ace


PokerStars Hand #228594848738:  Hold'em No Limit ($0.25/$0.50 USD) - 2021/07/26 18:17:30 ET
Table 'Tokai II' 6-max Seat #1 is the button
Seat 1: cCc89 ($60.15 in chips)
Seat 2: N1leon ($73.76 in chips)
Seat 3: mixailll99 ($50 in chips)
Seat 4: ArcticBearDK ($50 in chips)
Seat 5: EmilDef ($29.26 in chips)
Seat 6: manu7899 ($61.13 in chips)
N1leon: posts small blind $0.25
mixailll99: posts big blind $0.50
*** HOLE CARDS ***
ArcticBearDK: raises $0.75 to $1.25
EmilDef: folds
manu7899: calls $1.25
cCc89: folds
N1leon: folds
mixailll99: calls $0.75
*** FLOP *** [2c Ah Ad]
mixailll99: checks
ArcticBearDK: bets $2
manu7899: calls $2
mixailll99: folds
*** TURN *** [2c Ah Ad] [5d]
ArcticBearDK: bets $4
manu7899: calls $4
*** RIVER *** [2c Ah Ad 5d] [3s]
ArcticBearDK: checks
manu7899: checks
*** SHOW DOWN ***
ArcticBearDK: shows [Tc Ac] (three of a kind, Aces)
manu7899: mucks hand
ArcticBearDK collected $15.20 from pot
*** SUMMARY ***
Total pot $16 | Rake $0.80
Board [2c Ah Ad 5d 3s]
Seat 1: cCc89 (button) folded before Flop (didn't bet)
Seat 2: N1leon (small blind) folded before Flop
Seat 3: mixailll99 (big blind) folded on the Flop
Seat 4: ArcticBearDK showed [Tc Ac] and won ($15.20) with three of a kind, Aces
Seat 5: EmilDef folded before Flop (didn't bet)
Seat 6: manu7899 mucked


PokerStars Hand #228594878507:  Hold'em No Limit ($0.25/$0.50 USD) - 2021/07/26 18:18:47 ET
Table 'Tokai II' 6-max Seat #3 is the button
Seat 1: cCc89 ($60.15 in chips)
Seat 2: N1leon ($73.51 in chips)
Seat 3: mixailll99 ($50 in chips)
Seat 4: ArcticBearDK ($57.45 in chips)
Seat 5: EmilDef ($29.26 in chips)
Seat 6: manu7899 ($54.63 in chips)
ArcticBearDK: posts small blind $0.25
EmilDef: posts big blind $0.50
*** HOLE CARDS ***
manu7899: folds
cCc89: folds
N1leon: folds
mixailll99: raises $0.75 to $1.25
ArcticBearDK: folds
EmilDef: calls $0.75
*** FLOP *** [2d Tc Jc]
EmilDef: checks
mixailll99: checks
*** TURN *** [2d Tc Jc] [6h]
EmilDef: checks
mixailll99: checks
*** RIVER *** [2d Tc Jc 6h] [8d]
EmilDef: checks
mixailll99: checks
*** SHOW DOWN ***
EmilDef: shows [5d Jd] (a pair of Jacks)
mixailll99: mucks hand
EmilDef collected $2.61 from pot
*** SUMMARY ***
Total pot $2.75 | Rake $0.14
Board [2d Tc Jc 6h 8d]
Seat 1: cCc89 folded before Flop (didn't bet)
Seat 2: N1leon folded before Flop (didn't bet)
Seat 3: mixailll99 (button) mucked
Seat 4: ArcticBearDK (small blind) folded before Flop
Seat 5: EmilDef (big blind) showed [5d Jd] and won ($2.61) with a pair of Jacks
Seat 6: manu7899 folded before Flop (didn't bet)


PokerStars Hand #228594969294:  Hold'em No Limit ($0.25/$0.50 USD) - 2021/07/26 18:22:44 ET
Table 'Tokai II' 6-max Seat #3 is the button
Seat 1: cCc89 ($59.40 in chips)
Seat 2: N1leon ($73.90 in chips)
Seat 3: mixailll99 ($52.16 in chips)
Seat 4: ArcticBearDK ($50.70 in chips)
Seat 5: EmilDef ($30.37 in chips)
Seat 6: manu7899 ($58.66 in chips)
ArcticBearDK: posts small blind $0.25
EmilDef: posts big blind $0.50
*** HOLE CARDS ***
manu7899: folds
cCc89: folds
N1leon: raises $1 to $1.50
mixailll99: folds
ArcticBearDK: folds
EmilDef: calls $1
*** FLOP *** [7h Kh 4h]
EmilDef: checks
N1leon: bets $1.02
EmilDef: calls $1.02
*** TURN *** [7h Kh 4h] [6d]
EmilDef: checks
N1leon: bets $1.66
EmilDef: raises $1.66 to $3.32
N1leon: calls $1.66
*** RIVER *** [7h Kh 4h 6d] [2s]
EmilDef: bets $11.33
N1leon: calls $11.33
*** SHOW DOWN ***
EmilDef: shows [Ks Js] (a pair of Kings)
N1leon: mucks hand
EmilDef collected $32.86 from pot
*** SUMMARY ***
Total pot $34.59 | Rake $1.73
Board [7h Kh 4h 6d 2s]
Seat 1: cCc89 folded before Flop (didn't bet)
Seat 2: N1leon mucked
Seat 3: mixailll99 (button) folded before Flop (didn't bet)
Seat 4: ArcticBearDK (small blind) folded before Flop
Seat 5: EmilDef (big blind) showed [Ks Js] and won ($32.86) with a pair of Kings
Seat 6: manu7899 folded before Flop (didn't bet)


PokerStars Hand #228595130462:  Hold'em No Limit ($0.25/$0.50 USD) - 2021/07/26 18:29:26 ET
Table 'Tokai II' 6-max Seat #5 is the button
Seat 2: N1leon ($55.98 in chips)
Seat 4: ArcticBearDK ($52.50 in chips)
Seat 5: EmilDef ($44.56 in chips)
Seat 6: manu7899 ($69.19 in chips)
manu7899: posts small blind $0.25
cCc89: is sitting out
N1leon: posts big blind $0.50
*** HOLE CARDS ***
ArcticBearDK: raises $0.60 to $1.10
EmilDef: calls $1.10
cCc89 leaves the table
manu7899: raises $5.90 to $7
N1leon: folds
bigBUG1488 joins the table at seat #1
ArcticBearDK: folds
EmilDef: calls $5.90
*** FLOP *** [6c Jh 9c]
manu7899: bets $7.40
EmilDef: raises $7.40 to $14.80
manu7899: raises $47.39 to $62.19 and is all-in
EmilDef: calls $22.76 and is all-in
Uncalled bet ($24.63) returned to manu7899
*** TURN *** [6c Jh 9c] [Ts]
*** RIVER *** [6c Jh 9c Ts] [4s]
*** SHOW DOWN ***
manu7899: shows [Kd Kh] (a pair of Kings)
EmilDef: shows [Jd Jc] (three of a kind, Jacks)
EmilDef collected $89.97 from pot
*** SUMMARY ***
Total pot $90.72 | Rake $0.75
Board [6c Jh 9c Ts 4s]
Seat 2: N1leon (big blind) folded before Flop
Seat 4: ArcticBearDK folded before Flop
Seat 5: EmilDef (button) showed [Jd Jc] and won ($89.97) with three of a kind, Jacks
Seat 6: manu7899 (small blind) showed [Kd Kh] and lost with a pair of Kings


PokerStars Hand #228595222090:  Hold'em No Limit ($0.25/$0.50 USD) - 2021/07/26 18:33:15 ET
Table 'Tokai II' 6-max Seat #5 is the button
Seat 1: bigBUG1488 ($50.75 in chips)
Seat 2: N1leon ($57.36 in chips)
Seat 3: mixailll99 ($50.66 in chips)
Seat 4: ArcticBearDK ($51 in chips)
Seat 5: EmilDef ($88.47 in chips)
Seat 6: manu7899 ($50 in chips)
manu7899: posts small blind $0.25
bigBUG1488: posts big blind $0.50
*** HOLE CARDS ***
N1leon: folds
mixailll99: raises $1 to $1.50
ArcticBearDK: folds
EmilDef: folds
manu7899: folds
bigBUG1488: calls $1
*** FLOP *** [2h Ah Ac]
bigBUG1488: checks
mixailll99: bets $1.05
bigBUG1488: calls $1.05
*** TURN *** [2h Ah Ac] [Jh]
bigBUG1488: checks
mixailll99: bets $3.89
bigBUG1488: calls $3.89
*** RIVER *** [2h Ah Ac Jh] [3d]
bigBUG1488: checks
mixailll99: checks
*** SHOW DOWN ***
bigBUG1488: shows [7s 7c] (two pair, Aces and Sevens)
mixailll99: mucks hand
bigBUG1488 collected $12.47 from pot
*** SUMMARY ***
Total pot $13.13 | Rake $0.66
Board [2h Ah Ac Jh 3d]
Seat 1: bigBUG1488 (big blind) showed [7s 7c] and won ($12.47) with two pair, Aces and Sevens
Seat 2: N1leon folded before Flop (didn't bet)
Seat 3: mixailll99 mucked
Seat 4: ArcticBearDK folded before Flop (didn't bet)
Seat 5: EmilDef (button) folded before Flop (didn't bet)
Seat 6: manu7899 (small blind) folded before Flop


PokerStars Hand #228595365697:  Hold'em No Limit ($0.25/$0.50 USD) - 2021/07/26 18:39:23 ET
Table 'Tokai II' 6-max Seat #4 is the button
Seat 1: bigBUG1488 ($57.89 in chips)
Seat 2: N1leon ($55.27 in chips)
Seat 3: mixailll99 ($54.31 in chips)
Seat 4: ArcticBearDK ($50 in chips)
Seat 5: EmilDef ($87.92 in chips)
Seat 6: Thxmoon1 ($50 in chips)
EmilDef: posts small blind $0.25
Thxmoon1: posts big blind $0.50
*** HOLE CARDS ***
bigBUG1488: folds
N1leon: folds
mixailll99: folds
ArcticBearDK: folds
EmilDef: calls $0.25
Thxmoon1: raises $1.50 to $2
EmilDef: calls $1.50
*** FLOP *** [Ac Ts 7s]
EmilDef: checks
Thxmoon1: bets $1.90
EmilDef: raises $2.10 to $4
Thxmoon1: calls $2.10
*** TURN *** [Ac Ts 7s] [8c]
EmilDef: checks
Thxmoon1: checks
*** RIVER *** [Ac Ts 7s 8c] [9d]
EmilDef: bets $11.40
Thxmoon1: calls $11.40
*** SHOW DOWN ***
EmilDef: shows [5d 8d] (a pair of Eights)
Thxmoon1: shows [Ah 2h] (a pair of Aces)
Thxmoon1 collected $33.06 from pot
*** SUMMARY ***
Total pot $34.80 | Rake $1.74
Board [Ac Ts 7s 8c 9d]
Seat 1: bigBUG1488 folded before Flop (didn't bet)
Seat 2: N1leon folded before Flop (didn't bet)
Seat 3: mixailll99 folded before Flop (didn't bet)
Seat 4: ArcticBearDK (button) folded before Flop (didn't bet)
Seat 5: EmilDef (small blind) showed [5d 8d] and lost with a pair of Eights
Seat 6: Thxmoon1 (big blind) showed [Ah 2h] and won ($33.06) with a pair of Aces


PokerStars Hand #228595432682:  Hold'em No Limit ($0.25/$0.50 USD) - 2021/07/26 18:42:27 ET
Table 'Tokai II' 6-max Seat #3 is the button
Seat 1: bigBUG1488 ($59.74 in chips)
Seat 2: N1leon ($54.52 in chips)
Seat 3: mixailll99 ($53.52 in chips)
Seat 4: ArcticBearDK ($50 in chips)
Seat 5: EmilDef ($71.92 in chips)
Seat 6: Thxmoon1 ($64.16 in chips)
ArcticBearDK: posts small blind $0.25
EmilDef: posts big blind $0.50
*** HOLE CARDS ***
Thxmoon1: folds
bigBUG1488: folds
N1leon: folds
mixailll99: folds
ArcticBearDK: calls $0.25
EmilDef: checks
*** FLOP *** [3s Qs Qd]
ArcticBearDK: checks
EmilDef: checks
*** TURN *** [3s Qs Qd] [3h]
ArcticBearDK: checks
EmilDef: checks
*** RIVER *** [3s Qs Qd 3h] [9h]
ArcticBearDK: checks
EmilDef: checks
*** SHOW DOWN ***
ArcticBearDK: shows [8h Jd] (two pair, Queens and Threes)
EmilDef: mucks hand
ArcticBearDK collected $0.95 from pot
*** SUMMARY ***
Total pot $1 | Rake $0.05
Board [3s Qs Qd 3h 9h]
Seat 1: bigBUG1488 folded before Flop (didn't bet)
Seat 2: N1leon folded before Flop (didn't bet)
Seat 3: mixailll99 (button) folded before Flop (didn't bet)
Seat 4: ArcticBearDK (small blind) showed [8h Jd] and won ($0.95) with two pair, Queens and Threes
Seat 5: EmilDef (big blind) mucked
Seat 6: Thxmoon1 folded before Flop (didn't bet)


PokerStars Hand #228595488162:  Hold'em No Limit ($0.25/$0.50 USD) - 2021/07/26 18:44:59 ET
Table 'Tokai II' 6-max Seat #6 is the button
Seat 1: bigBUG1488 ($59.99 in chips)
Seat 2: N1leon ($51.84 in chips)
Seat 3: mixailll99 ($53.52 in chips)
Seat 4: ArcticBearDK ($50.45 in chips)
Seat 5: EmilDef ($74.31 in chips)
Seat 6: Thxmoon1 ($63.41 in chips)
bigBUG1488: posts small blind $0.25
N1leon: posts big blind $0.50
*** HOLE CARDS ***
mixailll99: folds
ArcticBearDK: folds
EmilDef: calls $0.50
Thxmoon1: folds
bigBUG1488: raises $2 to $2.50
N1leon: folds
EmilDef: calls $2
*** FLOP *** [9s 7c 8h]
bigBUG1488: checks
EmilDef: checks
*** TURN *** [9s 7c 8h] [5s]
bigBUG1488: checks
EmilDef: checks
*** RIVER *** [9s 7c 8h 5s] [Tc]
bigBUG1488: checks
EmilDef: bets $5.22
bigBUG1488: raises $7.78 to $13
EmilDef: raises $7.78 to $20.78
bigBUG1488: calls $7.78
*** SHOW DOWN ***
EmilDef: shows [Js Qs] (a straight, Eight to Queen)
bigBUG1488: mucks hand
EmilDef collected $45.06 from pot
*** SUMMARY ***
Total pot $47.06 | Rake $2
Board [9s 7c 8h 5s Tc]
Seat 1: bigBUG1488 (small blind) mucked
Seat 2: N1leon (big blind) folded before Flop
Seat 3: mixailll99 folded before Flop (didn't bet)
Seat 4: ArcticBearDK folded before Flop (didn't bet)
Seat 5: EmilDef showed [Js Qs] and won ($45.06) with a straight, Eight to Queen
Seat 6: Thxmoon1 (button) folded before Flop (didn't bet)


PokerStars Hand #228595539543:  Hold'em No Limit ($0.25/$0.50 USD) - 2021/07/26 18:47:22 ET
Table 'Tokai II' 6-max Seat #4 is the button
Seat 1: bigBUG1488 ($50.75 in chips)
Seat 2: N1leon ($51.09 in chips)
Seat 3: mixailll99 ($52.77 in chips)
Seat 4: ArcticBearDK ($51.15 in chips)
Seat 5: EmilDef ($95.59 in chips)
Seat 6: Thxmoon1 ($63.41 in chips)
EmilDef: posts small blind $0.25
Thxmoon1: posts big blind $0.50
*** HOLE CARDS ***
bigBUG1488: folds
N1leon: folds
mixailll99: folds
ArcticBearDK: folds
EmilDef: calls $0.25
Thxmoon1: checks
*** FLOP *** [9c Ad 5h]
EmilDef: checks
Thxmoon1: bets $0.50
EmilDef: calls $0.50
*** TURN *** [9c Ad 5h] [3c]
EmilDef: bets $1.90
Thxmoon1: calls $1.90
*** RIVER *** [9c Ad 5h 3c] [Kc]
EmilDef: bets $5.51
Thxmoon1: calls $5.51
*** SHOW DOWN ***
EmilDef: shows [Jc Ah] (a pair of Aces)
Thxmoon1: mucks hand
EmilDef collected $15.98 from pot
*** SUMMARY ***
Total pot $16.82 | Rake $0.84
Board [9c Ad 5h 3c Kc]
Seat 1: bigBUG1488 folded before Flop (didn't bet)
Seat 2: N1leon folded before Flop (didn't bet)
Seat 3: mixailll99 folded before Flop (didn't bet)
Seat 4: ArcticBearDK (button) folded before Flop (didn't bet)
Seat 5: EmilDef (small blind) showed [Jc Ah] and won ($15.98) with a pair of Aces
Seat 6: Thxmoon1 (big blind) mucked


PokerStars Hand #228595576657:  Hold'em No Limit ($0.25/$0.50 USD) - 2021/07/26 18:48:45 ET
Table 'Tokai II' 6-max Seat #2 is the button
Seat 1: bigBUG1488 ($50 in chips)
Seat 2: N1leon ($51.09 in chips)
Seat 3: mixailll99 ($53.02 in chips)
Seat 4: ArcticBearDK ($51.15 in chips)
Seat 5: EmilDef ($103.16 in chips)
Seat 6: Thxmoon1 ($55.50 in chips)
mixailll99: posts small blind $0.25
ArcticBearDK: posts big blind $0.50
*** HOLE CARDS ***
EmilDef: calls $0.50
Thxmoon1: folds
bigBUG1488: folds
N1leon: raises $2 to $2.50
mixailll99: folds
ArcticBearDK: folds
EmilDef: calls $2
*** FLOP *** [Qs 8c 5c]
EmilDef: checks
N1leon: bets $2.73
EmilDef: calls $2.73
*** TURN *** [Qs 8c 5c] [2d]
EmilDef: checks
N1leon: checks
*** RIVER *** [Qs 8c 5c 2d] [5h]
EmilDef: bets $10.65
N1leon: calls $10.65
*** SHOW DOWN ***
EmilDef: shows [Ad Qc] (two pair, Queens and Fives)
N1leon: mucks hand
EmilDef collected $30.88 from pot
*** SUMMARY ***
Total pot $32.51 | Rake $1.63
Board [Qs 8c 5c 2d 5h]
Seat 1: bigBUG1488 folded before Flop (didn't bet)
Seat 2: N1leon (button) mucked
Seat 3: mixailll99 (small blind) folded before Flop
Seat 4: ArcticBearDK (big blind) folded before Flop
Seat 5: EmilDef showed [Ad Qc] and won ($30.88) with two pair, Queens and Fives
Seat 6: Thxmoon1 folded before Flop (didn't bet)


PokerStars Hand #228595619399:  Hold'em No Limit ($0.25/$0.50 USD) - 2021/07/26 18:50:46 ET
Table 'Tokai II' 6-max Seat #2 is the button
Seat 1: bigBUG1488 ($50 in chips)
Seat 2: N1leon ($50 in chips)
Seat 3: mixailll99 ($52.52 in chips)
Seat 4: ArcticBearDK ($51.15 in chips)
Seat 5: EmilDef ($117.41 in chips)
Seat 6: Thxmoon1 ($56.75 in chips)
mixailll99: posts small blind $0.25
ArcticBearDK: posts big blind $0.50
*** HOLE CARDS ***
EmilDef: folds
Thxmoon1: folds
bigBUG1488: folds
N1leon: raises $0.50 to $1
mixailll99: folds
ArcticBearDK: calls $0.50
*** FLOP *** [3d Qh 8h]
ArcticBearDK: checks
N1leon: bets $1.28
ArcticBearDK: calls $1.28
*** TURN *** [3d Qh 8h] [7h]
ArcticBearDK: checks
N1leon: checks
*** RIVER *** [3d Qh 8h 7h] [Ah]
ArcticBearDK: checks
N1leon: bets $1.51
ArcticBearDK: calls $1.51
*** SHOW DOWN ***
N1leon: shows [9s Jc] (high card Ace)
ArcticBearDK: shows [9h Jd] (a flush, Ace high)
ArcticBearDK collected $7.44 from pot
*** SUMMARY ***
Total pot $7.83 | Rake $0.39
Board [3d Qh 8h 7h Ah]
Seat 1: bigBUG1488 folded before Flop (didn't bet)
Seat 2: N1leon (button) showed [9s Jc] and lost with high card Ace
Seat 3: mixailll99 (small blind) folded before Flop
Seat 4: ArcticBearDK (big blind) showed [9h Jd] and won ($7.44) with a flush, Ace high
Seat 5: EmilDef folded before Flop (didn't bet)
Seat 6: Thxmoon1 folded before Flop (didn't bet)


PokerStars Hand #228595703528:  Hold'em No Limit ($0.25/$0.50 USD) - 2021/07/26 18:54:47 ET
Table 'Tokai II' 6-max Seat #5 is the button
Seat 1: bigBUG1488 ($52.85 in chips)
Seat 2: N1leon ($50 in chips)
Seat 3: mixailll99 ($50 in chips)
Seat 4: ArcticBearDK ($56 in chips)
Seat 5: EmilDef ($121.91 in chips)
Seat 6: Thxmoon1 ($54.65 in chips)
Thxmoon1: posts small blind $0.25
bigBUG1488: posts big blind $0.50
*** HOLE CARDS ***
N1leon: folds
mixailll99: folds
ArcticBearDK: folds
EmilDef: calls $0.50
Thxmoon1: raises $2 to $2.50
bigBUG1488: calls $2
EmilDef: calls $2
*** FLOP *** [Qh Js 8s]
Thxmoon1: checks
bigBUG1488: checks
EmilDef: checks
*** TURN *** [Qh Js 8s] [6c]
Thxmoon1: bets $5.50
bigBUG1488: folds
EmilDef: calls $5.50
*** RIVER *** [Qh Js 8s 6c] [Ac]
Thxmoon1: checks
EmilDef: bets $17.58
Thxmoon1: calls $17.58
*** SHOW DOWN ***
EmilDef: shows [Kh Jd] (a pair of Jacks)
Thxmoon1: shows [Kc Kd] (a pair of Kings)
Thxmoon1 collected $51.66 from pot
*** SUMMARY ***
Total pot $53.66 | Rake $2
Board [Qh Js 8s 6c Ac]
Seat 1: bigBUG1488 (big blind) folded on the Turn
Seat 2: N1leon folded before Flop (didn't bet)
Seat 3: mixailll99 folded before Flop (didn't bet)
Seat 4: ArcticBearDK folded before Flop (didn't bet)
Seat 5: EmilDef (button) showed [Kh Jd] and lost with a pair of Jacks
Seat 6: Thxmoon1 (small blind) showed [Kc Kd] and won ($51.66) with a pair of Kings


PokerStars Hand #228595736769:  Hold'em No Limit ($0.25/$0.50 USD) - 2021/07/26 18:56:49 ET
Table 'Tokai II' 6-max Seat #2 is the button
Seat 1: bigBUG1488 ($50.10 in chips)
Seat 2: N1leon ($51.13 in chips)
Seat 3: mixailll99 ($50 in chips)
Seat 4: ArcticBearDK ($56.75 in chips)
Seat 5: EmilDef ($96.33 in chips)
Seat 6: Thxmoon1 ($80.73 in chips)
mixailll99: posts small blind $0.25
ArcticBearDK: posts big blind $0.50
*** HOLE CARDS ***
EmilDef: calls $0.50
Thxmoon1: folds
bigBUG1488: folds
N1leon: folds
mixailll99: folds
ArcticBearDK: checks
*** FLOP *** [Jd 9h 7s]
ArcticBearDK: checks
EmilDef: checks
*** TURN *** [Jd 9h 7s] [Jh]
ArcticBearDK: checks
EmilDef: checks
*** RIVER *** [Jd 9h 7s Jh] [6c]
ArcticBearDK: checks
EmilDef: checks
*** SHOW DOWN ***
ArcticBearDK: shows [7d 5c] (two pair, Jacks and Sevens)
EmilDef: mucks hand
ArcticBearDK collected $1.19 from pot
*** SUMMARY ***
Total pot $1.25 | Rake $0.06
Board [Jd 9h 7s Jh 6c]
Seat 1: bigBUG1488 folded before Flop (didn't bet)
Seat 2: N1leon (button) folded before Flop (didn't bet)
Seat 3: mixailll99 (small blind) folded before Flop
Seat 4: ArcticBearDK (big blind) showed [7d 5c] and won ($1.19) with two pair, Jacks and Sevens
Seat 5: EmilDef mucked
Seat 6: Thxmoon1 folded before Flop (didn't bet)


PokerStars Hand #228595744075:  Hold'em No Limit ($0.25/$0.50 USD) - 2021/07/26 18:57:16 ET
Table 'Tokai II' 6-max Seat #3 is the button
Seat 1: bigBUG1488 ($50.10 in chips)
Seat 2: N1leon ($51.13 in chips)
Seat 3: mixailll99 ($50 in chips)
Seat 4: ArcticBearDK ($57.44 in chips)
Seat 5: EmilDef ($95.83 in chips)
Seat 6: Thxmoon1 ($80.73 in chips)
ArcticBearDK: posts small blind $0.25
EmilDef: posts big blind $0.50
*** HOLE CARDS ***
Thxmoon1: folds
bigBUG1488: folds
N1leon: folds
mixailll99: raises $0.75 to $1.25
ArcticBearDK: folds
EmilDef: calls $0.75
*** FLOP *** [9c Ts 7d]
EmilDef: checks
mixailll99: checks
*** TURN *** [9c Ts 7d] [6d]
EmilDef: checks
mixailll99: checks
*** RIVER *** [9c Ts 7d 6d] [3d]
EmilDef: checks
mixailll99: checks
*** SHOW DOWN ***
EmilDef: shows [9s As] (a pair of Nines)
mixailll99: shows [Ah 9d] (a pair of Nines)
EmilDef collected $1.31 from pot
mixailll99 collected $1.30 from pot
*** SUMMARY ***
Total pot $2.75 | Rake $0.14
Board [9c Ts 7d 6d 3d]
Seat 1: bigBUG1488 folded before Flop (didn't bet)
Seat 2: N1leon folded before Flop (didn't bet)
Seat 3: mixailll99 (button) showed [Ah 9d] and won ($1.30) with a pair of Nines
Seat 4: ArcticBearDK (small blind) folded before Flop
Seat 5: EmilDef (big blind) showed [9s As] and won ($1.31) with a pair of Nines
Seat 6: Thxmoon1 folded before Flop (didn't bet)


PokerStars Hand #228595753465:  Hold'em No Limit ($0.25/$0.50 USD) - 2021/07/26 18:57:52 ET
Table 'Tokai II' 6-max Seat #4 is the button
Seat 1: bigBUG1488 ($50.10 in chips)
Seat 2: N1leon ($51.13 in chips)
Seat 3: mixailll99 ($50.05 in chips)
Seat 4: ArcticBearDK ($57.19 in chips)
Seat 5: EmilDef ($95.89 in chips)
Seat 6: Thxmoon1 ($80.73 in chips)
EmilDef: posts small blind $0.25
Thxmoon1: posts big blind $0.50
*** HOLE CARDS ***
bigBUG1488: folds
N1leon: folds
mixailll99: folds
ArcticBearDK: raises $0.85 to $1.35
EmilDef: calls $1.10
Thxmoon1: folds
*** FLOP *** [9d Jc 7h]
EmilDef: checks
ArcticBearDK: bets $1.50
EmilDef: calls $1.50
*** TURN *** [9d Jc 7h] [3d]
EmilDef: checks
ArcticBearDK: bets $4
EmilDef: calls $4
*** RIVER *** [9d Jc 7h 3d] [9s]
EmilDef: checks
ArcticBearDK: checks
*** SHOW DOWN ***
EmilDef: shows [Qc Qs] (two pair, Queens and Nines)
ArcticBearDK: mucks hand
EmilDef collected $13.49 from pot
*** SUMMARY ***
Total pot $14.20 | Rake $0.71
Board [9d Jc 7h 3d 9s]
Seat 1: bigBUG1488 folded before Flop (didn't bet)
Seat 2: N1leon folded before Flop (didn't bet)
Seat 3: mixailll99 folded before Flop (didn't bet)
Seat 4: ArcticBearDK (button) mucked
Seat 5: EmilDef (small blind) showed [Qc Qs] and won ($13.49) with two pair, Queens and Nines
Seat 6: Thxmoon1 (big blind) folded before Flop


PokerStars Hand #228595807401:  Hold'em No Limit ($0.25/$0.50 USD) - 2021/07/26 19:00:38 ET
Table 'Tokai II' 6-max Seat #4 is the button
Seat 1: bigBUG1488 ($50 in chips)
Seat 3: mixailll99 ($51.25 in chips)
Seat 4: ArcticBearDK ($50 in chips)
Seat 5: EmilDef ($104.52 in chips)
Seat 6: Thxmoon1 ($81.98 in chips)
EmilDef: posts small blind $0.25
Thxmoon1: posts big blind $0.50
Goldeneye_hd: sits out
*** HOLE CARDS ***
bigBUG1488: folds
mixailll99: raises $0.75 to $1.25
ArcticBearDK: folds
EmilDef: calls $1
Thxmoon1: calls $0.75
*** FLOP *** [8h 3s Kc]
EmilDef: checks
Thxmoon1: checks
mixailll99: checks
*** TURN *** [8h 3s Kc] [3d]
EmilDef: checks
Thxmoon1: checks
mixailll99: bets $1.87
EmilDef: calls $1.87
Thxmoon1: folds
*** RIVER *** [8h 3s Kc 3d] [7s]
EmilDef: checks
mixailll99: bets $5.50
EmilDef: calls $5.50
*** SHOW DOWN ***
mixailll99: shows [Kh Kd] (a full house, Kings full of Threes)
EmilDef: mucks hand
mixailll99 collected $17.57 from pot
*** SUMMARY ***
Total pot $18.49 | Rake $0.92
Board [8h 3s Kc 3d 7s]
Seat 1: bigBUG1488 folded before Flop (didn't bet)
Seat 3: mixailll99 showed [Kh Kd] and won ($17.57) with a full house, Kings full of Threes
Seat 4: ArcticBearDK (button) folded before Flop (didn't bet)
Seat 5: EmilDef (small blind) mucked
Seat 6: Thxmoon1 (big blind) folded on the Turn


PokerStars Hand #232217345473:  Hold'em No Limit (€0.25/€0.50 EUR) - 2021/12/14 14:49:00 ET
Table 'Franzia II' 6-max Seat #2 is the button
Seat 1: WWWW197 (€19.75 in chips)
Seat 2: MuUkR (€51.11 in chips)
Seat 3: onepiece314 (€50.25 in chips)
Seat 4: ArcticBearDK (€50 in chips)
Seat 5: mantisxyle (€50 in chips)
Seat 6: shnjke (€50 in chips)
onepiece314: posts small blind €0.25
ArcticBearDK: posts big blind €0.50
*** HOLE CARDS ***
mantisxyle: raises €0.75 to €1.25
shnjke: folds
WWWW197: calls €1.25
MuUkR: folds
onepiece314: folds
ArcticBearDK: folds
*** FLOP *** [Ts Jd 3s]
mantisxyle: checks
WWWW197: checks
*** TURN *** [Ts Jd 3s] [8s]
mantisxyle: bets €1.02
WWWW197: calls €1.02
*** RIVER *** [Ts Jd 3s 8s] [4d]
mantisxyle: checks
shnjke leaves the table
WWWW197: checks
*** SHOW DOWN ***
mantisxyle: shows [Kc Qh] (high card King)
WWWW197: shows [As 8h] (a pair of Eights)
WWWW197 collected €5.03 from pot
*** SUMMARY ***
Total pot €5.29 | Rake €0.26
Board [Ts Jd 3s 8s 4d]
Seat 1: WWWW197 showed [As 8h] and won (€5.03) with a pair of Eights
Seat 2: MuUkR (button) folded before Flop (didn't bet)
Seat 3: onepiece314 (small blind) folded before Flop
Seat 4: ArcticBearDK (big blind) folded before Flop
Seat 5: mantisxyle showed [Kc Qh] and lost with high card King
Seat 6: shnjke folded before Flop (didn't bet)


PokerStars Hand #232217393952:  Hold'em No Limit (€0.25/€0.50 EUR) - 2021/12/14 14:50:35 ET
Table 'Franzia II' 6-max Seat #5 is the button
Seat 1: WWWW197 (€20.51 in chips)
Seat 2: MuUkR (€51.11 in chips)
Seat 3: onepiece314 (€50 in chips)
Seat 4: ArcticBearDK (€55.63 in chips)
Seat 5: mantisxyle (€50 in chips)
Seat 6: Dospexiboga (€50 in chips)
Dospexiboga: posts small blind €0.25
WWWW197: posts big blind €0.50
*** HOLE CARDS ***
MuUkR: folds
onepiece314: folds
ArcticBearDK: folds
mantisxyle: folds
Dospexiboga: raises €1 to €1.50
WWWW197: calls €1
*** FLOP *** [Jd 2s 6s]
Dospexiboga: bets €0.94
WWWW197: calls €0.94
*** TURN *** [Jd 2s 6s] [Qd]
Dospexiboga: bets €1.53
WWWW197: calls €1.53
*** RIVER *** [Jd 2s 6s Qd] [Jh]
Dospexiboga: bets €2.49
WWWW197: calls €2.49
*** SHOW DOWN ***
Dospexiboga: shows [Jc Ah] (three of a kind, Jacks)
WWWW197: mucks hand
Dospexiboga collected €12.27 from pot
*** SUMMARY ***
Total pot €12.92 | Rake €0.65
Board [Jd 2s 6s Qd Jh]
Seat 1: WWWW197 (big blind) mucked
Seat 2: MuUkR folded before Flop (didn't bet)
Seat 3: onepiece314 folded before Flop (didn't bet)
Seat 4: ArcticBearDK folded before Flop (didn't bet)
Seat 5: mantisxyle (button) folded before Flop (didn't bet)
Seat 6: Dospexiboga (small blind) showed [Jc Ah] and won (€12.27) with three of a kind, Jacks


PokerStars Hand #232217556209:  Hold'em No Limit (€0.25/€0.50 EUR) - 2021/12/14 14:56:12 ET
Table 'Franzia II' 6-max Seat #6 is the button
Seat 1: WWWW197 (€20.51 in chips)
Seat 2: MuUkR (€59.09 in chips)
Seat 4: ArcticBearDK (€60.13 in chips)
Seat 5: mantisxyle (€50 in chips)
Seat 6: Dospexiboga (€50 in chips)
WWWW197: posts small blind €0.25
MuUkR: posts big blind €0.50
300feel: sits out
*** HOLE CARDS ***
ArcticBearDK: raises €0.75 to €1.25
mantisxyle: folds
Dospexiboga: raises €2.75 to €4
WWWW197: calls €3.75
MuUkR: folds
ArcticBearDK: calls €2.75
*** FLOP *** [6s 7c Qc]
WWWW197: checks
ArcticBearDK: checks
Dospexiboga: bets €3.92
WWWW197: calls €3.92
ArcticBearDK: folds
*** TURN *** [6s 7c Qc] [3c]
WWWW197: checks
Dospexiboga: checks
*** RIVER *** [6s 7c Qc 3c] [Kd]
WWWW197: bets €12.59 and is all-in
Dospexiboga: calls €12.59
*** SHOW DOWN ***
WWWW197: shows [Jd Ks] (a pair of Kings)
Dospexiboga: shows [Kh As] (a pair of Kings - Ace kicker)
Dospexiboga collected €43.72 from pot
*** SUMMARY ***
Total pot €45.52 | Rake €1.80
Board [6s 7c Qc 3c Kd]
Seat 1: WWWW197 (small blind) showed [Jd Ks] and lost with a pair of Kings
Seat 2: MuUkR (big blind) folded before Flop
Seat 4: ArcticBearDK folded on the Flop
Seat 5: mantisxyle folded before Flop (didn't bet)
Seat 6: Dospexiboga (button) showed [Kh As] and won (€43.72) with a pair of Kings


PokerStars Hand #224491807124:  Hold'em No Limit ($0.25/$0.50 USD) - 2021/03/05 15:58:05 ET
Table 'Almach II' 6-max Seat #4 is the button
Seat 1: GranMaster87 ($61.96 in chips)
Seat 2: yorke132 ($50 in chips)
Seat 3: ruQx01 ($50 in chips)
Seat 4: neo.poker44 ($61.06 in chips)
Seat 5: Collaxd ($50 in chips)
Seat 6: ArcticBearDK ($50 in chips)
Collaxd: posts small blind $0.25
ArcticBearDK: posts big blind $0.50
*** HOLE CARDS ***
GranMaster87: folds
yorke132: folds
ruQx01: raises $0.63 to $1.13
neo.poker44: calls $1.13
Collaxd: raises $4.87 to $6
ArcticBearDK: folds
ruQx01: calls $4.87
neo.poker44: calls $4.87
*** FLOP *** [9d 7d 5c]
Collaxd: checks
ruQx01: checks
neo.poker44: checks
*** TURN *** [9d 7d 5c] [8h]
Collaxd: checks
ruQx01: bets $5
neo.poker44: calls $5
Collaxd: calls $5
*** RIVER *** [9d 7d 5c 8h] [Qh]
Collaxd: checks
ruQx01: checks
neo.poker44: checks
*** SHOW DOWN ***
Collaxd: shows [Th Ts] (a pair of Tens)
ruQx01: mucks hand
neo.poker44: mucks hand
Collaxd collected $31.82 from pot
*** SUMMARY ***
Total pot $33.50 | Rake $1.68
Board [9d 7d 5c 8h Qh]
Seat 1: GranMaster87 folded before Flop (didn't bet)
Seat 2: yorke132 folded before Flop (didn't bet)
Seat 3: ruQx01 mucked
Seat 4: neo.poker44 (button) mucked
Seat 5: Collaxd (small blind) showed [Th Ts] and won ($31.82) with a pair of Tens
Seat 6: ArcticBearDK (big blind) folded before Flop


PokerStars Hand #224492030882:  Hold'em No Limit ($0.25/$0.50 USD) - 2021/03/05 16:04:04 ET
Table 'Almach II' 6-max Seat #1 is the button
Seat 1: GranMaster87 ($59.27 in chips)
Seat 2: yorke132 ($53.21 in chips)
Seat 3: ruQx01 ($50.75 in chips)
Seat 4: neo.poker44 ($51.82 in chips)
Seat 5: Collaxd ($70.82 in chips)
Seat 6: ArcticBearDK ($50 in chips)
yorke132: posts small blind $0.25
ruQx01: posts big blind $0.50
*** HOLE CARDS ***
neo.poker44: folds
Collaxd: folds
ArcticBearDK: raises $0.60 to $1.10
GranMaster87: folds
yorke132: folds
ruQx01: calls $0.60
*** FLOP *** [2d Kc Jd]
ruQx01: checks
ArcticBearDK: bets $1.50
ruQx01: calls $1.50
*** TURN *** [2d Kc Jd] [5h]
ruQx01: checks
ArcticBearDK: bets $4
ruQx01: calls $4
*** RIVER *** [2d Kc Jd 5h] [Qd]
ruQx01: checks
ArcticBearDK: checks
*** SHOW DOWN ***
ruQx01: shows [Kh Td] (a pair of Kings)
ArcticBearDK: shows [Jh Js] (three of a kind, Jacks)
ArcticBearDK collected $12.78 from pot
*** SUMMARY ***
Total pot $13.45 | Rake $0.67
Board [2d Kc Jd 5h Qd]
Seat 1: GranMaster87 (button) folded before Flop (didn't bet)
Seat 2: yorke132 (small blind) folded before Flop
Seat 3: ruQx01 (big blind) showed [Kh Td] and lost with a pair of Kings
Seat 4: neo.poker44 folded before Flop (didn't bet)
Seat 5: Collaxd folded before Flop (didn't bet)
Seat 6: ArcticBearDK showed [Jh Js] and won ($12.78) with three of a kind, Jacks


PokerStars Hand #224492103874:  Hold'em No Limit ($0.25/$0.50 USD) - 2021/03/05 16:05:42 ET
Table 'Almach II' 6-max Seat #3 is the button
Seat 1: GranMaster87 ($59.27 in chips)
Seat 2: yorke132 ($51.71 in chips)
Seat 3: ruQx01 ($51.75 in chips)
Seat 4: neo.poker44 ($51.32 in chips)
Seat 5: Collaxd ($70.82 in chips)
Seat 6: ArcticBearDK ($56.18 in chips)
neo.poker44: posts small blind $0.25
Collaxd: posts big blind $0.50
*** HOLE CARDS ***
ArcticBearDK: folds
GranMaster87: folds
yorke132: folds
ruQx01: folds
neo.poker44: calls $0.25
Collaxd: checks
*** FLOP *** [9s Ks Qs]
neo.poker44: checks
Collaxd: bets $0.50
neo.poker44: calls $0.50
*** TURN *** [9s Ks Qs] [5h]
neo.poker44: checks
Collaxd: checks
*** RIVER *** [9s Ks Qs 5h] [3c]
neo.poker44: checks
Collaxd: checks
*** SHOW DOWN ***
neo.poker44: shows [9c Jd] (a pair of Nines)
Collaxd: shows [6c Qh] (a pair of Queens)
Collaxd collected $1.90 from pot
*** SUMMARY ***
Total pot $2 | Rake $0.10
Board [9s Ks Qs 5h 3c]
Seat 1: GranMaster87 folded before Flop (didn't bet)
Seat 2: yorke132 folded before Flop (didn't bet)
Seat 3: ruQx01 (button) folded before Flop (didn't bet)
Seat 4: neo.poker44 (small blind) showed [9c Jd] and lost with a pair of Nines
Seat 5: Collaxd (big blind) showed [6c Qh] and won ($1.90) with a pair of Queens
Seat 6: ArcticBearDK folded before Flop (didn't bet)


PokerStars Hand #224492168511:  Hold'em No Limit ($0.25/$0.50 USD) - 2021/03/05 16:07:05 ET
Table 'Almach II' 6-max Seat #4 is the button
Seat 1: GranMaster87 ($59.27 in chips)
Seat 2: yorke132 ($51.71 in chips)
Seat 3: ruQx01 ($51.75 in chips)
Seat 4: neo.poker44 ($50.32 in chips)
Seat 5: Collaxd ($71.72 in chips)
Seat 6: ArcticBearDK ($56.18 in chips)
Collaxd: posts small blind $0.25
ArcticBearDK: posts big blind $0.50
*** HOLE CARDS ***
GranMaster87: folds
yorke132: folds
ruQx01: folds
neo.poker44: raises $1.25 to $1.75
Collaxd: folds
ArcticBearDK: calls $1.25
*** FLOP *** [Td 7s Kc]
ArcticBearDK: checks
neo.poker44: bets $3.56
ArcticBearDK: calls $3.56
*** TURN *** [Td 7s Kc] [2s]
ArcticBearDK: checks
neo.poker44: checks
*** RIVER *** [Td 7s Kc 2s] [6s]
ArcticBearDK: checks
neo.poker44: checks
*** SHOW DOWN ***
ArcticBearDK: shows [Kd Qc] (a pair of Kings)
neo.poker44: mucks hand
ArcticBearDK collected $10.33 from pot
*** SUMMARY ***
Total pot $10.87 | Rake $0.54
Board [Td 7s Kc 2s 6s]
Seat 1: GranMaster87 folded before Flop (didn't bet)
Seat 2: yorke132 folded before Flop (didn't bet)
Seat 3: ruQx01 folded before Flop (didn't bet)
Seat 4: neo.poker44 (button) mucked
Seat 5: Collaxd (small blind) folded before Flop
Seat 6: ArcticBearDK (big blind) showed [Kd Qc] and won ($10.33) with a pair of Kings


PokerStars Hand #224492237490:  Hold'em No Limit ($0.25/$0.50 USD) - 2021/03/05 16:08:39 ET
Table 'Almach II' 6-max Seat #4 is the button
Seat 1: GranMaster87 ($59.27 in chips)
Seat 4: neo.poker44 ($45.26 in chips)
Seat 5: Collaxd ($71.47 in chips)
Seat 6: ArcticBearDK ($60.95 in chips)
Collaxd: posts small blind $0.25
ArcticBearDK: posts big blind $0.50
*** HOLE CARDS ***
GranMaster87: folds
neo.poker44: calls $0.50
Collaxd: folds
ArcticBearDK: checks
*** FLOP *** [7d 6d 4d]
ArcticBearDK: checks
neo.poker44: checks
*** TURN *** [7d 6d 4d] [7h]
ArcticBearDK: checks
neo.poker44: checks
*** RIVER *** [7d 6d 4d 7h] [Qc]
ArcticBearDK: checks
neo.poker44: checks
*** SHOW DOWN ***
ArcticBearDK: shows [Th 8d] (a pair of Sevens)
neo.poker44: shows [Js 9c] (a pair of Sevens - Queen+Jack kicker)
neo.poker44 collected $1.19 from pot
*** SUMMARY ***
Total pot $1.25 | Rake $0.06
Board [7d 6d 4d 7h Qc]
Seat 1: GranMaster87 folded before Flop (didn't bet)
Seat 4: neo.poker44 (button) showed [Js 9c] and won ($1.19) with a pair of Sevens
Seat 5: Collaxd (small blind) folded before Flop
Seat 6: ArcticBearDK (big blind) showed [Th 8d] and lost with a pair of Sevens


PokerStars Hand #224492259271:  Hold'em No Limit ($0.25/$0.50 USD) - 2021/03/05 16:09:08 ET
Table 'Almach II' 6-max Seat #5 is the button
Seat 1: GranMaster87 ($59.27 in chips)
Seat 4: neo.poker44 ($45.95 in chips)
Seat 5: Collaxd ($71.22 in chips)
Seat 6: ArcticBearDK ($60.45 in chips)
ArcticBearDK: posts small blind $0.25
GranMaster87: posts big blind $0.50
*** HOLE CARDS ***
neo.poker44: calls $0.50
Collaxd: raises $1.50 to $2
ArcticBearDK: folds
GranMaster87: folds
neo.poker44: calls $1.50
*** FLOP *** [3s 2d As]
neo.poker44: checks
Collaxd: bets $1.49
neo.poker44: calls $1.49
*** TURN *** [3s 2d As] [3d]
neo.poker44: checks
yorke132 leaves the table
dimakryt1 joins the table at seat #2
Collaxd: bets $4.84
neo.poker44: calls $4.84
*** RIVER *** [3s 2d As 3d] [2h]
neo.poker44: checks
Collaxd: bets $8.33
neo.poker44: calls $8.33
*** SHOW DOWN ***
Collaxd: shows [9c Kc] (two pair, Threes and Deuces)
neo.poker44: shows [Ah Tc] (two pair, Aces and Threes)
neo.poker44 collected $33.32 from pot
*** SUMMARY ***
Total pot $34.07 | Rake $0.75
Board [3s 2d As 3d 2h]
Seat 1: GranMaster87 (big blind) folded before Flop
Seat 4: neo.poker44 showed [Ah Tc] and won ($33.32) with two pair, Aces and Threes
Seat 5: Collaxd (button) showed [9c Kc] and lost with two pair, Threes and Deuces
Seat 6: ArcticBearDK (small blind) folded before Flop


PokerStars Hand #224492347032:  Hold'em No Limit ($0.25/$0.50 USD) - 2021/03/05 16:11:07 ET
Table 'Almach II' 6-max Seat #1 is the button
Seat 1: GranMaster87 ($58.27 in chips)
Seat 2: dimakryt1 ($50.50 in chips)
Seat 4: neo.poker44 ($62.61 in chips)
Seat 5: Collaxd ($54.56 in chips)
Seat 6: ArcticBearDK ($60.20 in chips)
dimakryt1: posts small blind $0.25
neo.poker44: posts big blind $0.50
*** HOLE CARDS ***
Collaxd: folds
ArcticBearDK: raises $1 to $1.50
GranMaster87: calls $1.50
dimakryt1: folds
neo.poker44: calls $1
*** FLOP *** [Td 9d 6c]
neo.poker44: bets $4.51
ArcticBearDK: folds
GranMaster87: calls $4.51
*** TURN *** [Td 9d 6c] [As]
neo.poker44: bets $13.08
GranMaster87: calls $13.08
*** RIVER *** [Td 9d 6c As] [4h]
neo.poker44: checks
GranMaster87: checks
*** SHOW DOWN ***
neo.poker44: shows [Ts 6s] (two pair, Tens and Sixes)
GranMaster87: mucks hand
neo.poker44 collected $37.93 from pot
*** SUMMARY ***
Total pot $39.93 | Rake $2
Board [Td 9d 6c As 4h]
Seat 1: GranMaster87 (button) mucked
Seat 2: dimakryt1 (small blind) folded before Flop
Seat 4: neo.poker44 (big blind) showed [Ts 6s] and won ($37.93) with two pair, Tens and Sixes
Seat 5: Collaxd folded before Flop (didn't bet)
Seat 6: ArcticBearDK folded on the Flop


PokerStars Hand #224492420678:  Hold'em No Limit ($0.25/$0.50 USD) - 2021/03/05 16:12:48 ET
Table 'Almach II' 6-max Seat #4 is the button
Seat 1: GranMaster87 ($50 in chips)
Seat 2: dimakryt1 ($53.89 in chips)
Seat 4: neo.poker44 ($81.20 in chips)
Seat 5: Collaxd ($54.06 in chips)
Seat 6: ArcticBearDK ($55.45 in chips)
Collaxd: posts small blind $0.25
ArcticBearDK: posts big blind $0.50
*** HOLE CARDS ***
GranMaster87: folds
dimakryt1: raises $0.75 to $1.25
neo.poker44: folds
neo.poker44 leaves the table
Collaxd: raises $3.75 to $5
ArcticBearDK: folds
dimakryt1: calls $3.75
*** FLOP *** [8d 2h 5s]
Collaxd: bets $3.29
dimakryt1: calls $3.29
*** TURN *** [8d 2h 5s] [4c]
Collaxd: checks
dimakryt1: checks
*** RIVER *** [8d 2h 5s 4c] [Th]
Collaxd: bets $19.48
dimakryt1: calls $19.48
*** SHOW DOWN ***
Collaxd: shows [Jh 9h] (high card Jack)
dimakryt1: shows [7d 7s] (a pair of Sevens)
dimakryt1 collected $54.04 from pot
*** SUMMARY ***
Total pot $56.04 | Rake $2
Board [8d 2h 5s 4c Th]
Seat 1: GranMaster87 folded before Flop (didn't bet)
Seat 2: dimakryt1 showed [7d 7s] and won ($54.04) with a pair of Sevens
Seat 4: neo.poker44 (button) folded before Flop (didn't bet)
Seat 5: Collaxd (small blind) showed [Jh 9h] and lost with high card Jack
Seat 6: ArcticBearDK (big blind) folded before Flop


PokerStars Hand #221172610326:  Hold'em No Limit ($0.25/$0.50 USD) - 2020/12/06 17:39:34 ET
Table 'Sadalsuud' 6-max Seat #2 is the button
Seat 1: NiOk555 ($58.22 in chips)
Seat 2: FuchsJ ($50 in chips)
Seat 3: SerAlGog ($51.25 in chips)
Seat 4: Infusorium ($86.22 in chips)
Seat 5: Xenicide ($59.36 in chips)
Seat 6: trand1k ($84.58 in chips)
SerAlGog: posts small blind $0.25
Infusorium: posts big blind $0.50
*** HOLE CARDS ***
Xenicide: folds
trand1k: raises $0.50 to $1
Xenicide leaves the table
NiOk555: folds
FuchsJ: folds
SerAlGog: folds
Infusorium: calls $0.50
*** FLOP *** [Ad 4h 3c]
Infusorium: checks
trand1k: checks
*** TURN *** [Ad 4h 3c] [As]
ArcticBearDK joins the table at seat #5
Infusorium: checks
trand1k: checks
*** RIVER *** [Ad 4h 3c As] [8c]
Infusorium: checks
trand1k: checks
*** SHOW DOWN ***
Infusorium: shows [Qs 3s] (two pair, Aces and Threes)
trand1k: mucks hand
Infusorium collected $2.14 from pot
*** SUMMARY ***
Total pot $2.25 | Rake $0.11
Board [Ad 4h 3c As 8c]
Seat 1: NiOk555 folded before Flop (didn't bet)
Seat 2: FuchsJ (button) folded before Flop (didn't bet)
Seat 3: SerAlGog (small blind) folded before Flop
Seat 4: Infusorium (big blind) showed [Qs 3s] and won ($2.14) with two pair, Aces and Threes
Seat 5: Xenicide folded before Flop (didn't bet)
Seat 6: trand1k mucked


PokerStars Hand #221172635371:  Hold'em No Limit ($0.25/$0.50 USD) - 2020/12/06 17:40:10 ET
Table 'Sadalsuud' 6-max Seat #3 is the button
Seat 1: NiOk555 ($58.22 in chips)
Seat 2: FuchsJ ($50 in chips)
Seat 3: SerAlGog ($51 in chips)
Seat 4: Infusorium ($87.36 in chips)
Seat 5: ArcticBearDK ($50 in chips)
Seat 6: trand1k ($83.58 in chips)
Infusorium: posts small blind $0.25
ArcticBearDK: posts big blind $0.50
*** HOLE CARDS ***
trand1k: folds
NiOk555: raises $0.50 to $1
FuchsJ: folds
SerAlGog: calls $1
Infusorium: calls $0.75
ArcticBearDK: calls $0.50
*** FLOP *** [Kh 8d Ac]
Infusorium: checks
ArcticBearDK: checks
NiOk555: bets $3
SerAlGog: folds
Infusorium: folds
ArcticBearDK: calls $3
*** TURN *** [Kh 8d Ac] [3d]
ArcticBearDK: checks
NiOk555: checks
*** RIVER *** [Kh 8d Ac 3d] [Jd]
ArcticBearDK: checks
NiOk555: bets $4.75
ArcticBearDK: calls $4.75
*** SHOW DOWN ***
NiOk555: shows [Th Kc] (a pair of Kings)
ArcticBearDK: shows [Ah 5d] (a pair of Aces)
ArcticBearDK collected $18.52 from pot
*** SUMMARY ***
Total pot $19.50 | Rake $0.98
Board [Kh 8d Ac 3d Jd]
Seat 1: NiOk555 showed [Th Kc] and lost with a pair of Kings
Seat 2: FuchsJ folded before Flop (didn't bet)
Seat 3: SerAlGog (button) folded on the Flop
Seat 4: Infusorium (small blind) folded on the Flop
Seat 5: ArcticBearDK (big blind) showed [Ah 5d] and won ($18.52) with a pair of Aces
Seat 6: trand1k folded before Flop (didn't bet)


PokerStars Hand #221172672964:  Hold'em No Limit ($0.25/$0.50 USD) - 2020/12/06 17:41:03 ET
Table 'Sadalsuud' 6-max Seat #4 is the button
Seat 1: NiOk555 ($49.47 in chips)
Seat 2: FuchsJ ($50 in chips)
Seat 3: SerAlGog ($50 in chips)
Seat 4: Infusorium ($86.36 in chips)
Seat 5: ArcticBearDK ($59.77 in chips)
Seat 6: trand1k ($83.58 in chips)
ArcticBearDK: posts small blind $0.25
trand1k: posts big blind $0.50
*** HOLE CARDS ***
NiOk555: raises $1.25 to $1.75
FuchsJ: folds
SerAlGog: folds
Infusorium: folds
ArcticBearDK: calls $1.50
trand1k: calls $1.25
*** FLOP *** [9d 5s As]
ArcticBearDK: checks
trand1k: checks
NiOk555: checks
*** TURN *** [9d 5s As] [8s]
ArcticBearDK: bets $4
trand1k: folds
NiOk555: raises $4 to $8
ArcticBearDK: calls $4
*** RIVER *** [9d 5s As 8s] [5h]
ArcticBearDK: checks
NiOk555: bets $15
ArcticBearDK: calls $15
*** SHOW DOWN ***
NiOk555: shows [Ah 5c] (a full house, Fives full of Aces)
ArcticBearDK: mucks hand
NiOk555 collected $49.25 from pot
*** SUMMARY ***
Total pot $51.25 | Rake $2
Board [9d 5s As 8s 5h]
Seat 1: NiOk555 showed [Ah 5c] and won ($49.25) with a full house, Fives full of Aces
Seat 2: FuchsJ folded before Flop (didn't bet)
Seat 3: SerAlGog folded before Flop (didn't bet)
Seat 4: Infusorium (button) folded before Flop (didn't bet)
Seat 5: ArcticBearDK (small blind) mucked
Seat 6: trand1k (big blind) folded on the Turn


PokerStars Hand #221172913790:  Hold'em No Limit ($0.25/$0.50 USD) - 2020/12/06 17:46:30 ET
Table 'Sadalsuud' 6-max Seat #5 is the button
Seat 1: NiOk555 ($64.03 in chips)
Seat 2: FuchsJ ($50.64 in chips)
Seat 3: Passi17bu ($22.02 in chips)
Seat 4: Infusorium ($88.19 in chips)
Seat 5: ArcticBearDK ($64.75 in chips)
Seat 6: trand1k ($75.83 in chips)
trand1k: posts small blind $0.25
NiOk555: posts big blind $0.50
Passi17bu: posts big blind $0.50
*** HOLE CARDS ***
FuchsJ: folds
Passi17bu: checks
Infusorium: folds
ArcticBearDK: calls $0.50
trand1k: folds
NiOk555: checks
*** FLOP *** [Kd 2c Qd]
NiOk555: checks
Passi17bu: bets $0.50
ArcticBearDK: calls $0.50
NiOk555: folds
*** TURN *** [Kd 2c Qd] [As]
Passi17bu: bets $0.50
ArcticBearDK: calls $0.50
*** RIVER *** [Kd 2c Qd As] [4s]
Passi17bu: bets $0.50
ArcticBearDK: calls $0.50
*** SHOW DOWN ***
Passi17bu: shows [Jd Kh] (a pair of Kings)
ArcticBearDK: mucks hand
Passi17bu collected $4.51 from pot
*** SUMMARY ***
Total pot $4.75 | Rake $0.24
Board [Kd 2c Qd As 4s]
Seat 1: NiOk555 (big blind) folded on the Flop
Seat 2: FuchsJ folded before Flop (didn't bet)
Seat 3: Passi17bu showed [Jd Kh] and won ($4.51) with a pair of Kings
Seat 4: Infusorium folded before Flop (didn't bet)
Seat 5: ArcticBearDK (button) mucked
Seat 6: trand1k (small blind) folded before Flop


PokerStars Hand #221172938983:  Hold'em No Limit ($0.25/$0.50 USD) - 2020/12/06 17:47:05 ET
Table 'Sadalsuud' 6-max Seat #1 is the button
Seat 1: NiOk555 ($64.03 in chips)
Seat 2: FuchsJ ($50.14 in chips)
Seat 3: Passi17bu ($24.53 in chips)
Seat 4: Infusorium ($88.19 in chips)
Seat 5: ArcticBearDK ($62.75 in chips)
Seat 6: trand1k ($75.58 in chips)
FuchsJ: posts small blind $0.25
Passi17bu: posts big blind $0.50
*** HOLE CARDS ***
Infusorium: folds
ArcticBearDK: raises $1 to $1.50
trand1k: folds
NiOk555: calls $1.50
FuchsJ: folds
Passi17bu: calls $1
*** FLOP *** [5s Jc 2c]
Passi17bu: checks
ArcticBearDK: checks
NiOk555: checks
*** TURN *** [5s Jc 2c] [Jd]
Passi17bu: checks
ArcticBearDK: checks
NiOk555: checks
*** RIVER *** [5s Jc 2c Jd] [Kd]
Passi17bu: checks
ArcticBearDK: checks
NiOk555: checks
*** SHOW DOWN ***
Passi17bu: shows [Th Ah] (a pair of Jacks)
ArcticBearDK: mucks hand
NiOk555: mucks hand
Passi17bu collected $4.51 from pot
*** SUMMARY ***
Total pot $4.75 | Rake $0.24
Board [5s Jc 2c Jd Kd]
Seat 1: NiOk555 (button) mucked
Seat 2: FuchsJ (small blind) folded before Flop
Seat 3: Passi17bu (big blind) showed [Th Ah] and won ($4.51) with a pair of Jacks
Seat 4: Infusorium folded before Flop (didn't bet)
Seat 5: ArcticBearDK mucked
Seat 6: trand1k folded before Flop (didn't bet)


PokerStars Hand #221172990336:  Hold'em No Limit ($0.25/$0.50 USD) - 2020/12/06 17:48:18 ET
Table 'Sadalsuud' 6-max Seat #4 is the button
Seat 1: NiOk555 ($63.28 in chips)
Seat 3: Passi17bu ($27.29 in chips)
Seat 4: Infusorium ($88.19 in chips)
Seat 5: ArcticBearDK ($60.75 in chips)
Seat 6: trand1k ($75.58 in chips)
ArcticBearDK: posts small blind $0.25
trand1k: posts big blind $0.50
*** HOLE CARDS ***
NiOk555: raises $0.50 to $1
Passi17bu: calls $1
Infusorium: folds
ArcticBearDK: calls $0.75
trand1k: calls $0.50
*** FLOP *** [Jh Kh 4c]
ArcticBearDK: checks
trand1k: checks
NiOk555: bets $1.90
Passi17bu: calls $1.90
ArcticBearDK: folds
trand1k: folds
*** TURN *** [Jh Kh 4c] [Kd]
NiOk555: checks
Passi17bu: bets $1
NiOk555: calls $1
*** RIVER *** [Jh Kh 4c Kd] [Qd]
NiOk555: checks
Passi17bu: bets $2
NiOk555: calls $2
*** SHOW DOWN ***
Passi17bu: shows [Td Ac] (a straight, Ten to Ace)
NiOk555: mucks hand
Passi17bu collected $13.11 from pot
*** SUMMARY ***
Total pot $13.80 | Rake $0.69
Board [Jh Kh 4c Kd Qd]
Seat 1: NiOk555 mucked
Seat 3: Passi17bu showed [Td Ac] and won ($13.11) with a straight, Ten to Ace
Seat 4: Infusorium (button) folded before Flop (didn't bet)
Seat 5: ArcticBearDK (small blind) folded on the Flop
Seat 6: trand1k (big blind) folded on the Flop


PokerStars Hand #221173140596:  Hold'em No Limit ($0.25/$0.50 USD) - 2020/12/06 17:51:53 ET
Table 'Sadalsuud' 6-max Seat #5 is the button
Seat 1: NiOk555 ($60.89 in chips)
Seat 2: FuchsJ ($64.40 in chips)
Seat 3: Passi17bu ($26.99 in chips)
Seat 4: Infusorium ($79.26 in chips)
Seat 5: ArcticBearDK ($59 in chips)
Seat 6: trand1k ($71.58 in chips)
trand1k: posts small blind $0.25
NiOk555: posts big blind $0.50
*** HOLE CARDS ***
FuchsJ: folds
Passi17bu: calls $0.50
Infusorium: folds
ArcticBearDK: folds
trand1k: folds
NiOk555: raises $0.50 to $1
Passi17bu: calls $0.50
*** FLOP *** [4s 2h Qd]
NiOk555: bets $1.07
Passi17bu: calls $1.07
*** TURN *** [4s 2h Qd] [Jd]
NiOk555: bets $2
Passi17bu: calls $2
*** RIVER *** [4s 2h Qd Jd] [Kc]
NiOk555: bets $7.97
Passi17bu: calls $7.97
*** SHOW DOWN ***
NiOk555: shows [As Ac] (a pair of Aces)
Passi17bu: mucks hand
NiOk555 collected $23.11 from pot
*** SUMMARY ***
Total pot $24.33 | Rake $1.22
Board [4s 2h Qd Jd Kc]
Seat 1: NiOk555 (big blind) showed [As Ac] and won ($23.11) with a pair of Aces
Seat 2: FuchsJ folded before Flop (didn't bet)
Seat 3: Passi17bu mucked
Seat 4: Infusorium folded before Flop (didn't bet)
Seat 5: ArcticBearDK (button) folded before Flop (didn't bet)
Seat 6: trand1k (small blind) folded before Flop


PokerStars Hand #221173221464:  Hold'em No Limit ($0.25/$0.50 USD) - 2020/12/06 17:53:42 ET
Table 'Sadalsuud' 6-max Seat #1 is the button
Seat 1: NiOk555 ($86 in chips)
Seat 2: FuchsJ ($63.90 in chips)
Seat 3: Passi17bu ($14.95 in chips)
Seat 4: Infusorium ($79.26 in chips)
Seat 5: ArcticBearDK ($54.10 in chips)
Seat 6: trand1k ($61.43 in chips)
FuchsJ: posts small blind $0.25
Passi17bu: posts big blind $0.50
*** HOLE CARDS ***
Infusorium: raises $0.75 to $1.25
ArcticBearDK: folds
trand1k: folds
NiOk555: calls $1.25
FuchsJ: folds
Passi17bu: calls $0.75
*** FLOP *** [8s 5d 2c]
Passi17bu: checks
Infusorium: checks
NiOk555: bets $2
Passi17bu: folds
Infusorium: calls $2
*** TURN *** [8s 5d 2c] [2s]
Infusorium: checks
NiOk555: checks
*** RIVER *** [8s 5d 2c 2s] [8c]
Infusorium: bets $2.51
NiOk555: calls $2.51
*** SHOW DOWN ***
Infusorium: shows [Qc Ad] (two pair, Eights and Deuces)
NiOk555: shows [As 6h] (two pair, Eights and Deuces)
Infusorium collected $6.19 from pot
NiOk555 collected $6.18 from pot
*** SUMMARY ***
Total pot $13.02 | Rake $0.65
Board [8s 5d 2c 2s 8c]
Seat 1: NiOk555 (button) showed [As 6h] and won ($6.18) with two pair, Eights and Deuces
Seat 2: FuchsJ (small blind) folded before Flop
Seat 3: Passi17bu (big blind) folded on the Flop
Seat 4: Infusorium showed [Qc Ad] and won ($6.19) with two pair, Eights and Deuces
Seat 5: ArcticBearDK folded before Flop (didn't bet)
Seat 6: trand1k folded before Flop (didn't bet)


PokerStars Hand #221173254652:  Hold'em No Limit ($0.25/$0.50 USD) - 2020/12/06 17:54:30 ET
Table 'Sadalsuud' 6-max Seat #3 is the button
Seat 1: NiOk555 ($86.42 in chips)
Seat 2: FuchsJ ($63.65 in chips)
Seat 3: Passi17bu ($13.45 in chips)
Seat 4: Infusorium ($79.19 in chips)
Seat 5: ArcticBearDK ($54.10 in chips)
Seat 6: trand1k ($62.18 in chips)
Infusorium: posts small blind $0.25
ArcticBearDK: posts big blind $0.50
*** HOLE CARDS ***
trand1k: folds
NiOk555: raises $1.25 to $1.75
FuchsJ: folds
Passi17bu: raises $1.25 to $3
Infusorium: folds
ArcticBearDK: folds
NiOk555: raises $6.75 to $9.75
Passi17bu: raises $3.70 to $13.45 and is all-in
NiOk555: calls $3.70
*** FLOP *** [Kc 2d 5d]
*** TURN *** [Kc 2d 5d] [9h]
*** RIVER *** [Kc 2d 5d 9h] [3c]
*** SHOW DOWN ***
NiOk555: shows [Qs As] (high card Ace)
Passi17bu: shows [Ac 9c] (a pair of Nines)
Passi17bu collected $26.27 from pot
*** SUMMARY ***
Total pot $27.65 | Rake $1.38
Board [Kc 2d 5d 9h 3c]
Seat 1: NiOk555 showed [Qs As] and lost with high card Ace
Seat 2: FuchsJ folded before Flop (didn't bet)
Seat 3: Passi17bu (button) showed [Ac 9c] and won ($26.27) with a pair of Nines
Seat 4: Infusorium (small blind) folded before Flop
Seat 5: ArcticBearDK (big blind) folded before Flop
Seat 6: trand1k folded before Flop (didn't bet)


PokerStars Hand #221173298670:  Hold'em No Limit ($0.25/$0.50 USD) - 2020/12/06 17:55:51 ET
Table 'Sadalsuud' 6-max Seat #2 is the button
Seat 1: NiOk555 ($82.10 in chips)
Seat 2: FuchsJ ($54.50 in chips)
Seat 5: ArcticBearDK ($53.35 in chips)
Seat 6: trand1k ($61.93 in chips)
ArcticBearDK: posts small blind $0.25
trand1k: posts big blind $0.50
*** HOLE CARDS ***
NiOk555: raises $0.50 to $1
FuchsJ: raises $4 to $5
ArcticBearDK: folds
trand1k: calls $4.50
NiOk555: folds
*** FLOP *** [3s 6h 2c]
trand1k: checks
FuchsJ: checks
*** TURN *** [3s 6h 2c] [6c]
trand1k: bets $5
FuchsJ: calls $5
*** RIVER *** [3s 6h 2c 6c] [Jc]
trand1k: checks
FuchsJ: checks
*** SHOW DOWN ***
trand1k: shows [8d 8c] (two pair, Eights and Sixes)
FuchsJ: mucks hand
trand1k collected $20.50 from pot
*** SUMMARY ***
Total pot $21.25 | Rake $0.75
Board [3s 6h 2c 6c Jc]
Seat 1: NiOk555 folded before Flop
Seat 2: FuchsJ (button) mucked
Seat 5: ArcticBearDK (small blind) folded before Flop
Seat 6: trand1k (big blind) showed [8d 8c] and won ($20.50) with two pair, Eights and Sixes


PokerStars Hand #221173325780:  Hold'em No Limit ($0.25/$0.50 USD) - 2020/12/06 17:56:52 ET
Table 'Sadalsuud' 6-max Seat #6 is the button
Seat 1: NiOk555 ($81.35 in chips)
Seat 2: FuchsJ ($50 in chips)
Seat 5: ArcticBearDK ($53.10 in chips)
Seat 6: trand1k ($72.18 in chips)
NiOk555: posts small blind $0.25
FuchsJ: posts big blind $0.50
Ma1n1: sits out
*** HOLE CARDS ***
ArcticBearDK: raises $0.60 to $1.10
trand1k: folds
NiOk555: raises $2.70 to $3.80
FuchsJ: folds
ArcticBearDK: raises $7.60 to $11.40
NiOk555: calls $7.60
*** FLOP *** [As Ks 8d]
NiOk555: bets $22.55
ArcticBearDK: raises $19.15 to $41.70 and is all-in
NiOk555: calls $19.15
*** TURN *** [As Ks 8d] [5d]
*** RIVER *** [As Ks 8d 5d] [Qh]
*** SHOW DOWN ***
NiOk555: shows [Ad Tc] (a pair of Aces)
ArcticBearDK: shows [8s 8h] (three of a kind, Eights)
ArcticBearDK cashed out the hand for $101.29 | Cash Out Fee $1.02
*** SUMMARY ***
Total pot $106.70 | Rake $0.75
Board [As Ks 8d 5d Qh]
Seat 1: NiOk555 (small blind) showed [Ad Tc] and lost with a pair of Aces
Seat 2: FuchsJ (big blind) folded before Flop
Seat 5: ArcticBearDK showed [8s 8h] and won ($105.95) with three of a kind, Eights (pot not awarded as player cashed out)
Seat 6: trand1k (button) folded before Flop (didn't bet)


PokerStars Hand #232883451016:  Hold'em No Limit ($0.25/$0.50 USD) - 2022/01/06 16:57:17 ET
Table 'Kollaa IV' 6-max Seat #5 is the button
Seat 1: pabliq9 ($52.26 in chips)
Seat 2: ArcticBearDK ($50 in chips)
Seat 3: flagg709 ($88.11 in chips)
Seat 4: kapvas ($60.39 in chips)
Seat 5: jessycarbf ($50 in chips)
Seat 6: kerjeno666 ($66.29 in chips)
kerjeno666: posts small blind $0.25
pabliq9: posts big blind $0.50
*** HOLE CARDS ***
ArcticBearDK: raises $0.75 to $1.25
flagg709: raises $4.25 to $5.50
kapvas: folds
jessycarbf: folds
kerjeno666: folds
pabliq9: raises $6 to $11.50
ArcticBearDK: raises $38.50 to $50 and is all-in
flagg709: calls $44.50
pabliq9: folds
*** FLOP *** [3d 4s 2s]
*** TURN *** [3d 4s 2s] [Kh]
*** RIVER *** [3d 4s 2s Kh] [6h]
*** SHOW DOWN ***
ArcticBearDK: shows [As Ah] (a pair of Aces)
flagg709: shows [Qc Ac] (high card Ace)
ArcticBearDK collected $109.75 from pot
*** SUMMARY ***
Total pot $111.75 | Rake $2
Board [3d 4s 2s Kh 6h]
Seat 1: pabliq9 (big blind) folded before Flop
Seat 2: ArcticBearDK showed [As Ah] and won ($109.75) with a pair of Aces
Seat 3: flagg709 showed [Qc Ac] and lost with high card Ace
Seat 4: kapvas folded before Flop (didn't bet)
Seat 5: jessycarbf (button) folded before Flop (didn't bet)
Seat 6: kerjeno666 (small blind) folded before Flop


PokerStars Hand #232883640732:  Hold'em No Limit ($0.25/$0.50 USD) - 2022/01/06 17:03:32 ET
Table 'Kollaa IV' 6-max Seat #3 is the button
Seat 1: pabliq9 ($50 in chips)
Seat 2: ArcticBearDK ($105.75 in chips)
Seat 3: flagg709 ($50.90 in chips)
Seat 4: kapvas ($57 in chips)
Seat 5: jessycarbf ($53.75 in chips)
Seat 6: kerjeno666 ($68.04 in chips)
kapvas: posts small blind $0.25
jessycarbf: posts big blind $0.50
*** HOLE CARDS ***
kerjeno666: folds
pabliq9: folds
ArcticBearDK: folds
flagg709: raises $1 to $1.50
kapvas: raises $4.50 to $6
jessycarbf: folds
flagg709: calls $4.50
*** FLOP *** [Qs Jc 8s]
kapvas: bets $4
flagg709: calls $4
*** TURN *** [Qs Jc 8s] [9d]
kapvas: bets $12.86
flagg709: raises $28.04 to $40.90 and is all-in
kapvas: calls $28.04
*** RIVER *** [Qs Jc 8s 9d] [3d]
*** SHOW DOWN ***
kapvas: shows [9s 7s] (a pair of Nines)
flagg709: shows [Ts Ad] (a straight, Eight to Queen)
flagg709 collected $100.30 from pot
*** SUMMARY ***
Total pot $102.30 | Rake $2
Board [Qs Jc 8s 9d 3d]
Seat 1: pabliq9 folded before Flop (didn't bet)
Seat 2: ArcticBearDK folded before Flop (didn't bet)
Seat 3: flagg709 (button) showed [Ts Ad] and won ($100.30) with a straight, Eight to Queen
Seat 4: kapvas (small blind) showed [9s 7s] and lost with a pair of Nines
Seat 5: jessycarbf (big blind) folded before Flop
Seat 6: kerjeno666 folded before Flop (didn't bet)


PokerStars Hand #214494372793:  Hold'em No Limit ($0.25/$0.50 USD) - 2020/05/26 15:19:18 ET
Table 'Gaviola' 6-max Seat #2 is the button
Seat 1: Sean SN Lai ($32.24 in chips)
Seat 2: Artiom888 ($50 in chips)
Seat 3: 03upuc ($53.22 in chips)
Seat 4: Jo_jpp ($55 in chips)
Seat 5: ArcticBearDK ($50 in chips)
Seat 6: salamandryko ($50.75 in chips)
03upuc: posts small blind $0.25
Jo_jpp: posts big blind $0.50
*** HOLE CARDS ***
ArcticBearDK: raises $0.75 to $1.25
salamandryko: folds
Sean SN Lai: calls $1.25
Artiom888: folds
03upuc: folds
salamandryko leaves the table
Jo_jpp: calls $0.75
*** FLOP *** [Jc 5s 8s]
Jo_jpp: checks
ArcticBearDK: checks
Sean SN Lai: checks
*** TURN *** [Jc 5s 8s] [Kc]
Jo_jpp: bets $2.89
ArcticBearDK: calls $2.89
3zMyers joins the table at seat #6
Sean SN Lai: folds
*** RIVER *** [Jc 5s 8s Kc] [Kd]
Jo_jpp: bets $4.65
ArcticBearDK: calls $4.65
*** SHOW DOWN ***
Jo_jpp: shows [4c 6c] (a pair of Kings)
ArcticBearDK: shows [Ts Ks] (three of a kind, Kings)
ArcticBearDK collected $18.13 from pot
*** SUMMARY ***
Total pot $19.08 | Rake $0.95
Board [Jc 5s 8s Kc Kd]
Seat 1: Sean SN Lai folded on the Turn
Seat 2: Artiom888 (button) folded before Flop (didn't bet)
Seat 3: 03upuc (small blind) folded before Flop
Seat 4: Jo_jpp (big blind) showed [4c 6c] and lost with a pair of Kings
Seat 5: ArcticBearDK showed [Ts Ks] and won ($18.13) with three of a kind, Kings
Seat 6: salamandryko folded before Flop (didn't bet)


PokerStars Hand #214494633443:  Hold'em No Limit ($0.25/$0.50 USD) - 2020/05/26 15:24:02 ET
Table 'Gaviola' 6-max Seat #6 is the button
Seat 1: Sean SN Lai ($40.32 in chips)
Seat 2: Artiom888 ($51.75 in chips)
Seat 3: 03upuc ($50 in chips)
Seat 5: ArcticBearDK ($56.49 in chips)
Seat 6: 3zMyers ($50 in chips)
Sean SN Lai: posts small blind $0.25
Artiom888: posts big blind $0.50
Jo_jpp: sits out
*** HOLE CARDS ***
03upuc: folds
ArcticBearDK: folds
3zMyers: folds
Sean SN Lai: calls $0.25
Artiom888: raises $1.50 to $2
Sean SN Lai: calls $1.50
*** FLOP *** [Tc Jc 4d]
Sean SN Lai: checks
Artiom888: checks
*** TURN *** [Tc Jc 4d] [5c]
Sean SN Lai: checks
Artiom888: bets $2.55
Sean SN Lai: calls $2.55
*** RIVER *** [Tc Jc 4d 5c] [4h]
Sean SN Lai: checks
Artiom888: bets $5.79
Sean SN Lai: calls $5.79
*** SHOW DOWN ***
Artiom888: shows [8h 9h] (a pair of Fours)
Sean SN Lai: shows [5h Th] (two pair, Tens and Fives)
Sean SN Lai collected $19.65 from pot
*** SUMMARY ***
Total pot $20.68 | Rake $1.03
Board [Tc Jc 4d 5c 4h]
Seat 1: Sean SN Lai (small blind) showed [5h Th] and won ($19.65) with two pair, Tens and Fives
Seat 2: Artiom888 (big blind) showed [8h 9h] and lost with a pair of Fours
Seat 3: 03upuc folded before Flop (didn't bet)
Seat 5: ArcticBearDK folded before Flop (didn't bet)
Seat 6: 3zMyers (button) folded before Flop (didn't bet)


PokerStars Hand #223811888703:  Hold'em No Limit ($0.25/$0.50 USD) - 2021/02/14 13:47:29 ET
Table 'Xosa IV' 6-max Seat #3 is the button
Seat 1: LJ_237 ($190.66 in chips)
Seat 2: ArcticBearDK ($50 in chips)
Seat 3: xrpbtc ($60.48 in chips)
Seat 4: DoomeX123 ($19.25 in chips)
Seat 5: goughy88 ($81.87 in chips)
Seat 6: Exotik13 ($87.60 in chips)
DoomeX123: posts small blind $0.25
goughy88: posts big blind $0.50
*** HOLE CARDS ***
Exotik13: folds
LJ_237: folds
ArcticBearDK: folds
xrpbtc: folds
DoomeX123: calls $0.25
goughy88: checks
*** FLOP *** [6d 8s 9c]
DoomeX123: bets $1.50
goughy88: calls $1.50
*** TURN *** [6d 8s 9c] [Kc]
DoomeX123: bets $2
goughy88: calls $2
*** RIVER *** [6d 8s 9c Kc] [Js]
DoomeX123: checks
goughy88: checks
*** SHOW DOWN ***
DoomeX123: shows [8h 2h] (a pair of Eights)
goughy88: shows [9h 5s] (a pair of Nines)
goughy88 collected $7.60 from pot
*** SUMMARY ***
Total pot $8 | Rake $0.40
Board [6d 8s 9c Kc Js]
Seat 1: LJ_237 folded before Flop (didn't bet)
Seat 2: ArcticBearDK folded before Flop (didn't bet)
Seat 3: xrpbtc (button) folded before Flop (didn't bet)
Seat 4: DoomeX123 (small blind) showed [8h 2h] and lost with a pair of Eights
Seat 5: goughy88 (big blind) showed [9h 5s] and won ($7.60) with a pair of Nines
Seat 6: Exotik13 folded before Flop (didn't bet)


PokerStars Hand #223812030798:  Hold'em No Limit ($0.25/$0.50 USD) - 2021/02/14 13:50:17 ET
Table 'Xosa IV' 6-max Seat #1 is the button
Seat 1: LJ_237 ($188.91 in chips)
Seat 2: ArcticBearDK ($50 in chips)
Seat 3: xrpbtc ($60.48 in chips)
Seat 4: DoomeX123 ($23.32 in chips)
Seat 5: goughy88 ($85.22 in chips)
Seat 6: Exotik13 ($83.85 in chips)
ArcticBearDK: posts small blind $0.25
xrpbtc: posts big blind $0.50
*** HOLE CARDS ***
DoomeX123: calls $0.50
goughy88: folds
Exotik13: folds
LJ_237: folds
ArcticBearDK: calls $0.25
xrpbtc: checks
*** FLOP *** [5d Ah Ks]
ArcticBearDK: checks
xrpbtc: checks
DoomeX123: checks
*** TURN *** [5d Ah Ks] [Qc]
ArcticBearDK: checks
xrpbtc: checks
DoomeX123: checks
*** RIVER *** [5d Ah Ks Qc] [9d]
ArcticBearDK: checks
xrpbtc: checks
DoomeX123: checks
*** SHOW DOWN ***
ArcticBearDK: shows [3c 6c] (high card Ace)
xrpbtc: shows [9c Jh] (a pair of Nines)
DoomeX123: mucks hand
xrpbtc collected $1.42 from pot
*** SUMMARY ***
Total pot $1.50 | Rake $0.08
Board [5d Ah Ks Qc 9d]
Seat 1: LJ_237 (button) folded before Flop (didn't bet)
Seat 2: ArcticBearDK (small blind) showed [3c 6c] and lost with high card Ace
Seat 3: xrpbtc (big blind) showed [9c Jh] and won ($1.42) with a pair of Nines
Seat 4: DoomeX123 mucked
Seat 5: goughy88 folded before Flop (didn't bet)
Seat 6: Exotik13 folded before Flop (didn't bet)


PokerStars Hand #223812091020:  Hold'em No Limit ($0.25/$0.50 USD) - 2021/02/14 13:51:30 ET
Table 'Xosa IV' 6-max Seat #4 is the button
Seat 1: LJ_237 ($188.91 in chips)
Seat 2: ArcticBearDK ($50 in chips)
Seat 3: xrpbtc ($61.15 in chips)
Seat 4: DoomeX123 ($22.77 in chips)
Seat 5: goughy88 ($84.72 in chips)
Seat 6: Exotik13 ($84.60 in chips)
goughy88: posts small blind $0.25
Exotik13: posts big blind $0.50
*** HOLE CARDS ***
LJ_237: folds
ArcticBearDK: folds
xrpbtc: raises $0.62 to $1.12
DoomeX123: calls $1.12
goughy88: raises $6.38 to $7.50
Exotik13: folds
xrpbtc: folds
DoomeX123: raises $15.27 to $22.77 and is all-in
goughy88: calls $15.27
*** FLOP *** [4c 7h 2c]
*** TURN *** [4c 7h 2c] [4h]
*** RIVER *** [4c 7h 2c 4h] [8c]
*** SHOW DOWN ***
goughy88: shows [Ad Td] (a pair of Fours)
DoomeX123: shows [Qs Kc] (a pair of Fours - lower kicker)
goughy88 collected $45.16 from pot
*** SUMMARY ***
Total pot $47.16 | Rake $2
Board [4c 7h 2c 4h 8c]
Seat 1: LJ_237 folded before Flop (didn't bet)
Seat 2: ArcticBearDK folded before Flop (didn't bet)
Seat 3: xrpbtc folded before Flop
Seat 4: DoomeX123 (button) showed [Qs Kc] and lost with a pair of Fours
Seat 5: goughy88 (small blind) showed [Ad Td] and won ($45.16) with a pair of Fours
Seat 6: Exotik13 (big blind) folded before Flop


PokerStars Hand #225152172690:  Hold'em No Limit ($0.25/$0.50 USD) - 2021/03/24 18:47:39 ET
Table 'Corvina V' 6-max Seat #5 is the button
Seat 1: gvpsru ($23.72 in chips)
Seat 2: Arlongur ($56.80 in chips)
Seat 3: ArcticBearDK ($50 in chips)
Seat 4: superbuki ($46.40 in chips)
Seat 5: canty1981 ($66.82 in chips)
Seat 6: eeeLOVEnkov ($52.76 in chips)
eeeLOVEnkov: posts small blind $0.25
gvpsru: posts big blind $0.50
*** HOLE CARDS ***
Arlongur: folds
ArcticBearDK: folds
superbuki: folds
canty1981: raises $0.60 to $1.10
eeeLOVEnkov: calls $0.85
gvpsru: calls $0.60
*** FLOP *** [Tc Kc Qs]
eeeLOVEnkov: checks
gvpsru: checks
canty1981: checks
*** TURN *** [Tc Kc Qs] [2s]
eeeLOVEnkov: bets $2.09
gvpsru: calls $2.09
canty1981: folds
*** RIVER *** [Tc Kc Qs 2s] [5c]
eeeLOVEnkov: bets $5.40
gvpsru: calls $5.40
*** SHOW DOWN ***
eeeLOVEnkov: shows [7c 6c] (a flush, King high)
gvpsru: mucks hand
eeeLOVEnkov collected $17.37 from pot
*** SUMMARY ***
Total pot $18.28 | Rake $0.91
Board [Tc Kc Qs 2s 5c]
Seat 1: gvpsru (big blind) mucked
Seat 2: Arlongur folded before Flop (didn't bet)
Seat 3: ArcticBearDK folded before Flop (didn't bet)
Seat 4: superbuki folded before Flop (didn't bet)
Seat 5: canty1981 (button) folded on the Turn
Seat 6: eeeLOVEnkov (small blind) showed [7c 6c] and won ($17.37) with a flush, King high


PokerStars Hand #220509151842:  Hold'em No Limit ($0.25/$0.50 USD) - 2020/11/17 17:40:14 ET
Table 'Hermia II' 6-max Seat #1 is the button
Seat 1: BSK555 ($26.97 in chips)
Seat 2: sil3ntium8 ($52.04 in chips)
Seat 3: picizorr ($50 in chips)
Seat 4: ArcticBearDK ($50 in chips)
sil3ntium8: posts small blind $0.25
picizorr: posts big blind $0.50
MarinaKraken: sits out
kvitun: sits out
*** HOLE CARDS ***
ArcticBearDK: raises $0.60 to $1.10
BSK555: calls $1.10
sil3ntium8: folds
picizorr: calls $0.60
*** FLOP *** [4s As 2s]
picizorr: checks
ArcticBearDK: bets $2.25
BSK555: calls $2.25
picizorr: folds
*** TURN *** [4s As 2s] [5s]
ArcticBearDK: checks
BSK555: checks
*** RIVER *** [4s As 2s 5s] [3h]
ArcticBearDK: checks
BSK555: bets $2
ArcticBearDK: calls $2
*** SHOW DOWN ***
BSK555: shows [5d Ad] (a straight, Ace to Five)
ArcticBearDK: shows [Ah Qh] (a straight, Ace to Five)
ArcticBearDK collected $5.73 from pot
BSK555 collected $5.72 from pot
*** SUMMARY ***
Total pot $12.05 | Rake $0.60
Board [4s As 2s 5s 3h]
Seat 1: BSK555 (button) showed [5d Ad] and won ($5.72) with a straight, Ace to Five
Seat 2: sil3ntium8 (small blind) folded before Flop
Seat 3: picizorr (big blind) folded on the Flop
Seat 4: ArcticBearDK showed [Ah Qh] and won ($5.73) with a straight, Ace to Five


PokerStars Hand #220509228365:  Hold'em No Limit ($0.25/$0.50 USD) - 2020/11/17 17:42:11 ET
Table 'Hermia II' 6-max Seat #5 is the button
Seat 1: BSK555 ($26.03 in chips)
Seat 2: sil3ntium8 ($54.30 in chips)
Seat 3: picizorr ($50 in chips)
Seat 4: ArcticBearDK ($50 in chips)
Seat 5: MarinaKraken ($52 in chips)
Seat 6: kvitun ($50 in chips)
kvitun: posts small blind $0.25
BSK555: posts big blind $0.50
*** HOLE CARDS ***
sil3ntium8: folds
picizorr: folds
ArcticBearDK: folds
MarinaKraken: folds
kvitun: raises $1 to $1.50
BSK555: calls $1
*** FLOP *** [Kd As Jh]
kvitun: checks
BSK555: checks
*** TURN *** [Kd As Jh] [6h]
kvitun: checks
BSK555: checks
*** RIVER *** [Kd As Jh 6h] [5s]
kvitun: checks
BSK555: bets $2
kvitun: calls $2
*** SHOW DOWN ***
BSK555: shows [8c Qd] (high card Ace)
kvitun: shows [Th Kc] (a pair of Kings)
kvitun collected $6.65 from pot
*** SUMMARY ***
Total pot $7 | Rake $0.35
Board [Kd As Jh 6h 5s]
Seat 1: BSK555 (big blind) showed [8c Qd] and lost with high card Ace
Seat 2: sil3ntium8 folded before Flop (didn't bet)
Seat 3: picizorr folded before Flop (didn't bet)
Seat 4: ArcticBearDK folded before Flop (didn't bet)
Seat 5: MarinaKraken (button) folded before Flop (didn't bet)
Seat 6: kvitun (small blind) showed [Th Kc] and won ($6.65) with a pair of Kings


PokerStars Hand #220509254394:  Hold'em No Limit ($0.25/$0.50 USD) - 2020/11/17 17:42:56 ET
Table 'Hermia II' 6-max Seat #6 is the button
Seat 1: BSK555 ($22.53 in chips)
Seat 2: sil3ntium8 ($54.30 in chips)
Seat 3: picizorr ($50 in chips)
Seat 4: ArcticBearDK ($50 in chips)
Seat 5: MarinaKraken ($52 in chips)
Seat 6: kvitun ($53.15 in chips)
BSK555: posts small blind $0.25
sil3ntium8: posts big blind $0.50
*** HOLE CARDS ***
picizorr: folds
ArcticBearDK: raises $0.75 to $1.25
MarinaKraken: folds
kvitun: folds
BSK555: calls $1
sil3ntium8: folds
*** FLOP *** [4h 8s 9s]
BSK555: checks
ArcticBearDK: checks
*** TURN *** [4h 8s 9s] [4c]
BSK555: checks
ArcticBearDK: checks
*** RIVER *** [4h 8s 9s 4c] [5s]
BSK555: bets $0.50
ArcticBearDK: calls $0.50
*** SHOW DOWN ***
BSK555: shows [Jd 5h] (two pair, Fives and Fours)
ArcticBearDK: mucks hand
BSK555 collected $3.80 from pot
*** SUMMARY ***
Total pot $4 | Rake $0.20
Board [4h 8s 9s 4c 5s]
Seat 1: BSK555 (small blind) showed [Jd 5h] and won ($3.80) with two pair, Fives and Fours
Seat 2: sil3ntium8 (big blind) folded before Flop
Seat 3: picizorr folded before Flop (didn't bet)
Seat 4: ArcticBearDK mucked
Seat 5: MarinaKraken folded before Flop (didn't bet)
Seat 6: kvitun (button) folded before Flop (didn't bet)


PokerStars Hand #220509319349:  Hold'em No Limit ($0.25/$0.50 USD) - 2020/11/17 17:44:50 ET
Table 'Hermia II' 6-max Seat #3 is the button
Seat 1: BSK555 ($21.33 in chips)
Seat 2: sil3ntium8 ($55.55 in chips)
Seat 3: picizorr ($56 in chips)
Seat 4: ArcticBearDK ($50 in chips)
Seat 5: MarinaKraken ($50.75 in chips)
Seat 6: kvitun ($53.15 in chips)
ArcticBearDK: posts small blind $0.25
MarinaKraken: posts big blind $0.50
*** HOLE CARDS ***
kvitun: folds
BSK555: calls $0.50
sil3ntium8: folds
picizorr: folds
ArcticBearDK: raises $2 to $2.50
MarinaKraken: folds
BSK555: calls $2
*** FLOP *** [5s 7c 4c]
ArcticBearDK: checks
BSK555: checks
*** TURN *** [5s 7c 4c] [9d]
ArcticBearDK: bets $3.50
BSK555: calls $3.50
*** RIVER *** [5s 7c 4c 9d] [Kc]
ArcticBearDK: checks
BSK555: checks
*** SHOW DOWN ***
ArcticBearDK: shows [Ah 7h] (a pair of Sevens)
BSK555: mucks hand
ArcticBearDK collected $11.88 from pot
*** SUMMARY ***
Total pot $12.50 | Rake $0.62
Board [5s 7c 4c 9d Kc]
Seat 1: BSK555 mucked
Seat 2: sil3ntium8 folded before Flop (didn't bet)
Seat 3: picizorr (button) folded before Flop (didn't bet)
Seat 4: ArcticBearDK (small blind) showed [Ah 7h] and won ($11.88) with a pair of Sevens
Seat 5: MarinaKraken (big blind) folded before Flop
Seat 6: kvitun folded before Flop (didn't bet)


PokerStars Hand #220509349440:  Hold'em No Limit ($0.25/$0.50 USD) - 2020/11/17 17:45:43 ET
Table 'Hermia II' 6-max Seat #5 is the button
Seat 1: BSK555 ($16.08 in chips)
Seat 2: sil3ntium8 ($55.55 in chips)
Seat 3: picizorr ($56 in chips)
Seat 4: ArcticBearDK ($55.88 in chips)
Seat 5: MarinaKraken ($50 in chips)
Seat 6: kvitun ($52.65 in chips)
kvitun: posts small blind $0.25
BSK555: posts big blind $0.50
*** HOLE CARDS ***
sil3ntium8: folds
picizorr: folds
ArcticBearDK: folds
MarinaKraken: raises $0.75 to $1.25
kvitun: folds
BSK555: calls $0.75
*** FLOP *** [9h Qd 2c]
BSK555: checks
MarinaKraken: bets $0.86
BSK555: calls $0.86
*** TURN *** [9h Qd 2c] [4s]
BSK555: checks
MarinaKraken: checks
*** RIVER *** [9h Qd 2c 4s] [Ks]
BSK555: checks
MarinaKraken: checks
*** SHOW DOWN ***
BSK555: shows [7d 2d] (a pair of Deuces)
MarinaKraken: mucks hand
BSK555 collected $4.25 from pot
*** SUMMARY ***
Total pot $4.47 | Rake $0.22
Board [9h Qd 2c 4s Ks]
Seat 1: BSK555 (big blind) showed [7d 2d] and won ($4.25) with a pair of Deuces
Seat 2: sil3ntium8 folded before Flop (didn't bet)
Seat 3: picizorr folded before Flop (didn't bet)
Seat 4: ArcticBearDK folded before Flop (didn't bet)
Seat 5: MarinaKraken (button) mucked
Seat 6: kvitun (small blind) folded before Flop


PokerStars Hand #220509395642:  Hold'em No Limit ($0.25/$0.50 USD) - 2020/11/17 17:47:05 ET
Table 'Hermia II' 6-max Seat #1 is the button
Seat 1: BSK555 ($18.72 in chips)
Seat 2: sil3ntium8 ($55.05 in chips)
Seat 3: picizorr ($56 in chips)
Seat 4: ArcticBearDK ($55.88 in chips)
Seat 5: MarinaKraken ($50 in chips)
Seat 6: kvitun ($52.40 in chips)
sil3ntium8: posts small blind $0.25
picizorr: posts big blind $0.50
*** HOLE CARDS ***
ArcticBearDK: folds
MarinaKraken: folds
kvitun: folds
BSK555: calls $0.50
sil3ntium8: calls $0.25
picizorr: checks
*** FLOP *** [Jh 3s 3h]
sil3ntium8: bets $0.50
picizorr: folds
BSK555: calls $0.50
*** TURN *** [Jh 3s 3h] [6d]
sil3ntium8: bets $0.79
BSK555: calls $0.79
*** RIVER *** [Jh 3s 3h 6d] [Td]
sil3ntium8: checks
BSK555: checks
*** SHOW DOWN ***
sil3ntium8: shows [Js 4s] (two pair, Jacks and Threes)
BSK555: mucks hand
sil3ntium8 collected $3.88 from pot
*** SUMMARY ***
Total pot $4.08 | Rake $0.20
Board [Jh 3s 3h 6d Td]
Seat 1: BSK555 (button) mucked
Seat 2: sil3ntium8 (small blind) showed [Js 4s] and won ($3.88) with two pair, Jacks and Threes
Seat 3: picizorr (big blind) folded on the Flop
Seat 4: ArcticBearDK folded before Flop (didn't bet)
Seat 5: MarinaKraken folded before Flop (didn't bet)
Seat 6: kvitun folded before Flop (didn't bet)


PokerStars Hand #220509487478:  Hold'em No Limit ($0.25/$0.50 USD) - 2020/11/17 17:49:49 ET
Table 'Hermia II' 6-max Seat #2 is the button
Seat 1: BSK555 ($13.93 in chips)
Seat 2: sil3ntium8 ($57.14 in chips)
Seat 3: picizorr ($54.75 in chips)
Seat 4: ArcticBearDK ($57.48 in chips)
Seat 5: MarinaKraken ($51.25 in chips)
Seat 6: kvitun ($53.49 in chips)
picizorr: posts small blind $0.25
ArcticBearDK: posts big blind $0.50
*** HOLE CARDS ***
MarinaKraken: folds
kvitun: raises $0.75 to $1.25
BSK555: calls $1.25
sil3ntium8: folds
picizorr: folds
ArcticBearDK: folds
*** FLOP *** [9h 7s Ad]
kvitun: checks
BSK555: checks
*** TURN *** [9h 7s Ad] [2c]
kvitun: checks
BSK555: checks
*** RIVER *** [9h 7s Ad 2c] [3c]
kvitun: checks
BSK555: checks
*** SHOW DOWN ***
kvitun: shows [Ks Qd] (high card Ace)
BSK555: shows [2s 4s] (a pair of Deuces)
BSK555 collected $3.09 from pot
*** SUMMARY ***
Total pot $3.25 | Rake $0.16
Board [9h 7s Ad 2c 3c]
Seat 1: BSK555 showed [2s 4s] and won ($3.09) with a pair of Deuces
Seat 2: sil3ntium8 (button) folded before Flop (didn't bet)
Seat 3: picizorr (small blind) folded before Flop
Seat 4: ArcticBearDK (big blind) folded before Flop
Seat 5: MarinaKraken folded before Flop (didn't bet)
Seat 6: kvitun showed [Ks Qd] and lost with high card Ace


PokerStars Hand #220509514619:  Hold'em No Limit ($0.25/$0.50 USD) - 2020/11/17 17:50:38 ET
Table 'Hermia II' 6-max Seat #4 is the button
Seat 1: BSK555 ($15.77 in chips)
Seat 2: sil3ntium8 ($57.14 in chips)
Seat 3: picizorr ($54.50 in chips)
Seat 4: ArcticBearDK ($56.73 in chips)
Seat 5: MarinaKraken ($50.75 in chips)
Seat 6: kvitun ($52.99 in chips)
MarinaKraken: posts small blind $0.25
kvitun: posts big blind $0.50
*** HOLE CARDS ***
BSK555: calls $0.50
sil3ntium8: folds
picizorr: folds
ArcticBearDK: raises $1.50 to $2
MarinaKraken: raises $3.25 to $5.25
kvitun: folds
BSK555: calls $4.75
ArcticBearDK: folds
*** FLOP *** [4h 7h 7s]
MarinaKraken: bets $4.08
BSK555: raises $6.44 to $10.52 and is all-in
MarinaKraken: calls $6.44
*** TURN *** [4h 7h 7s] [5s]
*** RIVER *** [4h 7h 7s 5s] [8h]
*** SHOW DOWN ***
MarinaKraken: shows [Qd Qs] (two pair, Queens and Sevens)
BSK555: shows [5d 7d] (a full house, Sevens full of Fives)
BSK555 collected $32.34 from pot
*** SUMMARY ***
Total pot $34.04 | Rake $1.70
Board [4h 7h 7s 5s 8h]
Seat 1: BSK555 showed [5d 7d] and won ($32.34) with a full house, Sevens full of Fives
Seat 2: sil3ntium8 folded before Flop (didn't bet)
Seat 3: picizorr folded before Flop (didn't bet)
Seat 4: ArcticBearDK (button) folded before Flop
Seat 5: MarinaKraken (small blind) showed [Qd Qs] and lost with two pair, Queens and Sevens
Seat 6: kvitun (big blind) folded before Flop


PokerStars Hand #220509660446:  Hold'em No Limit ($0.25/$0.50 USD) - 2020/11/17 17:55:05 ET
Table 'Hermia II' 6-max Seat #2 is the button
Seat 1: BSK555 ($28.46 in chips)
Seat 2: sil3ntium8 ($113.38 in chips)
Seat 3: picizorr ($50 in chips)
Seat 4: ArcticBearDK ($54.73 in chips)
Seat 5: MarinaKraken ($50 in chips)
Seat 6: kvitun ($52.99 in chips)
picizorr: posts small blind $0.25
ArcticBearDK: posts big blind $0.50
*** HOLE CARDS ***
MarinaKraken: folds
kvitun: folds
BSK555: calls $0.50
sil3ntium8: folds
picizorr: folds
ArcticBearDK: checks
*** FLOP *** [Jd 4s Kh]
ArcticBearDK: checks
BSK555: checks
*** TURN *** [Jd 4s Kh] [3h]
ArcticBearDK: checks
BSK555: checks
*** RIVER *** [Jd 4s Kh 3h] [Jc]
ArcticBearDK: checks
BSK555: checks
*** SHOW DOWN ***
ArcticBearDK: shows [2c Ad] (a pair of Jacks)
BSK555: mucks hand
ArcticBearDK collected $1.19 from pot
*** SUMMARY ***
Total pot $1.25 | Rake $0.06
Board [Jd 4s Kh 3h Jc]
Seat 1: BSK555 mucked
Seat 2: sil3ntium8 (button) folded before Flop (didn't bet)
Seat 3: picizorr (small blind) folded before Flop
Seat 4: ArcticBearDK (big blind) showed [2c Ad] and won ($1.19) with a pair of Jacks
Seat 5: MarinaKraken folded before Flop (didn't bet)
Seat 6: kvitun folded before Flop (didn't bet)


PokerStars Hand #220509724255:  Hold'em No Limit ($0.25/$0.50 USD) - 2020/11/17 17:57:35 ET
Table 'Hermia II' 6-max Seat #6 is the button
Seat 1: BSK555 ($33.77 in chips)
Seat 2: sil3ntium8 ($110.25 in chips)
Seat 3: picizorr ($50 in chips)
Seat 4: ArcticBearDK ($53.67 in chips)
Seat 5: MarinaKraken ($50 in chips)
Seat 6: kvitun ($52.24 in chips)
BSK555: posts small blind $0.25
sil3ntium8: posts big blind $0.50
*** HOLE CARDS ***
picizorr: folds
ArcticBearDK: folds
MarinaKraken: folds
kvitun: raises $0.75 to $1.25
BSK555: calls $1
sil3ntium8: folds
*** FLOP *** [4h 5d Ks]
BSK555: checks
kvitun: bets $0.94
BSK555: calls $0.94
*** TURN *** [4h 5d Ks] [5h]
BSK555: checks
kvitun: bets $3.25
BSK555: calls $3.25
*** RIVER *** [4h 5d Ks 5h] [Jd]
BSK555: checks
kvitun: checks
*** SHOW DOWN ***
BSK555: shows [As 2h] (a pair of Fives)
kvitun: mucks hand
BSK555 collected $10.81 from pot
*** SUMMARY ***
Total pot $11.38 | Rake $0.57
Board [4h 5d Ks 5h Jd]
Seat 1: BSK555 (small blind) showed [As 2h] and won ($10.81) with a pair of Fives
Seat 2: sil3ntium8 (big blind) folded before Flop
Seat 3: picizorr folded before Flop (didn't bet)
Seat 4: ArcticBearDK folded before Flop (didn't bet)
Seat 5: MarinaKraken folded before Flop (didn't bet)
Seat 6: kvitun (button) mucked


PokerStars Hand #220509798787:  Hold'em No Limit ($0.25/$0.50 USD) - 2020/11/17 18:00:22 ET
Table 'Hermia II' 6-max Seat #4 is the button
Seat 1: BSK555 ($37.74 in chips)
Seat 2: sil3ntium8 ($109.50 in chips)
Seat 3: picizorr ($50 in chips)
Seat 4: ArcticBearDK ($59.24 in chips)
Seat 5: MarinaKraken ($50 in chips)
Seat 6: kvitun ($50 in chips)
MarinaKraken: posts small blind $0.25
kvitun: posts big blind $0.50
*** HOLE CARDS ***
BSK555: calls $0.50
sil3ntium8: folds
picizorr: folds
ArcticBearDK: folds
MarinaKraken: folds
kvitun: checks
*** FLOP *** [7d 9d 8s]
kvitun: checks
BSK555: checks
*** TURN *** [7d 9d 8s] [Ad]
kvitun: checks
BSK555: checks
*** RIVER *** [7d 9d 8s Ad] [Qh]
kvitun: checks
BSK555: bets $0.50
kvitun: calls $0.50
*** SHOW DOWN ***
BSK555: shows [As 2h] (a pair of Aces)
kvitun: mucks hand
BSK555 collected $2.14 from pot
*** SUMMARY ***
Total pot $2.25 | Rake $0.11
Board [7d 9d 8s Ad Qh]
Seat 1: BSK555 showed [As 2h] and won ($2.14) with a pair of Aces
Seat 2: sil3ntium8 folded before Flop (didn't bet)
Seat 3: picizorr folded before Flop (didn't bet)
Seat 4: ArcticBearDK (button) folded before Flop (didn't bet)
Seat 5: MarinaKraken (small blind) folded before Flop
Seat 6: kvitun (big blind) mucked


PokerStars Hand #220509943743:  Hold'em No Limit ($0.25/$0.50 USD) - 2020/11/17 18:05:04 ET
Table 'Hermia II' 6-max Seat #3 is the button
Seat 1: BSK555 ($15.71 in chips)
Seat 2: sil3ntium8 ($127.33 in chips)
Seat 3: picizorr ($50 in chips)
Seat 4: ArcticBearDK ($58.74 in chips)
Seat 5: MarinaKraken ($50 in chips)
Seat 6: kvitun ($58.31 in chips)
ArcticBearDK: posts small blind $0.25
MarinaKraken: posts big blind $0.50
*** HOLE CARDS ***
kvitun: folds
BSK555: calls $0.50
sil3ntium8: folds
picizorr: raises $1.25 to $1.75
ArcticBearDK: calls $1.50
MarinaKraken: folds
BSK555: raises $13.96 to $15.71 and is all-in
picizorr: folds
ArcticBearDK: calls $13.96
*** FLOP *** [2d 8h 5s]
*** TURN *** [2d 8h 5s] [5d]
*** RIVER *** [2d 8h 5s 5d] [7h]
*** SHOW DOWN ***
ArcticBearDK: shows [Kc Qs] (a pair of Fives)
BSK555: shows [Ts Td] (two pair, Tens and Fives)
BSK555 collected $31.99 from pot
*** SUMMARY ***
Total pot $33.67 | Rake $1.68
Board [2d 8h 5s 5d 7h]
Seat 1: BSK555 showed [Ts Td] and won ($31.99) with two pair, Tens and Fives
Seat 2: sil3ntium8 folded before Flop (didn't bet)
Seat 3: picizorr (button) folded before Flop
Seat 4: ArcticBearDK (small blind) showed [Kc Qs] and lost with a pair of Fives
Seat 5: MarinaKraken (big blind) folded before Flop
Seat 6: kvitun folded before Flop (didn't bet)


PokerStars Hand #220510041842:  Hold'em No Limit ($0.25/$0.50 USD) - 2020/11/17 18:08:12 ET
Table 'Hermia II' 6-max Seat #1 is the button
Seat 1: BSK555 ($31.42 in chips)
Seat 2: sil3ntium8 ($129.57 in chips)
Seat 3: picizorr ($50 in chips)
Seat 4: ArcticBearDK ($51.59 in chips)
Seat 5: MarinaKraken ($50 in chips)
Seat 6: kvitun ($57.56 in chips)
sil3ntium8: posts small blind $0.25
picizorr: posts big blind $0.50
*** HOLE CARDS ***
ArcticBearDK: folds
MarinaKraken: folds
kvitun: folds
BSK555: calls $0.50
sil3ntium8: folds
picizorr: checks
*** FLOP *** [8c 2d Ah]
picizorr: checks
BSK555: checks
*** TURN *** [8c 2d Ah] [Qd]
picizorr: checks
BSK555: checks
*** RIVER *** [8c 2d Ah Qd] [4h]
picizorr: checks
BSK555: bets $0.50
picizorr: calls $0.50
*** SHOW DOWN ***
BSK555: shows [8d 7d] (a pair of Eights)
picizorr: mucks hand
BSK555 collected $2.14 from pot
*** SUMMARY ***
Total pot $2.25 | Rake $0.11
Board [8c 2d Ah Qd 4h]
Seat 1: BSK555 (button) showed [8d 7d] and won ($2.14) with a pair of Eights
Seat 2: sil3ntium8 (small blind) folded before Flop
Seat 3: picizorr (big blind) mucked
Seat 4: ArcticBearDK folded before Flop (didn't bet)
Seat 5: MarinaKraken folded before Flop (didn't bet)
Seat 6: kvitun folded before Flop (didn't bet)


PokerStars Hand #220510079145:  Hold'em No Limit ($0.25/$0.50 USD) - 2020/11/17 18:09:12 ET
Table 'Hermia II' 6-max Seat #4 is the button
Seat 1: BSK555 ($32.56 in chips)
Seat 2: sil3ntium8 ($130.07 in chips)
Seat 3: picizorr ($50 in chips)
Seat 4: ArcticBearDK ($50.84 in chips)
Seat 5: MarinaKraken ($50.25 in chips)
Seat 6: kvitun ($57.56 in chips)
MarinaKraken: posts small blind $0.25
kvitun: posts big blind $0.50
*** HOLE CARDS ***
BSK555: calls $0.50
sil3ntium8: raises $1.75 to $2.25
picizorr: folds
ArcticBearDK: folds
MarinaKraken: folds
kvitun: folds
BSK555: calls $1.75
*** FLOP *** [3s 5d 9d]
BSK555: checks
sil3ntium8: bets $2.25
BSK555: calls $2.25
*** TURN *** [3s 5d 9d] [9c]
BSK555: checks
sil3ntium8: bets $4.63
BSK555: calls $4.63
*** RIVER *** [3s 5d 9d 9c] [Jc]
BSK555: checks
sil3ntium8: checks
*** SHOW DOWN ***
BSK555: shows [7s 7h] (two pair, Nines and Sevens)
sil3ntium8: shows [Td Th] (two pair, Tens and Nines)
sil3ntium8 collected $18.06 from pot
*** SUMMARY ***
Total pot $19.01 | Rake $0.95
Board [3s 5d 9d 9c Jc]
Seat 1: BSK555 showed [7s 7h] and lost with two pair, Nines and Sevens
Seat 2: sil3ntium8 showed [Td Th] and won ($18.06) with two pair, Tens and Nines
Seat 3: picizorr folded before Flop (didn't bet)
Seat 4: ArcticBearDK (button) folded before Flop (didn't bet)
Seat 5: MarinaKraken (small blind) folded before Flop
Seat 6: kvitun (big blind) folded before Flop


PokerStars Hand #220510109244:  Hold'em No Limit ($0.25/$0.50 USD) - 2020/11/17 18:10:10 ET
Table 'Hermia II' 6-max Seat #6 is the button
Seat 1: BSK555 ($22.93 in chips)
Seat 2: sil3ntium8 ($139 in chips)
Seat 3: picizorr ($50 in chips)
Seat 4: ArcticBearDK ($50.84 in chips)
Seat 5: MarinaKraken ($50 in chips)
Seat 6: kvitun ($57.56 in chips)
BSK555: posts small blind $0.25
sil3ntium8: posts big blind $0.50
*** HOLE CARDS ***
picizorr: folds
ArcticBearDK: folds
MarinaKraken: folds
kvitun: folds
BSK555: calls $0.25
sil3ntium8: checks
*** FLOP *** [8s 3d 3s]
BSK555: checks
sil3ntium8: checks
*** TURN *** [8s 3d 3s] [4c]
BSK555: checks
sil3ntium8: bets $0.76
BSK555: calls $0.76
*** RIVER *** [8s 3d 3s 4c] [Ks]
BSK555: checks
sil3ntium8: checks
*** SHOW DOWN ***
BSK555: shows [8d 7c] (two pair, Eights and Threes)
sil3ntium8: mucks hand
BSK555 collected $2.39 from pot
*** SUMMARY ***
Total pot $2.52 | Rake $0.13
Board [8s 3d 3s 4c Ks]
Seat 1: BSK555 (small blind) showed [8d 7c] and won ($2.39) with two pair, Eights and Threes
Seat 2: sil3ntium8 (big blind) mucked
Seat 3: picizorr folded before Flop (didn't bet)
Seat 4: ArcticBearDK folded before Flop (didn't bet)
Seat 5: MarinaKraken folded before Flop (didn't bet)
Seat 6: kvitun (button) folded before Flop (didn't bet)


PokerStars Hand #220510230711:  Hold'em No Limit ($0.25/$0.50 USD) - 2020/11/17 18:14:08 ET
Table 'Hermia II' 6-max Seat #5 is the button
Seat 1: BSK555 ($15.19 in chips)
Seat 2: sil3ntium8 ($132.74 in chips)
Seat 3: picizorr ($50 in chips)
Seat 4: ArcticBearDK ($50.84 in chips)
Seat 5: MarinaKraken ($60.25 in chips)
Seat 6: kvitun ($62.56 in chips)
kvitun: posts small blind $0.25
BSK555: posts big blind $0.50
*** HOLE CARDS ***
sil3ntium8: folds
picizorr: folds
ArcticBearDK: raises $0.60 to $1.10
MarinaKraken: folds
kvitun: folds
BSK555: calls $0.60
*** FLOP *** [Kc Jc 3h]
BSK555: checks
ArcticBearDK: checks
*** TURN *** [Kc Jc 3h] [Ts]
BSK555: checks
ArcticBearDK: checks
*** RIVER *** [Kc Jc 3h Ts] [8h]
BSK555: checks
ArcticBearDK: bets $1.50
BSK555: calls $1.50
*** SHOW DOWN ***
ArcticBearDK: shows [4d 5d] (high card King)
BSK555: shows [2c As] (high card Ace)
BSK555 collected $5.18 from pot
*** SUMMARY ***
Total pot $5.45 | Rake $0.27
Board [Kc Jc 3h Ts 8h]
Seat 1: BSK555 (big blind) showed [2c As] and won ($5.18) with high card Ace
Seat 2: sil3ntium8 folded before Flop (didn't bet)
Seat 3: picizorr folded before Flop (didn't bet)
Seat 4: ArcticBearDK showed [4d 5d] and lost with high card King
Seat 5: MarinaKraken (button) folded before Flop (didn't bet)
Seat 6: kvitun (small blind) folded before Flop


PokerStars Hand #220510280047:  Hold'em No Limit ($0.25/$0.50 USD) - 2020/11/17 18:15:45 ET
Table 'Hermia II' 6-max Seat #2 is the button
Seat 1: BSK555 ($6.41 in chips)
Seat 2: sil3ntium8 ($143.90 in chips)
Seat 3: picizorr ($50 in chips)
Seat 4: ArcticBearDK ($50.75 in chips)
Seat 5: MarinaKraken ($60.25 in chips)
Seat 6: kvitun ($62.31 in chips)
picizorr: posts small blind $0.25
ArcticBearDK: posts big blind $0.50
*** HOLE CARDS ***
MarinaKraken: folds
kvitun: folds
BSK555: raises $5.91 to $6.41 and is all-in
sil3ntium8: folds
picizorr: folds
ArcticBearDK: calls $5.91
*** FLOP *** [5s 9s Th]
*** TURN *** [5s 9s Th] [As]
*** RIVER *** [5s 9s Th As] [Qc]
*** SHOW DOWN ***
ArcticBearDK: shows [Ad Kc] (a pair of Aces)
BSK555: shows [2h 2d] (a pair of Deuces)
ArcticBearDK collected $12.42 from pot
*** SUMMARY ***
Total pot $13.07 | Rake $0.65
Board [5s 9s Th As Qc]
Seat 1: BSK555 showed [2h 2d] and lost with a pair of Deuces
Seat 2: sil3ntium8 (button) folded before Flop (didn't bet)
Seat 3: picizorr (small blind) folded before Flop
Seat 4: ArcticBearDK (big blind) showed [Ad Kc] and won ($12.42) with a pair of Aces
Seat 5: MarinaKraken folded before Flop (didn't bet)
Seat 6: kvitun folded before Flop (didn't bet)


PokerStars Hand #220510359953:  Hold'em No Limit ($0.25/$0.50 USD) - 2020/11/17 18:18:25 ET
Table 'Hermia II' 6-max Seat #4 is the button
Seat 2: sil3ntium8 ($143.15 in chips)
Seat 4: ArcticBearDK ($56.01 in chips)
Seat 5: MarinaKraken ($61 in chips)
MarinaKraken: posts small blind $0.25
sil3ntium8: posts big blind $0.50
*** HOLE CARDS ***
Lurst joins the table at seat #6
ArcticBearDK: raises $0.85 to $1.35
MarinaKraken: folds
sil3ntium8: calls $0.85
*** FLOP *** [6s 9c 7c]
sil3ntium8: checks
ArcticBearDK: checks
*** TURN *** [6s 9c 7c] [9h]
sil3ntium8: bets $4.28
ArcticBearDK: calls $4.28
*** RIVER *** [6s 9c 7c 9h] [Ts]
sil3ntium8: bets $7.32
ArcticBearDK: raises $11.68 to $19
sil3ntium8: calls $11.68
*** SHOW DOWN ***
ArcticBearDK: shows [Ah Js] (a pair of Nines)
sil3ntium8: shows [Qs 8s] (a straight, Six to Ten)
sil3ntium8 collected $48.76 from pot
*** SUMMARY ***
Total pot $49.51 | Rake $0.75
Board [6s 9c 7c 9h Ts]
Seat 2: sil3ntium8 (big blind) showed [Qs 8s] and won ($48.76) with a straight, Six to Ten
Seat 4: ArcticBearDK (button) showed [Ah Js] and lost with a pair of Nines
Seat 5: MarinaKraken (small blind) folded before Flop


PokerStars Hand #216113525098:  Hold'em No Limit ($0.25/$0.50 USD) - 2020/07/05 16:21:40 ET
Table 'Urhixidur V' 6-max Seat #3 is the button
Seat 1: Hander_005 ($52.13 in chips)
Seat 2: ArcticBearDK ($50.75 in chips)
Seat 3: AstrumNatale ($52.44 in chips)
Seat 4: robin999999 ($55.89 in chips)
Seat 5: teglio55 ($61.40 in chips)
Seat 6: oleg001/61 ($60.70 in chips)
robin999999: posts small blind $0.25
teglio55: posts big blind $0.50
*** HOLE CARDS ***
oleg001/61: calls $0.50
Hander_005: folds
ArcticBearDK: folds
AstrumNatale: raises $1.25 to $1.75
robin999999: folds
teglio55: folds
oleg001/61: calls $1.25
*** FLOP *** [Qs Kh 8h]
oleg001/61: checks
AstrumNatale: checks
*** TURN *** [Qs Kh 8h] [Ts]
oleg001/61: checks
AstrumNatale: checks
*** RIVER *** [Qs Kh 8h Ts] [Jd]
oleg001/61: checks
AstrumNatale: checks
*** SHOW DOWN ***
oleg001/61: shows [5c 6d] (high card King)
AstrumNatale: shows [7s 7d] (a pair of Sevens)
AstrumNatale collected $4.04 from pot
*** SUMMARY ***
Total pot $4.25 | Rake $0.21
Board [Qs Kh 8h Ts Jd]
Seat 1: Hander_005 folded before Flop (didn't bet)
Seat 2: ArcticBearDK folded before Flop (didn't bet)
Seat 3: AstrumNatale (button) showed [7s 7d] and won ($4.04) with a pair of Sevens
Seat 4: robin999999 (small blind) folded before Flop
Seat 5: teglio55 (big blind) folded before Flop
Seat 6: oleg001/61 showed [5c 6d] and lost with high card King


PokerStars Hand #216113699472:  Hold'em No Limit ($0.25/$0.50 USD) - 2020/07/05 16:25:13 ET
Table 'Urhixidur V' 6-max Seat #3 is the button
Seat 1: Hander_005 ($51.38 in chips)
Seat 2: ArcticBearDK ($50 in chips)
Seat 3: AstrumNatale ($55.98 in chips)
Seat 4: robin999999 ($51.39 in chips)
Seat 5: teglio55 ($54.15 in chips)
Seat 6: oleg001/61 ($78.14 in chips)
robin999999: posts small blind $0.25
teglio55: posts big blind $0.50
*** HOLE CARDS ***
oleg001/61: folds
Hander_005: folds
ArcticBearDK: folds
AstrumNatale: raises $0.75 to $1.25
robin999999: calls $1
teglio55: folds
*** FLOP *** [Qc 4d Kd]
robin999999: checks
AstrumNatale: checks
*** TURN *** [Qc 4d Kd] [4s]
robin999999: checks
AstrumNatale: checks
*** RIVER *** [Qc 4d Kd 4s] [7h]
robin999999: checks
AstrumNatale: checks
*** SHOW DOWN ***
robin999999: shows [Ac Js] (a pair of Fours)
AstrumNatale: mucks hand
robin999999 collected $2.85 from pot
*** SUMMARY ***
Total pot $3 | Rake $0.15
Board [Qc 4d Kd 4s 7h]
Seat 1: Hander_005 folded before Flop (didn't bet)
Seat 2: ArcticBearDK folded before Flop (didn't bet)
Seat 3: AstrumNatale (button) mucked
Seat 4: robin999999 (small blind) showed [Ac Js] and won ($2.85) with a pair of Fours
Seat 5: teglio55 (big blind) folded before Flop
Seat 6: oleg001/61 folded before Flop (didn't bet)


PokerStars Hand #216113799297:  Hold'em No Limit ($0.25/$0.50 USD) - 2020/07/05 16:27:15 ET
Table 'Urhixidur V' 6-max Seat #3 is the button
Seat 1: Hander_005 ($50.63 in chips)
Seat 2: ArcticBearDK ($50.75 in chips)
Seat 3: AstrumNatale ($53.98 in chips)
Seat 4: robin999999 ($52.49 in chips)
Seat 5: teglio55 ($54.15 in chips)
Seat 6: oleg001/61 ($79.58 in chips)
robin999999: posts small blind $0.25
teglio55: posts big blind $0.50
*** HOLE CARDS ***
oleg001/61: calls $0.50
Hander_005: raises $1.75 to $2.25
ArcticBearDK: folds
AstrumNatale: folds
robin999999: folds
teglio55: folds
oleg001/61: calls $1.75
*** FLOP *** [Qd 4h Jh]
oleg001/61: checks
Hander_005: bets $1.60
oleg001/61: calls $1.60
*** TURN *** [Qd 4h Jh] [9s]
oleg001/61: checks
Hander_005: bets $9
oleg001/61: calls $9
*** RIVER *** [Qd 4h Jh 9s] [5h]
oleg001/61: checks
Hander_005: bets $14.75
oleg001/61: calls $14.75
*** SHOW DOWN ***
Hander_005: shows [4d 4c] (three of a kind, Fours)
oleg001/61: mucks hand
Hander_005 collected $53.95 from pot
*** SUMMARY ***
Total pot $55.95 | Rake $2
Board [Qd 4h Jh 9s 5h]
Seat 1: Hander_005 showed [4d 4c] and won ($53.95) with three of a kind, Fours
Seat 2: ArcticBearDK folded before Flop (didn't bet)
Seat 3: AstrumNatale (button) folded before Flop (didn't bet)
Seat 4: robin999999 (small blind) folded before Flop
Seat 5: teglio55 (big blind) folded before Flop
Seat 6: oleg001/61 mucked


PokerStars Hand #216113914794:  Hold'em No Limit ($0.25/$0.50 USD) - 2020/07/05 16:29:39 ET
Table 'Urhixidur V' 6-max Seat #3 is the button
Seat 1: Hander_005 ($77.73 in chips)
Seat 2: ArcticBearDK ($50.75 in chips)
Seat 3: AstrumNatale ($53.23 in chips)
Seat 4: robin999999 ($51.74 in chips)
Seat 5: teglio55 ($51.40 in chips)
Seat 6: oleg001/61 ($54.42 in chips)
robin999999: posts small blind $0.25
teglio55: posts big blind $0.50
*** HOLE CARDS ***
oleg001/61: calls $0.50
Hander_005: folds
ArcticBearDK: folds
AstrumNatale: folds
robin999999: calls $0.25
teglio55: checks
*** FLOP *** [Td 7c 5s]
robin999999: checks
teglio55: checks
oleg001/61: bets $1.50
robin999999: folds
teglio55: calls $1.50
*** TURN *** [Td 7c 5s] [Th]
teglio55: bets $2.14
oleg001/61: calls $2.14
*** RIVER *** [Td 7c 5s Th] [4s]
teglio55: checks
oleg001/61: bets $2.50
teglio55: calls $2.50
*** SHOW DOWN ***
oleg001/61: shows [Qs Qd] (two pair, Queens and Tens)
teglio55: mucks hand
oleg001/61 collected $13.09 from pot
*** SUMMARY ***
Total pot $13.78 | Rake $0.69
Board [Td 7c 5s Th 4s]
Seat 1: Hander_005 folded before Flop (didn't bet)
Seat 2: ArcticBearDK folded before Flop (didn't bet)
Seat 3: AstrumNatale (button) folded before Flop (didn't bet)
Seat 4: robin999999 (small blind) folded on the Flop
Seat 5: teglio55 (big blind) mucked
Seat 6: oleg001/61 showed [Qs Qd] and won ($13.09) with two pair, Queens and Tens


PokerStars Hand #216113959652:  Hold'em No Limit ($0.25/$0.50 USD) - 2020/07/05 16:30:35 ET
Table 'Urhixidur V' 6-max Seat #4 is the button
Seat 1: Hander_005 ($77.73 in chips)
Seat 2: ArcticBearDK ($50.75 in chips)
Seat 3: AstrumNatale ($53.23 in chips)
Seat 4: robin999999 ($51.24 in chips)
Seat 5: teglio55 ($50 in chips)
Seat 6: oleg001/61 ($60.87 in chips)
teglio55: posts small blind $0.25
oleg001/61: posts big blind $0.50
*** HOLE CARDS ***
Hander_005: folds
ArcticBearDK: raises $1 to $1.50
AstrumNatale: folds
robin999999: calls $1.50
teglio55: folds
oleg001/61: calls $1
*** FLOP *** [Js 2s Kc]
oleg001/61: checks
ArcticBearDK: bets $2.75
robin999999: calls $2.75
oleg001/61: folds
*** TURN *** [Js 2s Kc] [Kh]
ArcticBearDK: bets $6.50
robin999999: raises $10.01 to $16.51
ArcticBearDK: raises $29.99 to $46.50 and is all-in
robin999999: calls $29.99
*** RIVER *** [Js 2s Kc Kh] [Ac]
*** SHOW DOWN ***
ArcticBearDK: shows [Kd Qd] (three of a kind, Kings)
robin999999: shows [Ks As] (a full house, Kings full of Aces)
robin999999 collected $101.25 from pot
*** SUMMARY ***
Total pot $103.25 | Rake $2
Board [Js 2s Kc Kh Ac]
Seat 1: Hander_005 folded before Flop (didn't bet)
Seat 2: ArcticBearDK showed [Kd Qd] and lost with three of a kind, Kings
Seat 3: AstrumNatale folded before Flop (didn't bet)
Seat 4: robin999999 (button) showed [Ks As] and won ($101.25) with a full house, Kings full of Aces
Seat 5: teglio55 (small blind) folded before Flop
Seat 6: oleg001/61 (big blind) folded on the Flop


PokerStars Hand #216114311826:  Hold'em No Limit ($0.25/$0.50 USD) - 2020/07/05 16:37:56 ET
Table 'Urhixidur V' 6-max Seat #2 is the button
Seat 1: Hander_005 ($75.48 in chips)
Seat 2: ArcticBearDK ($50 in chips)
Seat 3: Icefire00627 ($50 in chips)
Seat 4: robin999999 ($100.93 in chips)
Seat 5: teglio55 ($50.89 in chips)
Seat 6: oleg001/61 ($68.60 in chips)
Icefire00627: posts small blind $0.25
robin999999: posts big blind $0.50
*** HOLE CARDS ***
teglio55: folds
oleg001/61: calls $0.50
Hander_005: raises $1.75 to $2.25
ArcticBearDK: folds
Icefire00627: folds
robin999999: folds
oleg001/61: calls $1.75
*** FLOP *** [6c 8h 2s]
oleg001/61: checks
Hander_005: checks
*** TURN *** [6c 8h 2s] [Jc]
oleg001/61: bets $2.50
Hander_005: calls $2.50
*** RIVER *** [6c 8h 2s Jc] [Qc]
oleg001/61: checks
Hander_005: checks
*** SHOW DOWN ***
oleg001/61: shows [7h 9s] (high card Queen)
Hander_005: shows [Jh Th] (a pair of Jacks)
Hander_005 collected $9.74 from pot
*** SUMMARY ***
Total pot $10.25 | Rake $0.51
Board [6c 8h 2s Jc Qc]
Seat 1: Hander_005 showed [Jh Th] and won ($9.74) with a pair of Jacks
Seat 2: ArcticBearDK (button) folded before Flop (didn't bet)
Seat 3: Icefire00627 (small blind) folded before Flop
Seat 4: robin999999 (big blind) folded before Flop
Seat 5: teglio55 folded before Flop (didn't bet)
Seat 6: oleg001/61 showed [7h 9s] and lost with high card Queen


PokerStars Hand #216114472366:  Hold'em No Limit ($0.25/$0.50 USD) - 2020/07/05 16:41:19 ET
Table 'Urhixidur V' 6-max Seat #1 is the button
Seat 1: Hander_005 ($80.22 in chips)
Seat 2: ArcticBearDK ($50 in chips)
Seat 3: Icefire00627 ($59.79 in chips)
Seat 4: robin999999 ($98.68 in chips)
Seat 5: teglio55 ($50.92 in chips)
ArcticBearDK: posts small blind $0.25
Icefire00627: posts big blind $0.50
*** HOLE CARDS ***
robin999999: calls $0.50
teglio55: folds
Hander_005: folds
ArcticBearDK: folds
Icefire00627: raises $1.75 to $2.25
robin999999: calls $1.75
*** FLOP *** [9h Jh 3h]
Icefire00627: bets $1.35
robin999999: raises $2.15 to $3.50
Icefire00627: calls $2.15
*** TURN *** [9h Jh 3h] [8d]
Icefire00627: checks
robin999999: bets $7.81
Icefire00627: calls $7.81
*** RIVER *** [9h Jh 3h 8d] [Js]
Icefire00627: checks
robin999999: checks
*** SHOW DOWN ***
Icefire00627: shows [Jd Ah] (three of a kind, Jacks)
robin999999: mucks hand
Icefire00627 collected $26 from pot
*** SUMMARY ***
Total pot $27.37 | Rake $1.37
Board [9h Jh 3h 8d Js]
Seat 1: Hander_005 (button) folded before Flop (didn't bet)
Seat 2: ArcticBearDK (small blind) folded before Flop
Seat 3: Icefire00627 (big blind) showed [Jd Ah] and won ($26) with three of a kind, Jacks
Seat 4: robin999999 mucked
Seat 5: teglio55 folded before Flop (didn't bet)


PokerStars Hand #216114590217:  Hold'em No Limit ($0.25/$0.50 USD) - 2020/07/05 16:43:54 ET
Table 'Urhixidur V' 6-max Seat #4 is the button
Seat 3: Icefire00627 ($72.73 in chips)
Seat 4: robin999999 ($86.32 in chips)
Seat 5: teglio55 ($50.42 in chips)
teglio55: posts small blind $0.25
ArcticBearDK: is sitting out
ArcticBearDK leaves the table
Icefire00627: posts big blind $0.50
*** HOLE CARDS ***
robin999999: calls $0.50
Hander_005 leaves the table
teglio55: folds
Icefire00627: checks
*** FLOP *** [Qs Kh 3c]
Icefire00627: checks
robin999999: checks
*** TURN *** [Qs Kh 3c] [4d]
Icefire00627: checks
robin999999: bets $0.50
Icefire00627: calls $0.50
*** RIVER *** [Qs Kh 3c 4d] [Qd]
Icefire00627: checks
robin999999: checks
*** SHOW DOWN ***
Icefire00627: shows [6c 7s] (a pair of Queens)
robin999999: shows [4s Js] (two pair, Queens and Fours)
robin999999 collected $2.14 from pot
*** SUMMARY ***
Total pot $2.25 | Rake $0.11
Board [Qs Kh 3c 4d Qd]
Seat 3: Icefire00627 (big blind) showed [6c 7s] and lost with a pair of Queens
Seat 4: robin999999 (button) showed [4s Js] and won ($2.14) with two pair, Queens and Fours
Seat 5: teglio55 (small blind) folded before Flop


PokerStars Hand #227146313195:  Hold'em No Limit ($0.25/$0.50 USD) - 2021/05/28 19:05:14 ET
Table 'Sarir II' 6-max Seat #6 is the button
Seat 1: ViperKheso ($50 in chips)
Seat 2: FarmaZaQ ($67.80 in chips)
Seat 3: kris_beatus ($44.09 in chips)
Seat 5: thetruth109 ($32.39 in chips)
Seat 6: de snoeker ($23.59 in chips)
ViperKheso: posts small blind $0.25
FarmaZaQ: posts big blind $0.50
*** HOLE CARDS ***
kris_beatus: raises $0.50 to $1
thetruth109: folds
de snoeker: folds
ViperKheso: folds
FarmaZaQ: calls $0.50
*** FLOP *** [Jc 8s 3s]
FarmaZaQ: checks
kris_beatus: bets $1.07
FarmaZaQ: calls $1.07
*** TURN *** [Jc 8s 3s] [Ac]
FarmaZaQ: checks
kris_beatus: bets $3.08
bequemer leaves the table
FarmaZaQ: calls $3.08
*** RIVER *** [Jc 8s 3s Ac] [8c]
ArcticBearDK joins the table at seat #4
FarmaZaQ: checks
kris_beatus: checks
*** SHOW DOWN ***
FarmaZaQ: shows [Jh Qs] (two pair, Jacks and Eights)
kris_beatus: mucks hand
FarmaZaQ collected $10.02 from pot
*** SUMMARY ***
Total pot $10.55 | Rake $0.53
Board [Jc 8s 3s Ac 8c]
Seat 1: ViperKheso (small blind) folded before Flop
Seat 2: FarmaZaQ (big blind) showed [Jh Qs] and won ($10.02) with two pair, Jacks and Eights
Seat 3: kris_beatus mucked
Seat 5: thetruth109 folded before Flop (didn't bet)
Seat 6: de snoeker (button) folded before Flop (didn't bet)


PokerStars Hand #227146728638:  Hold'em No Limit ($0.25/$0.50 USD) - 2021/05/28 19:21:43 ET
Table 'Sarir II' 6-max Seat #6 is the button
Seat 1: ViperKheso ($50 in chips)
Seat 2: FarmaZaQ ($88.50 in chips)
Seat 3: kris_beatus ($43.34 in chips)
Seat 4: ArcticBearDK ($51.69 in chips)
Seat 5: thetruth109 ($18.40 in chips)
Seat 6: de snoeker ($24.82 in chips)
ViperKheso: posts small blind $0.25
FarmaZaQ: posts big blind $0.50
thetruth109: posts small & big blinds $0.75
*** HOLE CARDS ***
kris_beatus: calls $0.50
ArcticBearDK: folds
thetruth109: checks
de snoeker: folds
ViperKheso: calls $0.25
FarmaZaQ: checks
*** FLOP *** [4s 7c 8d]
ViperKheso: checks
FarmaZaQ: checks
kris_beatus: checks
thetruth109: bets $2.14
ViperKheso: folds
FarmaZaQ: folds
kris_beatus: calls $2.14
*** TURN *** [4s 7c 8d] [Jc]
kris_beatus: checks
thetruth109: bets $6.20
kris_beatus: calls $6.20
*** RIVER *** [4s 7c 8d Jc] [As]
kris_beatus: bets $34.50 and is all-in
thetruth109: calls $9.31 and is all-in
Uncalled bet ($25.19) returned to kris_beatus
*** SHOW DOWN ***
kris_beatus: shows [3c 4c] (a pair of Fours)
thetruth109: shows [9s Td] (a straight, Seven to Jack)
thetruth109 collected $35.67 from pot
*** SUMMARY ***
Total pot $37.55 | Rake $1.88
Board [4s 7c 8d Jc As]
Seat 1: ViperKheso (small blind) folded on the Flop
Seat 2: FarmaZaQ (big blind) folded on the Flop
Seat 3: kris_beatus showed [3c 4c] and lost with a pair of Fours
Seat 4: ArcticBearDK folded before Flop (didn't bet)
Seat 5: thetruth109 showed [9s Td] and won ($35.67) with a straight, Seven to Jack
Seat 6: de snoeker (button) folded before Flop (didn't bet)


PokerStars Hand #227146813168:  Hold'em No Limit ($0.25/$0.50 USD) - 2021/05/28 19:25:23 ET
Table 'Sarir II' 6-max Seat #1 is the button
Seat 1: ViperKheso ($50 in chips)
Seat 2: FarmaZaQ ($86.38 in chips)
Seat 3: kris_beatus ($52.62 in chips)
Seat 4: ArcticBearDK ($50.94 in chips)
Seat 5: thetruth109 ($35.92 in chips)
Seat 6: de snoeker ($25.23 in chips)
FarmaZaQ: posts small blind $0.25
kris_beatus: posts big blind $0.50
*** HOLE CARDS ***
ArcticBearDK: raises $1 to $1.50
thetruth109: calls $1.50
de snoeker: folds
ViperKheso: folds
FarmaZaQ: folds
kris_beatus: folds
*** FLOP *** [4h 9s Th]
ArcticBearDK: bets $2.25
thetruth109: calls $2.25
*** TURN *** [4h 9s Th] [9d]
ArcticBearDK: checks
thetruth109: bets $3.92
ArcticBearDK: calls $3.92
*** RIVER *** [4h 9s Th 9d] [6h]
ArcticBearDK: checks
thetruth109: bets $7.65
ArcticBearDK: calls $7.65
*** SHOW DOWN ***
thetruth109: shows [Kh Qd] (a pair of Nines)
ArcticBearDK: shows [Ts Jd] (two pair, Tens and Nines)
ArcticBearDK collected $29.82 from pot
*** SUMMARY ***
Total pot $31.39 | Rake $1.57
Board [4h 9s Th 9d 6h]
Seat 1: ViperKheso (button) folded before Flop (didn't bet)
Seat 2: FarmaZaQ (small blind) folded before Flop
Seat 3: kris_beatus (big blind) folded before Flop
Seat 4: ArcticBearDK showed [Ts Jd] and won ($29.82) with two pair, Tens and Nines
Seat 5: thetruth109 showed [Kh Qd] and lost with a pair of Nines
Seat 6: de snoeker folded before Flop (didn't bet)


PokerStars Hand #227146914673:  Hold'em No Limit ($0.25/$0.50 USD) - 2021/05/28 19:29:40 ET
Table 'Sarir II' 6-max Seat #6 is the button
Seat 1: ViperKheso ($50 in chips)
Seat 2: FarmaZaQ ($99.12 in chips)
Seat 3: kris_beatus ($52.37 in chips)
Seat 4: ArcticBearDK ($52.69 in chips)
Seat 5: thetruth109 ($19.90 in chips)
Seat 6: de snoeker ($24.48 in chips)
ViperKheso: posts small blind $0.25
FarmaZaQ: posts big blind $0.50
*** HOLE CARDS ***
kris_beatus: folds
ArcticBearDK: raises $0.75 to $1.25
thetruth109 has timed out
thetruth109: folds
de snoeker: folds
ViperKheso: folds
FarmaZaQ: calls $0.75
*** FLOP *** [2s Jc Js]
FarmaZaQ: checks
ArcticBearDK: bets $1
FarmaZaQ: calls $1
*** TURN *** [2s Jc Js] [8c]
FarmaZaQ: checks
ArcticBearDK: bets $3.49
FarmaZaQ: calls $3.49
*** RIVER *** [2s Jc Js 8c] [Th]
FarmaZaQ: checks
ArcticBearDK: checks
*** SHOW DOWN ***
FarmaZaQ: shows [Jh Ad] (three of a kind, Jacks)
ArcticBearDK: mucks hand
FarmaZaQ collected $11.14 from pot
*** SUMMARY ***
Total pot $11.73 | Rake $0.59
Board [2s Jc Js 8c Th]
Seat 1: ViperKheso (small blind) folded before Flop
Seat 2: FarmaZaQ (big blind) showed [Jh Ad] and won ($11.14) with three of a kind, Jacks
Seat 3: kris_beatus folded before Flop (didn't bet)
Seat 4: ArcticBearDK mucked
Seat 5: thetruth109 folded before Flop (didn't bet)
Seat 6: de snoeker (button) folded before Flop (didn't bet)


PokerStars Hand #227146977704:  Hold'em No Limit ($0.25/$0.50 USD) - 2021/05/28 19:32:28 ET
Table 'Sarir II' 6-max Seat #3 is the button
Seat 1: ViperKheso ($50 in chips)
Seat 2: FarmaZaQ ($104.27 in chips)
Seat 3: kris_beatus ($44.52 in chips)
Seat 4: ArcticBearDK ($50 in chips)
Seat 5: thetruth109 ($27.74 in chips)
Seat 6: de snoeker ($24.48 in chips)
ArcticBearDK: posts small blind $0.25
thetruth109: posts big blind $0.50
*** HOLE CARDS ***
de snoeker: folds
ViperKheso: folds
FarmaZaQ: folds
kris_beatus: raises $1 to $1.50
ArcticBearDK: raises $3.50 to $5
thetruth109: folds
kris_beatus: calls $3.50
*** FLOP *** [2s Tc 7h]
ArcticBearDK: checks
kris_beatus: checks
*** TURN *** [2s Tc 7h] [7s]
ArcticBearDK: checks
kris_beatus: bets $4.99
ArcticBearDK: calls $4.99
*** RIVER *** [2s Tc 7h 7s] [5s]
ArcticBearDK: checks
kris_beatus: checks
*** SHOW DOWN ***
ArcticBearDK: shows [Kc Ah] (a pair of Sevens)
kris_beatus: shows [9d 9s] (two pair, Nines and Sevens)
kris_beatus collected $19.46 from pot
*** SUMMARY ***
Total pot $20.48 | Rake $1.02
Board [2s Tc 7h 7s 5s]
Seat 1: ViperKheso folded before Flop (didn't bet)
Seat 2: FarmaZaQ folded before Flop (didn't bet)
Seat 3: kris_beatus (button) showed [9d 9s] and won ($19.46) with two pair, Nines and Sevens
Seat 4: ArcticBearDK (small blind) showed [Kc Ah] and lost with a pair of Sevens
Seat 5: thetruth109 (big blind) folded before Flop
Seat 6: de snoeker folded before Flop (didn't bet)


PokerStars Hand #227147084493:  Hold'em No Limit ($0.25/$0.50 USD) - 2021/05/28 19:36:56 ET
Table 'Sarir II' 6-max Seat #3 is the button
Seat 1: ViperKheso ($50 in chips)
Seat 2: FarmaZaQ ($108.27 in chips)
Seat 3: kris_beatus ($54.38 in chips)
Seat 4: ArcticBearDK ($50 in chips)
Seat 5: thetruth109 ($27.78 in chips)
Seat 6: de snoeker ($22.61 in chips)
ArcticBearDK: posts small blind $0.25
thetruth109: posts big blind $0.50
*** HOLE CARDS ***
de snoeker: raises $0.50 to $1
ViperKheso: folds
FarmaZaQ: folds
kris_beatus: raises $0.50 to $1.50
ArcticBearDK: folds
thetruth109: calls $1
de snoeker: calls $0.50
*** FLOP *** [9s 4h Qh]
thetruth109: checks
de snoeker: checks
kris_beatus: bets $2.25
thetruth109: folds
de snoeker: calls $2.25
*** TURN *** [9s 4h Qh] [Ks]
de snoeker: checks
kris_beatus: checks
*** RIVER *** [9s 4h Qh Ks] [8c]
de snoeker: bets $2.50
kris_beatus: calls $2.50
*** SHOW DOWN ***
de snoeker: shows [Qc Jc] (a pair of Queens)
kris_beatus: shows [9d 8d] (two pair, Nines and Eights)
kris_beatus collected $13.54 from pot
*** SUMMARY ***
Total pot $14.25 | Rake $0.71
Board [9s 4h Qh Ks 8c]
Seat 1: ViperKheso folded before Flop (didn't bet)
Seat 2: FarmaZaQ folded before Flop (didn't bet)
Seat 3: kris_beatus (button) showed [9d 8d] and won ($13.54) with two pair, Nines and Eights
Seat 4: ArcticBearDK (small blind) folded before Flop
Seat 5: thetruth109 (big blind) folded on the Flop
Seat 6: de snoeker showed [Qc Jc] and lost with a pair of Queens


PokerStars Hand #227147105878:  Hold'em No Limit ($0.25/$0.50 USD) - 2021/05/28 19:37:55 ET
Table 'Sarir II' 6-max Seat #4 is the button
Seat 1: ViperKheso ($50 in chips)
Seat 2: FarmaZaQ ($108.27 in chips)
Seat 3: kris_beatus ($61.67 in chips)
Seat 4: ArcticBearDK ($50 in chips)
Seat 5: thetruth109 ($26.28 in chips)
Seat 6: de snoeker ($16.36 in chips)
thetruth109: posts small blind $0.25
de snoeker: posts big blind $0.50
*** HOLE CARDS ***
ViperKheso: folds
FarmaZaQ: raises $0.62 to $1.12
kris_beatus: calls $1.12
ArcticBearDK: folds
thetruth109: folds
de snoeker: raises $1.88 to $3
FarmaZaQ: calls $1.88
kris_beatus: calls $1.88
*** FLOP *** [6s Qd 2d]
thetruth109 is disconnected
de snoeker: checks
FarmaZaQ: checks
kris_beatus: bets $4.39
de snoeker: raises $8.97 to $13.36 and is all-in
FarmaZaQ: folds
kris_beatus: calls $8.97
*** TURN *** [6s Qd 2d] [Qc]
*** RIVER *** [6s Qd 2d Qc] [8d]
*** SHOW DOWN ***
de snoeker: shows [As Ad] (two pair, Aces and Queens)
kris_beatus: shows [Qh 5h] (three of a kind, Queens)
kris_beatus collected $34.17 from pot
*** SUMMARY ***
Total pot $35.97 | Rake $1.80
Board [6s Qd 2d Qc 8d]
Seat 1: ViperKheso folded before Flop (didn't bet)
Seat 2: FarmaZaQ folded on the Flop
Seat 3: kris_beatus showed [Qh 5h] and won ($34.17) with three of a kind, Queens
Seat 4: ArcticBearDK (button) folded before Flop (didn't bet)
Seat 5: thetruth109 (small blind) folded before Flop
Seat 6: de snoeker (big blind) showed [As Ad] and lost with two pair, Aces and Queens


PokerStars Hand #227147199675:  Hold'em No Limit ($0.25/$0.50 USD) - 2021/05/28 19:42:06 ET
Table 'Sarir II' 6-max Seat #3 is the button
Seat 1: ViperKheso ($50 in chips)
Seat 2: FarmaZaQ ($98.48 in chips)
Seat 3: kris_beatus ($72.94 in chips)
Seat 4: ArcticBearDK ($62.59 in chips)
Seat 5: thetruth109 ($26.03 in chips)
ArcticBearDK: posts small blind $0.25
thetruth109: posts big blind $0.50
de snoeker: sits out
*** HOLE CARDS ***
ViperKheso: folds
FarmaZaQ: folds
kris_beatus: raises $0.50 to $1
ArcticBearDK: calls $0.75
thetruth109: folds
*** FLOP *** [6d 3h 7h]
thetruth109 leaves the table
ArcticBearDK: checks
kris_beatus: bets $1.19
Subaru52rus joins the table at seat #5
ArcticBearDK: raises $3.31 to $4.50
kris_beatus: raises $11.38 to $15.88
ArcticBearDK: raises $45.71 to $61.59 and is all-in
kris_beatus: calls $45.71
*** TURN *** [6d 3h 7h] [Kd]
*** RIVER *** [6d 3h 7h Kd] [Qs]
*** SHOW DOWN ***
ArcticBearDK: shows [5c 4d] (a straight, Three to Seven)
kris_beatus: shows [6h 6c] (three of a kind, Sixes)
ArcticBearDK collected $123.68 from pot
*** SUMMARY ***
Total pot $125.68 | Rake $2
Board [6d 3h 7h Kd Qs]
Seat 1: ViperKheso folded before Flop (didn't bet)
Seat 2: FarmaZaQ folded before Flop (didn't bet)
Seat 3: kris_beatus (button) showed [6h 6c] and lost with three of a kind, Sixes
Seat 4: ArcticBearDK (small blind) showed [5c 4d] and won ($123.68) with a straight, Three to Seven
Seat 5: thetruth109 (big blind) folded before Flop


PokerStars Hand #227147223858:  Hold'em No Limit ($0.25/$0.50 USD) - 2021/05/28 19:43:14 ET
Table 'Sarir II' 6-max Seat #2 is the button
Seat 1: ViperKheso ($51.36 in chips)
Seat 2: FarmaZaQ ($98.48 in chips)
Seat 3: kris_beatus ($9.10 in chips)
Seat 4: ArcticBearDK ($123.68 in chips)
Seat 6: de snoeker ($50 in chips)
kris_beatus: posts small blind $0.25
ArcticBearDK: posts big blind $0.50
Subaru52rus: sits out
de snoeker: posts small blind $0.25
*** HOLE CARDS ***
de snoeker: raises $0.50 to $1
ViperKheso: folds
FarmaZaQ: calls $1
kris_beatus: calls $0.75
ArcticBearDK: calls $0.50
*** FLOP *** [7c Qd 6d]
kris_beatus: checks
ArcticBearDK: checks
de snoeker: checks
FarmaZaQ: checks
*** TURN *** [7c Qd 6d] [4h]
kris_beatus: checks
ArcticBearDK: checks
de snoeker: bets $1.50
FarmaZaQ: folds
kris_beatus: calls $1.50
ArcticBearDK: folds
*** RIVER *** [7c Qd 6d 4h] [Qs]
kris_beatus: checks
de snoeker: checks
*** SHOW DOWN ***
kris_beatus: shows [3d 4c] (two pair, Queens and Fours)
de snoeker: shows [5h 5s] (two pair, Queens and Fives)
de snoeker collected $6.89 from pot
*** SUMMARY ***
Total pot $7.25 | Rake $0.36
Board [7c Qd 6d 4h Qs]
Seat 1: ViperKheso folded before Flop (didn't bet)
Seat 2: FarmaZaQ (button) folded on the Turn
Seat 3: kris_beatus (small blind) showed [3d 4c] and lost with two pair, Queens and Fours
Seat 4: ArcticBearDK (big blind) folded on the Turn
Seat 6: de snoeker showed [5h 5s] and won ($6.89) with two pair, Queens and Fives


PokerStars Hand #223660512241:  Hold'em No Limit ($0.25/$0.50 USD) - 2021/02/10 16:48:21 ET
Table 'China V' 6-max Seat #5 is the button
Seat 1: zMukeha ($50.60 in chips)
Seat 2: ArcticBearDK ($50 in chips)
Seat 3: lukerutterr ($32.19 in chips)
Seat 4: krash0 ($73.23 in chips)
Seat 5: Odintsov Spb ($62.55 in chips)
Seat 6: MrNeverLucky4 ($50.26 in chips)
MrNeverLucky4: posts small blind $0.25
zMukeha: posts big blind $0.50
*** HOLE CARDS ***
ArcticBearDK: raises $1 to $1.50
lukerutterr: calls $1.50
krash0: raises $4.50 to $6
Odintsov Spb: folds
MrNeverLucky4: folds
zMukeha: folds
ArcticBearDK: folds
lukerutterr: raises $26.19 to $32.19 and is all-in
krash0: calls $26.19
*** FLOP *** [3d 4h Tc]
*** TURN *** [3d 4h Tc] [6h]
*** RIVER *** [3d 4h Tc 6h] [Kd]
*** SHOW DOWN ***
lukerutterr: shows [Ts 9s] (a pair of Tens)
krash0: shows [Kh Ad] (a pair of Kings)
krash0 collected $64.63 from pot
*** SUMMARY ***
Total pot $66.63 | Rake $2
Board [3d 4h Tc 6h Kd]
Seat 1: zMukeha (big blind) folded before Flop
Seat 2: ArcticBearDK folded before Flop
Seat 3: lukerutterr showed [Ts 9s] and lost with a pair of Tens
Seat 4: krash0 showed [Kh Ad] and won ($64.63) with a pair of Kings
Seat 5: Odintsov Spb (button) folded before Flop (didn't bet)
Seat 6: MrNeverLucky4 (small blind) folded before Flop


PokerStars Hand #228443332602:  Hold'em No Limit ($0.25/$0.50 USD) - 2021/07/20 17:20:04 ET
Table 'Raimonda' 6-max Seat #5 is the button
Seat 2: Yagomooca ($50.35 in chips)
Seat 3: de snoeker ($46.75 in chips)
Seat 4: jubilado1 ($51.83 in chips)
Seat 5: yellowrose88 ($93.53 in chips)
Seat 6: proker29 ($54.45 in chips)
proker29: posts small blind $0.25
ArcticBearDK: is sitting out
ArcticBearDK leaves the table
Yagomooca: posts big blind $0.50
*** HOLE CARDS ***
de snoeker: folds
jubilado1: folds
yellowrose88: folds
TRUNIGGAH187 joins the table at seat #1
proker29: raises $1.02 to $1.52
Yagomooca: calls $1.02
*** FLOP *** [8s 9d 7d]
proker29: checks
Yagomooca: checks
*** TURN *** [8s 9d 7d] [7c]
proker29: checks
Yagomooca: checks
*** RIVER *** [8s 9d 7d 7c] [Qh]
proker29: checks
Yagomooca: checks
*** SHOW DOWN ***
proker29: shows [9s Kh] (two pair, Nines and Sevens)
Yagomooca: mucks hand
proker29 collected $2.89 from pot
*** SUMMARY ***
Total pot $3.04 | Rake $0.15
Board [8s 9d 7d 7c Qh]
Seat 2: Yagomooca (big blind) mucked
Seat 3: de snoeker folded before Flop (didn't bet)
Seat 4: jubilado1 folded before Flop (didn't bet)
Seat 5: yellowrose88 (button) folded before Flop (didn't bet)
Seat 6: proker29 (small blind) showed [9s Kh] and won ($2.89) with two pair, Nines and Sevens


PokerStars Hand #228445263022:  Hold'em No Limit ($0.25/$0.50 USD) - 2021/07/20 18:38:38 ET
Table 'Raimonda' 6-max Seat #2 is the button
Seat 1: 1,2freddyCome4u ($54.73 in chips)
Seat 2: Yagomooca ($123.80 in chips)
Seat 3: de snoeker ($27.97 in chips)
Seat 4: jubilado1 ($55.25 in chips)
Seat 5: giwrgosantw ($50 in chips)
Seat 6: Tayne10 ($26.94 in chips)
de snoeker: posts small blind $0.25
jubilado1: posts big blind $0.50
*** HOLE CARDS ***
giwrgosantw: folds
Tayne10: folds
1,2freddyCome4u: folds
Yagomooca: folds
de snoeker: calls $0.25
jubilado1: checks
*** FLOP *** [2h Ah Th]
de snoeker: checks
jubilado1: checks
*** TURN *** [2h Ah Th] [7d]
giwrgosantw was removed from the table for failing to post
giwrgosantw leaves the table
de snoeker: checks
jubilado1: checks
*** RIVER *** [2h Ah Th 7d] [Jd]
de snoeker: checks
ArcticBearDK joins the table at seat #5
jubilado1: checks
*** SHOW DOWN ***
de snoeker: shows [6c Qd] (high card Ace)
jubilado1: mucks hand
de snoeker collected $0.95 from pot
*** SUMMARY ***
Total pot $1 | Rake $0.05
Board [2h Ah Th 7d Jd]
Seat 1: 1,2freddyCome4u folded before Flop (didn't bet)
Seat 2: Yagomooca (button) folded before Flop (didn't bet)
Seat 3: de snoeker (small blind) showed [6c Qd] and won ($0.95) with high card Ace
Seat 4: jubilado1 (big blind) mucked
Seat 5: giwrgosantw folded before Flop (didn't bet)
Seat 6: Tayne10 folded before Flop (didn't bet)


PokerStars Hand #228445282946:  Hold'em No Limit ($0.25/$0.50 USD) - 2021/07/20 18:39:25 ET
Table 'Raimonda' 6-max Seat #4 is the button
Seat 1: 1,2freddyCome4u ($54.73 in chips)
Seat 2: Yagomooca ($123.80 in chips)
Seat 3: de snoeker ($28.42 in chips)
Seat 4: jubilado1 ($54.50 in chips)
Seat 5: ArcticBearDK ($50.25 in chips)
Seat 6: Tayne10 ($26.94 in chips)
ArcticBearDK: posts small blind $0.25
Tayne10: posts big blind $0.50
*** HOLE CARDS ***
1,2freddyCome4u: raises $0.60 to $1.10
Yagomooca: folds
de snoeker: calls $1.10
jubilado1: folds
ArcticBearDK: folds
Tayne10: folds
*** FLOP *** [Ks 6c Kd]
1,2freddyCome4u: checks
de snoeker: checks
*** TURN *** [Ks 6c Kd] [8h]
1,2freddyCome4u: checks
de snoeker: checks
*** RIVER *** [Ks 6c Kd 8h] [3d]
1,2freddyCome4u: checks
de snoeker: checks
*** SHOW DOWN ***
1,2freddyCome4u: shows [Ah Th] (a pair of Kings)
de snoeker: shows [As Qd] (a pair of Kings - Ace+Queen kicker)
de snoeker collected $2.80 from pot
*** SUMMARY ***
Total pot $2.95 | Rake $0.15
Board [Ks 6c Kd 8h 3d]
Seat 1: 1,2freddyCome4u showed [Ah Th] and lost with a pair of Kings
Seat 2: Yagomooca folded before Flop (didn't bet)
Seat 3: de snoeker showed [As Qd] and won ($2.80) with a pair of Kings
Seat 4: jubilado1 (button) folded before Flop (didn't bet)
Seat 5: ArcticBearDK (small blind) folded before Flop
Seat 6: Tayne10 (big blind) folded before Flop


PokerStars Hand #228445347877:  Hold'em No Limit ($0.25/$0.50 USD) - 2021/07/20 18:42:23 ET
Table 'Raimonda' 6-max Seat #4 is the button
Seat 1: 1,2freddyCome4u ($53.63 in chips)
Seat 2: Yagomooca ($123.05 in chips)
Seat 3: de snoeker ($29.37 in chips)
Seat 4: jubilado1 ($55.41 in chips)
Seat 5: ArcticBearDK ($50.25 in chips)
Seat 6: Tayne10 ($26.58 in chips)
ArcticBearDK: posts small blind $0.25
Tayne10: posts big blind $0.50
*** HOLE CARDS ***
1,2freddyCome4u: folds
Yagomooca: folds
de snoeker: folds
jubilado1: raises $0.50 to $1
ArcticBearDK: calls $0.75
Tayne10: calls $0.50
*** FLOP *** [8h 7h Jd]
ArcticBearDK: checks
Tayne10: checks
jubilado1: checks
*** TURN *** [8h 7h Jd] [3s]
ArcticBearDK: bets $1.50
Tayne10: calls $1.50
jubilado1: folds
*** RIVER *** [8h 7h Jd 3s] [5c]
ArcticBearDK: checks
Tayne10: checks
*** SHOW DOWN ***
ArcticBearDK: shows [Ad 9d] (high card Ace)
Tayne10: shows [6h 7s] (a pair of Sevens)
Tayne10 collected $5.70 from pot
*** SUMMARY ***
Total pot $6 | Rake $0.30
Board [8h 7h Jd 3s 5c]
Seat 1: 1,2freddyCome4u folded before Flop (didn't bet)
Seat 2: Yagomooca folded before Flop (didn't bet)
Seat 3: de snoeker folded before Flop (didn't bet)
Seat 4: jubilado1 (button) folded on the Turn
Seat 5: ArcticBearDK (small blind) showed [Ad 9d] and lost with high card Ace
Seat 6: Tayne10 (big blind) showed [6h 7s] and won ($5.70) with a pair of Sevens


PokerStars Hand #228445375110:  Hold'em No Limit ($0.25/$0.50 USD) - 2021/07/20 18:43:38 ET
Table 'Raimonda' 6-max Seat #1 is the button
Seat 1: 1,2freddyCome4u ($53.63 in chips)
Seat 2: Yagomooca ($122.55 in chips)
Seat 3: de snoeker ($29.37 in chips)
Seat 4: jubilado1 ($55.16 in chips)
Seat 5: ArcticBearDK ($50 in chips)
Seat 6: Tayne10 ($29.53 in chips)
Yagomooca: posts small blind $0.25
de snoeker: posts big blind $0.50
*** HOLE CARDS ***
jubilado1: folds
ArcticBearDK: folds
Tayne10: raises $1.75 to $2.25
1,2freddyCome4u: folds
Yagomooca: raises $8.75 to $11
de snoeker: folds
Tayne10: calls $8.75
*** FLOP *** [Th 3d 4h]
Yagomooca: bets $7.06
Tayne10: raises $11.47 to $18.53 and is all-in
Yagomooca: calls $11.47
*** TURN *** [Th 3d 4h] [7s]
*** RIVER *** [Th 3d 4h 7s] [3s]
*** SHOW DOWN ***
Yagomooca: shows [Kd Ac] (a pair of Threes)
Tayne10: shows [Td 7d] (two pair, Tens and Sevens)
Tayne10 collected $57.56 from pot
*** SUMMARY ***
Total pot $59.56 | Rake $2
Board [Th 3d 4h 7s 3s]
Seat 1: 1,2freddyCome4u (button) folded before Flop (didn't bet)
Seat 2: Yagomooca (small blind) showed [Kd Ac] and lost with a pair of Threes
Seat 3: de snoeker (big blind) folded before Flop
Seat 4: jubilado1 folded before Flop (didn't bet)
Seat 5: ArcticBearDK folded before Flop (didn't bet)
Seat 6: Tayne10 showed [Td 7d] and won ($57.56) with two pair, Tens and Sevens


PokerStars Hand #228445448752:  Hold'em No Limit ($0.25/$0.50 USD) - 2021/07/20 18:46:37 ET
Table 'Raimonda' 6-max Seat #6 is the button
Seat 1: 1,2freddyCome4u ($54.69 in chips)
Seat 2: Yagomooca ($93.02 in chips)
Seat 3: de snoeker ($30.47 in chips)
Seat 4: jubilado1 ($55.65 in chips)
Seat 5: ArcticBearDK ($50 in chips)
Seat 6: Tayne10 ($54.72 in chips)
1,2freddyCome4u: posts small blind $0.25
Yagomooca: posts big blind $0.50
*** HOLE CARDS ***
de snoeker: folds
jubilado1: folds
ArcticBearDK: raises $0.60 to $1.10
Tayne10: raises $3.70 to $4.80
1,2freddyCome4u: folds
Yagomooca: folds
ArcticBearDK: calls $3.70
*** FLOP *** [8h 4c 4d]
ArcticBearDK: checks
Tayne10: bets $4.91
ArcticBearDK: calls $4.91
*** TURN *** [8h 4c 4d] [9s]
ArcticBearDK: checks
Tayne10: checks
*** RIVER *** [8h 4c 4d 9s] [Td]
ArcticBearDK: checks
Tayne10: bets $10.58
ArcticBearDK: calls $10.58
*** SHOW DOWN ***
Tayne10: shows [Jh Ah] (a pair of Fours)
ArcticBearDK: shows [Ad 8d] (two pair, Eights and Fours)
ArcticBearDK collected $39.33 from pot
*** SUMMARY ***
Total pot $41.33 | Rake $2
Board [8h 4c 4d 9s Td]
Seat 1: 1,2freddyCome4u (small blind) folded before Flop
Seat 2: Yagomooca (big blind) folded before Flop
Seat 3: de snoeker folded before Flop (didn't bet)
Seat 4: jubilado1 folded before Flop (didn't bet)
Seat 5: ArcticBearDK showed [Ad 8d] and won ($39.33) with two pair, Eights and Fours
Seat 6: Tayne10 (button) showed [Jh Ah] and lost with a pair of Fours


PokerStars Hand #228445564112:  Hold'em No Limit ($0.25/$0.50 USD) - 2021/07/20 18:51:46 ET
Table 'Raimonda' 6-max Seat #4 is the button
Seat 1: 1,2freddyCome4u ($54.35 in chips)
Seat 2: Yagomooca ($94.72 in chips)
Seat 4: jubilado1 ($57.32 in chips)
Seat 5: ArcticBearDK ($67.79 in chips)
Seat 6: Tayne10 ($31.99 in chips)
ArcticBearDK: posts small blind $0.25
Tayne10: posts big blind $0.50
de snoeker: sits out
*** HOLE CARDS ***
1,2freddyCome4u: raises $0.60 to $1.10
Yagomooca: folds
jubilado1: folds
ArcticBearDK: folds
Tayne10: raises $2.45 to $3.55
1,2freddyCome4u: raises $10.45 to $14
Tayne10: calls $10.45
*** FLOP *** [Th Ah 7d]
Tayne10: bets $17.99 and is all-in
1,2freddyCome4u: calls $17.99
*** TURN *** [Th Ah 7d] [6s]
*** RIVER *** [Th Ah 7d 6s] [4s]
*** SHOW DOWN ***
Tayne10: shows [8h Jh] (high card Ace)
1,2freddyCome4u: shows [Ad Kd] (a pair of Aces)
1,2freddyCome4u collected $62.23 from pot
*** SUMMARY ***
Total pot $64.23 | Rake $2
Board [Th Ah 7d 6s 4s]
Seat 1: 1,2freddyCome4u showed [Ad Kd] and won ($62.23) with a pair of Aces
Seat 2: Yagomooca folded before Flop (didn't bet)
Seat 4: jubilado1 (button) folded before Flop (didn't bet)
Seat 5: ArcticBearDK (small blind) folded before Flop
Seat 6: Tayne10 (big blind) showed [8h Jh] and lost with high card Ace


PokerStars Hand #228445595867:  Hold'em No Limit ($0.25/$0.50 USD) - 2021/07/20 18:53:17 ET
Table 'Raimonda' 6-max Seat #1 is the button
Seat 1: 1,2freddyCome4u ($84.34 in chips)
Seat 2: Yagomooca ($97.47 in chips)
Seat 3: de snoeker ($28.97 in chips)
Seat 4: jubilado1 ($55.32 in chips)
Seat 5: ArcticBearDK ($67.54 in chips)
Yagomooca: posts small blind $0.25
de snoeker: posts big blind $0.50
*** HOLE CARDS ***
Tayne10 is disconnected
jubilado1: raises $0.61 to $1.11
ArcticBearDK: folds
1,2freddyCome4u: raises $2.64 to $3.75
Yagomooca: folds
de snoeker: folds
jubilado1: calls $2.64
*** FLOP *** [6c 2s 9s]
jubilado1: checks
1,2freddyCome4u: bets $3.92
jubilado1: calls $3.92
*** TURN *** [6c 2s 9s] [Qh]
jubilado1: checks
1,2freddyCome4u: bets $11.47
jubilado1: calls $11.47
*** RIVER *** [6c 2s 9s Qh] [5d]
jubilado1: checks
1,2freddyCome4u: checks
*** SHOW DOWN ***
jubilado1: shows [8d 9d] (a pair of Nines)
1,2freddyCome4u: shows [Kc Qc] (a pair of Queens)
1,2freddyCome4u collected $37.08 from pot
*** SUMMARY ***
Total pot $39.03 | Rake $1.95
Board [6c 2s 9s Qh 5d]
Seat 1: 1,2freddyCome4u (button) showed [Kc Qc] and won ($37.08) with a pair of Queens
Seat 2: Yagomooca (small blind) folded before Flop
Seat 3: de snoeker (big blind) folded before Flop
Seat 4: jubilado1 showed [8d 9d] and lost with a pair of Nines
Seat 5: ArcticBearDK folded before Flop (didn't bet)


PokerStars Hand #228445637030:  Hold'em No Limit ($0.25/$0.50 USD) - 2021/07/20 18:55:18 ET
Table 'Raimonda' 6-max Seat #2 is the button
Seat 1: 1,2freddyCome4u ($102.28 in chips)
Seat 2: Yagomooca ($97.22 in chips)
Seat 3: de snoeker ($28.47 in chips)
Seat 4: jubilado1 ($50 in chips)
Seat 5: ArcticBearDK ($67.54 in chips)
de snoeker: posts small blind $0.25
jubilado1: posts big blind $0.50
*** HOLE CARDS ***
ArcticBearDK: folds
1,2freddyCome4u: folds
Yagomooca: raises $1 to $1.50
de snoeker: folds
jubilado1: calls $1
*** FLOP *** [Ts 2d Qc]
jubilado1: checks
Yagomooca: bets $1.02
jubilado1: calls $1.02
*** TURN *** [Ts 2d Qc] [7c]
jubilado1: checks
Yagomooca: checks
*** RIVER *** [Ts 2d Qc 7c] [6c]
jubilado1: bets $1.26
Yagomooca: raises $3.24 to $4.50
jubilado1: calls $3.24
*** SHOW DOWN ***
Yagomooca: shows [5s 5d] (a pair of Fives)
jubilado1: shows [3d Qd] (a pair of Queens)
jubilado1 collected $13.58 from pot
*** SUMMARY ***
Total pot $14.29 | Rake $0.71
Board [Ts 2d Qc 7c 6c]
Seat 1: 1,2freddyCome4u folded before Flop (didn't bet)
Seat 2: Yagomooca (button) showed [5s 5d] and lost with a pair of Fives
Seat 3: de snoeker (small blind) folded before Flop
Seat 4: jubilado1 (big blind) showed [3d Qd] and won ($13.58) with a pair of Queens
Seat 5: ArcticBearDK folded before Flop (didn't bet)


PokerStars Hand #228445661402:  Hold'em No Limit ($0.25/$0.50 USD) - 2021/07/20 18:56:49 ET
Table 'Raimonda' 6-max Seat #5 is the button
Seat 1: 1,2freddyCome4u ($102.53 in chips)
Seat 2: Yagomooca ($90.20 in chips)
Seat 4: jubilado1 ($56.56 in chips)
Seat 5: ArcticBearDK ($67.29 in chips)
1,2freddyCome4u: posts small blind $0.25
Yagomooca: posts big blind $0.50
*** HOLE CARDS ***
jubilado1: raises $0.61 to $1.11
ArcticBearDK: folds
1,2freddyCome4u: folds
Yagomooca: calls $0.61
*** FLOP *** [5s 9h 8c]
Yagomooca: checks
jubilado1: bets $0.78
Yagomooca: calls $0.78
*** TURN *** [5s 9h 8c] [Td]
Yagomooca: checks
jubilado1: bets $2
Yagomooca: calls $2
*** RIVER *** [5s 9h 8c Td] [7s]
Yagomooca: checks
jubilado1: checks
*** SHOW DOWN ***
Yagomooca: shows [9s Tc] (two pair, Tens and Nines)
jubilado1: shows [Th Ts] (three of a kind, Tens)
jubilado1 collected $7.63 from pot
*** SUMMARY ***
Total pot $8.03 | Rake $0.40
Board [5s 9h 8c Td 7s]
Seat 1: 1,2freddyCome4u (small blind) folded before Flop
Seat 2: Yagomooca (big blind) showed [9s Tc] and lost with two pair, Tens and Nines
Seat 4: jubilado1 showed [Th Ts] and won ($7.63) with three of a kind, Tens
Seat 5: ArcticBearDK (button) folded before Flop (didn't bet)


PokerStars Hand #220326152523:  Hold'em No Limit ($0.25/$0.50 USD) - 2020/11/12 16:57:09 ET
Table 'Tarvos III' 6-max Seat #1 is the button
Seat 1: redbrain0817 ($78.91 in chips)
Seat 2: BefirsSt ($50 in chips)
Seat 3: buy-in86 ($15.27 in chips)
Seat 4: oxxxy ($61.96 in chips)
Seat 5: dimakryt1 ($50 in chips)
BefirsSt: posts small blind $0.25
buy-in86: posts big blind $0.50
ArcticBearDK: sits out
*** HOLE CARDS ***
oxxxy: folds
dimakryt1: folds
redbrain0817: raises $0.62 to $1.12
BefirsSt: folds
buy-in86: calls $0.62
*** FLOP *** [4d Jc As]
buy-in86: checks
redbrain0817: checks
*** TURN *** [4d Jc As] [3d]
buy-in86: checks
redbrain0817: checks
*** RIVER *** [4d Jc As 3d] [5h]
buy-in86: checks
redbrain0817: checks
*** SHOW DOWN ***
buy-in86: shows [3s 7h] (a pair of Threes)
redbrain0817: shows [Jd Tc] (a pair of Jacks)
redbrain0817 collected $2.37 from pot
*** SUMMARY ***
Total pot $2.49 | Rake $0.12
Board [4d Jc As 3d 5h]
Seat 1: redbrain0817 (button) showed [Jd Tc] and won ($2.37) with a pair of Jacks
Seat 2: BefirsSt (small blind) folded before Flop
Seat 3: buy-in86 (big blind) showed [3s 7h] and lost with a pair of Threes
Seat 4: oxxxy folded before Flop (didn't bet)
Seat 5: dimakryt1 folded before Flop (didn't bet)


PokerStars Hand #220326181500:  Hold'em No Limit ($0.25/$0.50 USD) - 2020/11/12 16:58:09 ET
Table 'Tarvos III' 6-max Seat #2 is the button
Seat 1: redbrain0817 ($80.16 in chips)
Seat 2: BefirsSt ($50 in chips)
Seat 3: buy-in86 ($14.15 in chips)
Seat 4: oxxxy ($61.96 in chips)
Seat 5: dimakryt1 ($50 in chips)
buy-in86: posts small blind $0.25
oxxxy: posts big blind $0.50
ArcticBearDK: sits out
*** HOLE CARDS ***
dimakryt1: folds
redbrain0817: folds
BefirsSt: raises $0.75 to $1.25
buy-in86: calls $1
oxxxy: calls $0.75
*** FLOP *** [Tc 4d Ts]
buy-in86: checks
oxxxy: checks
BefirsSt: checks
*** TURN *** [Tc 4d Ts] [4c]
buy-in86: checks
oxxxy: checks
BefirsSt: checks
*** RIVER *** [Tc 4d Ts 4c] [6h]
buy-in86: checks
oxxxy: checks
BefirsSt: checks
*** SHOW DOWN ***
buy-in86: shows [Qh Jh] (two pair, Tens and Fours)
oxxxy: mucks hand
BefirsSt: shows [Qc Ks] (two pair, Tens and Fours - King kicker)
BefirsSt collected $3.56 from pot
*** SUMMARY ***
Total pot $3.75 | Rake $0.19
Board [Tc 4d Ts 4c 6h]
Seat 1: redbrain0817 folded before Flop (didn't bet)
Seat 2: BefirsSt (button) showed [Qc Ks] and won ($3.56) with two pair, Tens and Fours
Seat 3: buy-in86 (small blind) showed [Qh Jh] and lost with two pair, Tens and Fours
Seat 4: oxxxy (big blind) mucked
Seat 5: dimakryt1 folded before Flop (didn't bet)


PokerStars Hand #220326295344:  Hold'em No Limit ($0.25/$0.50 USD) - 2020/11/12 17:01:49 ET
Table 'Tarvos III' 6-max Seat #3 is the button
Seat 1: redbrain0817 ($79.41 in chips)
Seat 2: BefirsSt ($53.06 in chips)
Seat 3: buy-in86 ($13.09 in chips)
Seat 4: oxxxy ($63.24 in chips)
Seat 5: dimakryt1 ($50 in chips)
Seat 6: ArcticBearDK ($50 in chips)
oxxxy: posts small blind $0.25
dimakryt1: posts big blind $0.50
*** HOLE CARDS ***
ArcticBearDK: folds
redbrain0817: raises $0.75 to $1.25
BefirsSt: raises $2.75 to $4
buy-in86: folds
oxxxy: folds
dimakryt1: folds
redbrain0817: calls $2.75
*** FLOP *** [4h 8c 8d]
redbrain0817: checks
BefirsSt: bets $3
redbrain0817: calls $3
*** TURN *** [4h 8c 8d] [Jd]
redbrain0817: checks
BefirsSt: checks
*** RIVER *** [4h 8c 8d Jd] [2s]
redbrain0817: checks
BefirsSt: checks
*** SHOW DOWN ***
redbrain0817: shows [Tc Td] (two pair, Tens and Eights)
BefirsSt: mucks hand
redbrain0817 collected $14.01 from pot
*** SUMMARY ***
Total pot $14.75 | Rake $0.74
Board [4h 8c 8d Jd 2s]
Seat 1: redbrain0817 showed [Tc Td] and won ($14.01) with two pair, Tens and Eights
Seat 2: BefirsSt mucked
Seat 3: buy-in86 (button) folded before Flop (didn't bet)
Seat 4: oxxxy (small blind) folded before Flop
Seat 5: dimakryt1 (big blind) folded before Flop
Seat 6: ArcticBearDK folded before Flop (didn't bet)


PokerStars Hand #220326443370:  Hold'em No Limit ($0.25/$0.50 USD) - 2020/11/12 17:05:39 ET
Table 'Tarvos III' 6-max Seat #4 is the button
Seat 1: redbrain0817 ($85.67 in chips)
Seat 2: BefirsSt ($52.94 in chips)
Seat 3: buy-in86 ($16.45 in chips)
Seat 4: oxxxy ($62.24 in chips)
Seat 5: dimakryt1 ($50.25 in chips)
Seat 6: ArcticBearDK ($50 in chips)
dimakryt1: posts small blind $0.25
ArcticBearDK: posts big blind $0.50
*** HOLE CARDS ***
redbrain0817: raises $0.75 to $1.25
BefirsSt: folds
buy-in86: calls $1.25
oxxxy: folds
dimakryt1: folds
ArcticBearDK: folds
*** FLOP *** [4h 6s 6c]
redbrain0817: bets $1.50
buy-in86: raises $1.50 to $3
redbrain0817: raises $5 to $8
buy-in86: raises $7.20 to $15.20 and is all-in
redbrain0817: calls $7.20
*** TURN *** [4h 6s 6c] [Qs]
*** RIVER *** [4h 6s 6c Qs] [9d]
*** SHOW DOWN ***
redbrain0817: shows [Tc Th] (two pair, Tens and Sixes)
buy-in86: shows [Jd Jc] (two pair, Jacks and Sixes)
buy-in86 collected $31.97 from pot
*** SUMMARY ***
Total pot $33.65 | Rake $1.68
Board [4h 6s 6c Qs 9d]
Seat 1: redbrain0817 showed [Tc Th] and lost with two pair, Tens and Sixes
Seat 2: BefirsSt folded before Flop (didn't bet)
Seat 3: buy-in86 showed [Jd Jc] and won ($31.97) with two pair, Jacks and Sixes
Seat 4: oxxxy (button) folded before Flop (didn't bet)
Seat 5: dimakryt1 (small blind) folded before Flop
Seat 6: ArcticBearDK (big blind) folded before Flop


PokerStars Hand #220326517810:  Hold'em No Limit ($0.25/$0.50 USD) - 2020/11/12 17:07:32 ET
Table 'Tarvos III' 6-max Seat #1 is the button
Seat 1: redbrain0817 ($68.47 in chips)
Seat 2: BefirsSt ($50.19 in chips)
Seat 3: buy-in86 ($32.31 in chips)
Seat 4: oxxxy ($62.24 in chips)
Seat 5: dimakryt1 ($50 in chips)
Seat 6: ArcticBearDK ($53 in chips)
BefirsSt: posts small blind $0.25
buy-in86: posts big blind $0.50
*** HOLE CARDS ***
oxxxy: raises $0.62 to $1.12
dimakryt1: folds
ArcticBearDK: folds
redbrain0817: folds
BefirsSt: folds
buy-in86: calls $0.62
*** FLOP *** [4s Ad 3h]
buy-in86: checks
oxxxy: checks
*** TURN *** [4s Ad 3h] [5s]
buy-in86: checks
oxxxy: checks
*** RIVER *** [4s Ad 3h 5s] [4c]
buy-in86: checks
oxxxy: checks
*** SHOW DOWN ***
buy-in86: shows [8h 9d] (a pair of Fours)
oxxxy: shows [Qh Ks] (a pair of Fours - Ace+King kicker)
oxxxy collected $2.37 from pot
*** SUMMARY ***
Total pot $2.49 | Rake $0.12
Board [4s Ad 3h 5s 4c]
Seat 1: redbrain0817 (button) folded before Flop (didn't bet)
Seat 2: BefirsSt (small blind) folded before Flop
Seat 3: buy-in86 (big blind) showed [8h 9d] and lost with a pair of Fours
Seat 4: oxxxy showed [Qh Ks] and won ($2.37) with a pair of Fours
Seat 5: dimakryt1 folded before Flop (didn't bet)
Seat 6: ArcticBearDK folded before Flop (didn't bet)


PokerStars Hand #220327171960:  Hold'em No Limit ($0.25/$0.50 USD) - 2020/11/12 17:24:18 ET
Table 'Tarvos III' 6-max Seat #2 is the button
Seat 1: redbrain0817 ($80.58 in chips)
Seat 2: BefirsSt ($50 in chips)
Seat 3: buy-in86 ($19.68 in chips)
Seat 4: mixailll99 ($53.01 in chips)
Seat 5: dimakryt1 ($71.60 in chips)
Seat 6: ArcticBearDK ($52.54 in chips)
buy-in86: posts small blind $0.25
mixailll99: posts big blind $0.50
*** HOLE CARDS ***
dimakryt1: folds
ArcticBearDK: folds
redbrain0817: folds
BefirsSt: raises $0.75 to $1.25
buy-in86: calls $1
mixailll99: folds
*** FLOP *** [3s 5h 9d]
buy-in86: checks
BefirsSt: checks
*** TURN *** [3s 5h 9d] [6s]
buy-in86: checks
BefirsSt: checks
*** RIVER *** [3s 5h 9d 6s] [Jc]
buy-in86: checks
BefirsSt: checks
*** SHOW DOWN ***
buy-in86: shows [As Kc] (high card Ace)
BefirsSt: mucks hand
buy-in86 collected $2.85 from pot
*** SUMMARY ***
Total pot $3 | Rake $0.15
Board [3s 5h 9d 6s Jc]
Seat 1: redbrain0817 folded before Flop (didn't bet)
Seat 2: BefirsSt (button) mucked
Seat 3: buy-in86 (small blind) showed [As Kc] and won ($2.85) with high card Ace
Seat 4: mixailll99 (big blind) folded before Flop
Seat 5: dimakryt1 folded before Flop (didn't bet)
Seat 6: ArcticBearDK folded before Flop (didn't bet)


PokerStars Hand #220327197523:  Hold'em No Limit ($0.25/$0.50 USD) - 2020/11/12 17:24:59 ET
Table 'Tarvos III' 6-max Seat #3 is the button
Seat 1: redbrain0817 ($80.58 in chips)
Seat 2: BefirsSt ($50 in chips)
Seat 3: buy-in86 ($21.28 in chips)
Seat 4: mixailll99 ($52.51 in chips)
Seat 5: dimakryt1 ($71.60 in chips)
Seat 6: ArcticBearDK ($52.54 in chips)
mixailll99: posts small blind $0.25
dimakryt1: posts big blind $0.50
*** HOLE CARDS ***
ArcticBearDK: folds
redbrain0817: folds
BefirsSt: folds
buy-in86: calls $0.50
mixailll99: folds
dimakryt1: checks
*** FLOP *** [Jh 7d 6h]
dimakryt1: bets $0.50
buy-in86: calls $0.50
*** TURN *** [Jh 7d 6h] [5s]
dimakryt1: checks
buy-in86: checks
*** RIVER *** [Jh 7d 6h 5s] [6d]
dimakryt1: checks
buy-in86: checks
*** SHOW DOWN ***
dimakryt1: shows [5h Qh] (two pair, Sixes and Fives)
buy-in86: shows [Ah 5c] (two pair, Sixes and Fives - Ace kicker)
buy-in86 collected $2.14 from pot
*** SUMMARY ***
Total pot $2.25 | Rake $0.11
Board [Jh 7d 6h 5s 6d]
Seat 1: redbrain0817 folded before Flop (didn't bet)
Seat 2: BefirsSt folded before Flop (didn't bet)
Seat 3: buy-in86 (button) showed [Ah 5c] and won ($2.14) with two pair, Sixes and Fives
Seat 4: mixailll99 (small blind) folded before Flop
Seat 5: dimakryt1 (big blind) showed [5h Qh] and lost with two pair, Sixes and Fives
Seat 6: ArcticBearDK folded before Flop (didn't bet)


PokerStars Hand #220327376625:  Hold'em No Limit ($0.25/$0.50 USD) - 2020/11/12 17:29:52 ET
Table 'Tarvos III' 6-max Seat #6 is the button
Seat 1: redbrain0817 ($78.83 in chips)
Seat 2: BefirsSt ($50 in chips)
Seat 3: buy-in86 ($22.37 in chips)
Seat 4: mixailll99 ($50.51 in chips)
Seat 5: dimakryt1 ($74.13 in chips)
Seat 6: ArcticBearDK ($60.87 in chips)
redbrain0817: posts small blind $0.25
BefirsSt: posts big blind $0.50
*** HOLE CARDS ***
buy-in86: raises $1.25 to $1.75
mixailll99: folds
dimakryt1: calls $1.75
ArcticBearDK: folds
redbrain0817: raises $4.75 to $6.50
BefirsSt: folds
buy-in86: raises $15.87 to $22.37 and is all-in
dimakryt1: folds
redbrain0817: calls $15.87
*** FLOP *** [Kc 9c 4c]
*** TURN *** [Kc 9c 4c] [6c]
*** RIVER *** [Kc 9c 4c 6c] [Qs]
*** SHOW DOWN ***
redbrain0817: shows [Ac Ah] (a flush, Ace high)
buy-in86: shows [7h Th] (high card King)
redbrain0817 collected $44.99 from pot
*** SUMMARY ***
Total pot $46.99 | Rake $2
Board [Kc 9c 4c 6c Qs]
Seat 1: redbrain0817 (small blind) showed [Ac Ah] and won ($44.99) with a flush, Ace high
Seat 2: BefirsSt (big blind) folded before Flop
Seat 3: buy-in86 showed [7h Th] and lost with high card King
Seat 4: mixailll99 folded before Flop (didn't bet)
Seat 5: dimakryt1 folded before Flop
Seat 6: ArcticBearDK (button) folded before Flop (didn't bet)


PokerStars Hand #220327665416:  Hold'em No Limit ($0.25/$0.50 USD) - 2020/11/12 17:37:52 ET
Table 'Tarvos III' 6-max Seat #3 is the button
Seat 1: redbrain0817 ($115.03 in chips)
Seat 2: nastja336 ($50.81 in chips)
Seat 3: buy-in86 ($47.72 in chips)
Seat 4: mixailll99 ($50 in chips)
Seat 5: WinstonasX ($40 in chips)
Seat 6: ArcticBearDK ($63.18 in chips)
mixailll99: posts small blind $0.25
WinstonasX: posts big blind $0.50
*** HOLE CARDS ***
ArcticBearDK: folds
redbrain0817: folds
nastja336: folds
buy-in86: calls $0.50
mixailll99: folds
WinstonasX: checks
*** FLOP *** [9s 3c Tc]
WinstonasX: checks
buy-in86: bets $1.50
WinstonasX: calls $1.50
*** TURN *** [9s 3c Tc] [Qs]
WinstonasX: checks
buy-in86: bets $1.50
WinstonasX: calls $1.50
*** RIVER *** [9s 3c Tc Qs] [Kh]
WinstonasX: bets $2
buy-in86: calls $2
*** SHOW DOWN ***
WinstonasX: shows [9h 5d] (a pair of Nines)
buy-in86: shows [Jc Td] (a straight, Nine to King)
buy-in86 collected $10.69 from pot
*** SUMMARY ***
Total pot $11.25 | Rake $0.56
Board [9s 3c Tc Qs Kh]
Seat 1: redbrain0817 folded before Flop (didn't bet)
Seat 2: nastja336 folded before Flop (didn't bet)
Seat 3: buy-in86 (button) showed [Jc Td] and won ($10.69) with a straight, Nine to King
Seat 4: mixailll99 (small blind) folded before Flop
Seat 5: WinstonasX (big blind) showed [9h 5d] and lost with a pair of Nines
Seat 6: ArcticBearDK folded before Flop (didn't bet)


PokerStars Hand #220327875189:  Hold'em No Limit ($0.25/$0.50 USD) - 2020/11/12 17:43:42 ET
Table 'Tarvos III' 6-max Seat #6 is the button
Seat 1: redbrain0817 ($124.74 in chips)
Seat 2: nastja336 ($50.06 in chips)
Seat 3: buy-in86 ($44.47 in chips)
Seat 4: mixailll99 ($50 in chips)
Seat 5: WinstonasX ($35.41 in chips)
Seat 6: ArcticBearDK ($60.18 in chips)
redbrain0817: posts small blind $0.25
nastja336: posts big blind $0.50
*** HOLE CARDS ***
buy-in86: folds
mixailll99: folds
WinstonasX: calls $0.50
ArcticBearDK: folds
redbrain0817: folds
nastja336: checks
*** FLOP *** [8h Th Ah]
nastja336: checks
WinstonasX: bets $0.50
nastja336: calls $0.50
*** TURN *** [8h Th Ah] [5c]
nastja336: checks
WinstonasX: bets $0.50
nastja336: calls $0.50
*** RIVER *** [8h Th Ah 5c] [Kh]
nastja336: checks
WinstonasX: checks
*** SHOW DOWN ***
nastja336: shows [Ks 7h] (a flush, Ace high)
WinstonasX: mucks hand
nastja336 collected $3.09 from pot
*** SUMMARY ***
Total pot $3.25 | Rake $0.16
Board [8h Th Ah 5c Kh]
Seat 1: redbrain0817 (small blind) folded before Flop
Seat 2: nastja336 (big blind) showed [Ks 7h] and won ($3.09) with a flush, Ace high
Seat 3: buy-in86 folded before Flop (didn't bet)
Seat 4: mixailll99 folded before Flop (didn't bet)
Seat 5: WinstonasX mucked
Seat 6: ArcticBearDK (button) folded before Flop (didn't bet)


PokerStars Hand #220327949865:  Hold'em No Limit ($0.25/$0.50 USD) - 2020/11/12 17:45:50 ET
Table 'Tarvos III' 6-max Seat #3 is the button
Seat 1: redbrain0817 ($124.49 in chips)
Seat 2: nastja336 ($51.15 in chips)
Seat 3: buy-in86 ($52.17 in chips)
Seat 4: mixailll99 ($50.25 in chips)
Seat 5: WinstonasX ($25.60 in chips)
Seat 6: ArcticBearDK ($60.18 in chips)
mixailll99: posts small blind $0.25
WinstonasX: posts big blind $0.50
*** HOLE CARDS ***
ArcticBearDK: folds
redbrain0817: folds
nastja336: folds
buy-in86: calls $0.50
mixailll99: folds
WinstonasX: checks
*** FLOP *** [Ac 4h 2d]
WinstonasX: checks
buy-in86: checks
*** TURN *** [Ac 4h 2d] [Qs]
WinstonasX: checks
buy-in86: checks
*** RIVER *** [Ac 4h 2d Qs] [Kd]
WinstonasX: checks
buy-in86: checks
*** SHOW DOWN ***
WinstonasX: shows [5s 8d] (high card Ace)
buy-in86: mucks hand
WinstonasX collected $1.19 from pot
*** SUMMARY ***
Total pot $1.25 | Rake $0.06
Board [Ac 4h 2d Qs Kd]
Seat 1: redbrain0817 folded before Flop (didn't bet)
Seat 2: nastja336 folded before Flop (didn't bet)
Seat 3: buy-in86 (button) mucked
Seat 4: mixailll99 (small blind) folded before Flop
Seat 5: WinstonasX (big blind) showed [5s 8d] and won ($1.19) with high card Ace
Seat 6: ArcticBearDK folded before Flop (didn't bet)


PokerStars Hand #220328000380:  Hold'em No Limit ($0.25/$0.50 USD) - 2020/11/12 17:47:03 ET
Table 'Tarvos III' 6-max Seat #5 is the button
Seat 1: redbrain0817 ($124.49 in chips)
Seat 2: nastja336 ($51.15 in chips)
Seat 3: buy-in86 ($52.36 in chips)
Seat 4: mixailll99 ($50 in chips)
Seat 5: WinstonasX ($26.04 in chips)
Seat 6: ArcticBearDK ($59.68 in chips)
ArcticBearDK: posts small blind $0.25
redbrain0817: posts big blind $0.50
*** HOLE CARDS ***
nastja336: folds
buy-in86: raises $0.50 to $1
mixailll99: raises $2.50 to $3.50
WinstonasX: folds
ArcticBearDK: folds
redbrain0817: folds
buy-in86: calls $2.50
*** FLOP *** [5s 7d 2h]
buy-in86: checks
mixailll99: checks
*** TURN *** [5s 7d 2h] [8d]
buy-in86: checks
mixailll99: checks
*** RIVER *** [5s 7d 2h 8d] [4s]
buy-in86: checks
mixailll99: checks
*** SHOW DOWN ***
buy-in86: shows [Kd 9h] (high card King)
mixailll99: shows [Jd Ks] (high card King - Jack kicker)
mixailll99 collected $7.36 from pot
*** SUMMARY ***
Total pot $7.75 | Rake $0.39
Board [5s 7d 2h 8d 4s]
Seat 1: redbrain0817 (big blind) folded before Flop
Seat 2: nastja336 folded before Flop (didn't bet)
Seat 3: buy-in86 showed [Kd 9h] and lost with high card King
Seat 4: mixailll99 showed [Jd Ks] and won ($7.36) with high card King
Seat 5: WinstonasX (button) folded before Flop (didn't bet)
Seat 6: ArcticBearDK (small blind) folded before Flop


PokerStars Hand #220328222337:  Hold'em No Limit ($0.25/$0.50 USD) - 2020/11/12 17:53:30 ET
Table 'Tarvos III' 6-max Seat #3 is the button
Seat 1: redbrain0817 ($124.09 in chips)
Seat 2: nastja336 ($54.05 in chips)
Seat 3: buy-in86 ($44.11 in chips)
Seat 4: mixailll99 ($54.54 in chips)
Seat 5: WinstonasX ($29.82 in chips)
Seat 6: ArcticBearDK ($55.77 in chips)
mixailll99: posts small blind $0.25
WinstonasX: posts big blind $0.50
*** HOLE CARDS ***
ArcticBearDK: raises $1 to $1.50
redbrain0817: folds
nastja336: folds
buy-in86: folds
mixailll99: folds
WinstonasX: calls $1
*** FLOP *** [Jh 7s 6c]
WinstonasX: checks
ArcticBearDK: bets $2
WinstonasX: calls $2
*** TURN *** [Jh 7s 6c] [Js]
WinstonasX: checks
ArcticBearDK: bets $3.50
WinstonasX: calls $3.50
*** RIVER *** [Jh 7s 6c Js] [Kd]
WinstonasX: checks
ArcticBearDK: checks
*** SHOW DOWN ***
WinstonasX: shows [7h Qs] (two pair, Jacks and Sevens)
ArcticBearDK: mucks hand
WinstonasX collected $13.54 from pot
*** SUMMARY ***
Total pot $14.25 | Rake $0.71
Board [Jh 7s 6c Js Kd]
Seat 1: redbrain0817 folded before Flop (didn't bet)
Seat 2: nastja336 folded before Flop (didn't bet)
Seat 3: buy-in86 (button) folded before Flop (didn't bet)
Seat 4: mixailll99 (small blind) folded before Flop
Seat 5: WinstonasX (big blind) showed [7h Qs] and won ($13.54) with two pair, Jacks and Sevens
Seat 6: ArcticBearDK mucked


PokerStars Hand #220328276247:  Hold'em No Limit ($0.25/$0.50 USD) - 2020/11/12 17:55:07 ET
Table 'Tarvos III' 6-max Seat #5 is the button
Seat 1: redbrain0817 ($124.09 in chips)
Seat 2: nastja336 ($57.06 in chips)
Seat 3: buy-in86 ($42.61 in chips)
Seat 4: mixailll99 ($54.29 in chips)
Seat 5: WinstonasX ($36.11 in chips)
Seat 6: ArcticBearDK ($50 in chips)
ArcticBearDK: posts small blind $0.25
redbrain0817: posts big blind $0.50
*** HOLE CARDS ***
nastja336: folds
buy-in86: raises $1 to $1.50
mixailll99: folds
WinstonasX: folds
ArcticBearDK: folds
redbrain0817: calls $1
*** FLOP *** [Qd Tc 3s]
redbrain0817: checks
buy-in86: checks
*** TURN *** [Qd Tc 3s] [5c]
redbrain0817: checks
buy-in86: checks
*** RIVER *** [Qd Tc 3s 5c] [9s]
redbrain0817: checks
buy-in86: checks
*** SHOW DOWN ***
redbrain0817: shows [2h 2s] (a pair of Deuces)
buy-in86: mucks hand
redbrain0817 collected $3.09 from pot
*** SUMMARY ***
Total pot $3.25 | Rake $0.16
Board [Qd Tc 3s 5c 9s]
Seat 1: redbrain0817 (big blind) showed [2h 2s] and won ($3.09) with a pair of Deuces
Seat 2: nastja336 folded before Flop (didn't bet)
Seat 3: buy-in86 mucked
Seat 4: mixailll99 folded before Flop (didn't bet)
Seat 5: WinstonasX (button) folded before Flop (didn't bet)
Seat 6: ArcticBearDK (small blind) folded before Flop


PokerStars Hand #220328423170:  Hold'em No Limit ($0.25/$0.50 USD) - 2020/11/12 18:00:48 ET
Table 'Tarvos III' 6-max Seat #1 is the button
Seat 1: redbrain0817 ($123.32 in chips)
Seat 2: nastja336 ($50 in chips)
Seat 3: buy-in86 ($42.22 in chips)
Seat 4: mixailll99 ($55.79 in chips)
Seat 5: WinstonasX ($38.18 in chips)
Seat 6: ArcticBearDK ($54.40 in chips)
nastja336: posts small blind $0.25
buy-in86: posts big blind $0.50
*** HOLE CARDS ***
mixailll99: folds
WinstonasX: calls $0.50
ArcticBearDK: folds
redbrain0817: raises $1.50 to $2
nastja336: folds
buy-in86: folds
WinstonasX: calls $1.50
*** FLOP *** [2s 4s 3d]
WinstonasX: bets $1
redbrain0817: calls $1
*** TURN *** [2s 4s 3d] [Ks]
WinstonasX: bets $2
redbrain0817: calls $2
*** RIVER *** [2s 4s 3d Ks] [5h]
WinstonasX: bets $2.50
redbrain0817: calls $2.50
*** SHOW DOWN ***
WinstonasX: shows [8d Jd] (high card King)
redbrain0817: shows [Kd As] (a straight, Ace to Five)
redbrain0817 collected $14.96 from pot
*** SUMMARY ***
Total pot $15.75 | Rake $0.79
Board [2s 4s 3d Ks 5h]
Seat 1: redbrain0817 (button) showed [Kd As] and won ($14.96) with a straight, Ace to Five
Seat 2: nastja336 (small blind) folded before Flop
Seat 3: buy-in86 (big blind) folded before Flop
Seat 4: mixailll99 folded before Flop (didn't bet)
Seat 5: WinstonasX showed [8d Jd] and lost with high card King
Seat 6: ArcticBearDK folded before Flop (didn't bet)


PokerStars Hand #220328543609:  Hold'em No Limit ($0.25/$0.50 USD) - 2020/11/12 18:04:24 ET
Table 'Tarvos III' 6-max Seat #1 is the button
Seat 1: redbrain0817 ($130.03 in chips)
Seat 2: nastja336 ($50.25 in chips)
Seat 3: buy-in86 ($40.66 in chips)
Seat 4: mixailll99 ($54.54 in chips)
Seat 5: WinstonasX ($29.68 in chips)
Seat 6: ArcticBearDK ($57.85 in chips)
nastja336: posts small blind $0.25
buy-in86: posts big blind $0.50
*** HOLE CARDS ***
mixailll99: folds
WinstonasX: calls $0.50
ArcticBearDK: raises $1.50 to $2
redbrain0817: folds
nastja336: folds
buy-in86: folds
WinstonasX: calls $1.50
*** FLOP *** [Ah Ks Jh]
WinstonasX: checks
ArcticBearDK: bets $2.75
WinstonasX: calls $2.75
*** TURN *** [Ah Ks Jh] [Qh]
WinstonasX: bets $24.93 and is all-in
ArcticBearDK: calls $24.93
*** RIVER *** [Ah Ks Jh Qh] [Jd]
*** SHOW DOWN ***
WinstonasX: shows [Tc 5c] (a straight, Ten to Ace)
ArcticBearDK: shows [Th Ad] (a straight, Ten to Ace)
WinstonasX collected $29.06 from pot
ArcticBearDK collected $29.05 from pot
*** SUMMARY ***
Total pot $60.11 | Rake $2
Board [Ah Ks Jh Qh Jd]
Seat 1: redbrain0817 (button) folded before Flop (didn't bet)
Seat 2: nastja336 (small blind) folded before Flop
Seat 3: buy-in86 (big blind) folded before Flop
Seat 4: mixailll99 folded before Flop (didn't bet)
Seat 5: WinstonasX showed [Tc 5c] and won ($29.06) with a straight, Ten to Ace
Seat 6: ArcticBearDK showed [Th Ad] and won ($29.05) with a straight, Ten to Ace


PokerStars Hand #220328597980:  Hold'em No Limit ($0.25/$0.50 USD) - 2020/11/12 18:06:05 ET
Table 'Tarvos III' 6-max Seat #3 is the button
Seat 1: redbrain0817 ($130.03 in chips)
Seat 2: nastja336 ($50 in chips)
Seat 3: buy-in86 ($39.91 in chips)
Seat 4: mixailll99 ($54.04 in chips)
Seat 5: WinstonasX ($40.12 in chips)
Seat 6: ArcticBearDK ($50 in chips)
mixailll99: posts small blind $0.25
WinstonasX: posts big blind $0.50
*** HOLE CARDS ***
ArcticBearDK: raises $1 to $1.50
redbrain0817: folds
nastja336: calls $1.50
buy-in86: calls $1.50
mixailll99: folds
WinstonasX: folds
*** FLOP *** [Qs Qh 9s]
ArcticBearDK: checks
nastja336: checks
buy-in86: checks
*** TURN *** [Qs Qh 9s] [Ts]
ArcticBearDK: checks
nastja336: checks
buy-in86: checks
*** RIVER *** [Qs Qh 9s Ts] [Jh]
ArcticBearDK: checks
nastja336: checks
buy-in86: checks
*** SHOW DOWN ***
ArcticBearDK: shows [7d 5d] (a pair of Queens)
nastja336: shows [3d 3c] (two pair, Queens and Threes)
buy-in86: shows [4c 4d] (two pair, Queens and Fours)
buy-in86 collected $4.99 from pot
*** SUMMARY ***
Total pot $5.25 | Rake $0.26
Board [Qs Qh 9s Ts Jh]
Seat 1: redbrain0817 folded before Flop (didn't bet)
Seat 2: nastja336 showed [3d 3c] and lost with two pair, Queens and Threes
Seat 3: buy-in86 (button) showed [4c 4d] and won ($4.99) with two pair, Queens and Fours
Seat 4: mixailll99 (small blind) folded before Flop
Seat 5: WinstonasX (big blind) folded before Flop
Seat 6: ArcticBearDK showed [7d 5d] and lost with a pair of Queens


PokerStars Hand #220328833091:  Hold'em No Limit ($0.25/$0.50 USD) - 2020/11/12 18:13:03 ET
Table 'Tarvos III' 6-max Seat #6 is the button
Seat 1: redbrain0817 ($126.78 in chips)
Seat 2: Lurst ($54 in chips)
Seat 3: buy-in86 ($37.15 in chips)
Seat 5: WinstonasX ($40.87 in chips)
Seat 6: ArcticBearDK ($59.77 in chips)
redbrain0817: posts small blind $0.25
Lurst: posts big blind $0.50
mixailll99: sits out
*** HOLE CARDS ***
buy-in86: folds
WinstonasX: folds
ArcticBearDK: folds
redbrain0817: raises $1 to $1.50
Lurst: calls $1
*** FLOP *** [Kc 6d 4d]
redbrain0817: bets $0.94
Lurst: raises $3.31 to $4.25
redbrain0817: calls $3.31
*** TURN *** [Kc 6d 4d] [Ts]
redbrain0817: checks
Lurst: checks
*** RIVER *** [Kc 6d 4d Ts] [2d]
redbrain0817: checks
Lurst: checks
*** SHOW DOWN ***
redbrain0817: shows [As Jd] (high card Ace)
Lurst: mucks hand
redbrain0817 collected $10.92 from pot
*** SUMMARY ***
Total pot $11.50 | Rake $0.58
Board [Kc 6d 4d Ts 2d]
Seat 1: redbrain0817 (small blind) showed [As Jd] and won ($10.92) with high card Ace
Seat 2: Lurst (big blind) mucked
Seat 3: buy-in86 folded before Flop (didn't bet)
Seat 5: WinstonasX folded before Flop (didn't bet)
Seat 6: ArcticBearDK (button) folded before Flop (didn't bet)


PokerStars Hand #220329033553:  Hold'em No Limit ($0.25/$0.50 USD) - 2020/11/12 18:19:24 ET
Table 'Tarvos III' 6-max Seat #1 is the button
Seat 1: redbrain0817 ($126.45 in chips)
Seat 2: Lurst ($50 in chips)
Seat 3: buy-in86 ($38.57 in chips)
Seat 4: mixailll99 ($53.04 in chips)
Seat 5: pr0tecto ($50 in chips)
Seat 6: ArcticBearDK ($67.27 in chips)
Lurst: posts small blind $0.25
buy-in86: posts big blind $0.50
*** HOLE CARDS ***
mixailll99: raises $1 to $1.50
pr0tecto: folds
ArcticBearDK: folds
redbrain0817: folds
Lurst: folds
buy-in86: calls $1
*** FLOP *** [Kd 2h 2c]
buy-in86: bets $1.54
mixailll99: raises $3.08 to $4.62
buy-in86: calls $3.08
*** TURN *** [Kd 2h 2c] [Qc]
buy-in86: bets $5.93
mixailll99: calls $5.93
*** RIVER *** [Kd 2h 2c Qc] [6d]
buy-in86: bets $11.56
mixailll99: calls $11.56
*** SHOW DOWN ***
buy-in86: shows [Ks 9h] (two pair, Kings and Deuces)
mixailll99: shows [Kh Ad] (two pair, Kings and Deuces - Ace kicker)
mixailll99 collected $45.47 from pot
*** SUMMARY ***
Total pot $47.47 | Rake $2
Board [Kd 2h 2c Qc 6d]
Seat 1: redbrain0817 (button) folded before Flop (didn't bet)
Seat 2: Lurst (small blind) folded before Flop
Seat 3: buy-in86 (big blind) showed [Ks 9h] and lost with two pair, Kings and Deuces
Seat 4: mixailll99 showed [Kh Ad] and won ($45.47) with two pair, Kings and Deuces
Seat 5: pr0tecto folded before Flop (didn't bet)
Seat 6: ArcticBearDK folded before Flop (didn't bet)


PokerStars Hand #220329096881:  Hold'em No Limit ($0.25/$0.50 USD) - 2020/11/12 18:21:26 ET
Table 'Tarvos III' 6-max Seat #6 is the button
Seat 1: redbrain0817 ($124.70 in chips)
Seat 2: Lurst ($50.75 in chips)
Seat 3: buy-in86 ($15.46 in chips)
Seat 4: mixailll99 ($76.90 in chips)
Seat 5: pr0tecto ($50 in chips)
Seat 6: ArcticBearDK ($66.52 in chips)
redbrain0817: posts small blind $0.25
Lurst: posts big blind $0.50
*** HOLE CARDS ***
buy-in86: calls $0.50
mixailll99: folds
pr0tecto: folds
ArcticBearDK: raises $1.35 to $1.85
redbrain0817: folds
Lurst: folds
buy-in86: calls $1.35
*** FLOP *** [4h Ac 6h]
buy-in86: checks
ArcticBearDK: checks
*** TURN *** [4h Ac 6h] [7s]
buy-in86: checks
ArcticBearDK: checks
*** RIVER *** [4h Ac 6h 7s] [9h]
buy-in86: checks
ArcticBearDK: checks
*** SHOW DOWN ***
buy-in86: shows [Kd 3h] (high card Ace)
ArcticBearDK: mucks hand
buy-in86 collected $4.23 from pot
*** SUMMARY ***
Total pot $4.45 | Rake $0.22
Board [4h Ac 6h 7s 9h]
Seat 1: redbrain0817 (small blind) folded before Flop
Seat 2: Lurst (big blind) folded before Flop
Seat 3: buy-in86 showed [Kd 3h] and won ($4.23) with high card Ace
Seat 4: mixailll99 folded before Flop (didn't bet)
Seat 5: pr0tecto folded before Flop (didn't bet)
Seat 6: ArcticBearDK (button) mucked


PokerStars Hand #220329153561:  Hold'em No Limit ($0.25/$0.50 USD) - 2020/11/12 18:23:16 ET
Table 'Tarvos III' 6-max Seat #5 is the button
Seat 1: redbrain0817 ($125.20 in chips)
Seat 2: Lurst ($52.35 in chips)
Seat 3: buy-in86 ($16.09 in chips)
Seat 4: mixailll99 ($76.15 in chips)
Seat 5: pr0tecto ($50 in chips)
Seat 6: ArcticBearDK ($64.92 in chips)
ArcticBearDK: posts small blind $0.25
redbrain0817: posts big blind $0.50
*** HOLE CARDS ***
Lurst: folds
buy-in86: folds
mixailll99: folds
pr0tecto: raises $0.75 to $1.25
ArcticBearDK: folds
redbrain0817: calls $0.75
*** FLOP *** [5c Tc Ad]
redbrain0817: checks
pr0tecto: checks
*** TURN *** [5c Tc Ad] [Th]
redbrain0817: checks
pr0tecto: checks
*** RIVER *** [5c Tc Ad Th] [9s]
redbrain0817: checks
pr0tecto: checks
*** SHOW DOWN ***
redbrain0817: shows [As 6c] (two pair, Aces and Tens)
pr0tecto: mucks hand
redbrain0817 collected $2.61 from pot
*** SUMMARY ***
Total pot $2.75 | Rake $0.14
Board [5c Tc Ad Th 9s]
Seat 1: redbrain0817 (big blind) showed [As 6c] and won ($2.61) with two pair, Aces and Tens
Seat 2: Lurst folded before Flop (didn't bet)
Seat 3: buy-in86 folded before Flop (didn't bet)
Seat 4: mixailll99 folded before Flop (didn't bet)
Seat 5: pr0tecto (button) mucked
Seat 6: ArcticBearDK (small blind) folded before Flop


PokerStars Hand #220329290079:  Hold'em No Limit ($0.25/$0.50 USD) - 2020/11/12 18:27:46 ET
Table 'Tarvos III' 6-max Seat #6 is the button
Seat 1: redbrain0817 ($126.56 in chips)
Seat 2: Lurst ($58.65 in chips)
Seat 3: buy-in86 ($10.34 in chips)
Seat 4: mixailll99 ($75.40 in chips)
Seat 5: pr0tecto ($50 in chips)
Seat 6: ArcticBearDK ($66.42 in chips)
redbrain0817: posts small blind $0.25
Lurst: posts big blind $0.50
*** HOLE CARDS ***
buy-in86: raises $1.25 to $1.75
mixailll99: folds
pr0tecto: folds
ArcticBearDK: folds
redbrain0817: folds
Lurst: calls $1.25
*** FLOP *** [5h 7s Qh]
Lurst: checks
buy-in86: checks
*** TURN *** [5h 7s Qh] [4s]
Lurst: bets $2.50
buy-in86: raises $6.09 to $8.59 and is all-in
Lurst: calls $6.09
*** RIVER *** [5h 7s Qh 4s] [3c]
*** SHOW DOWN ***
Lurst: shows [As 8s] (high card Ace)
buy-in86: shows [5c Qc] (two pair, Queens and Fives)
buy-in86 collected $19.88 from pot
*** SUMMARY ***
Total pot $20.93 | Rake $1.05
Board [5h 7s Qh 4s 3c]
Seat 1: redbrain0817 (small blind) folded before Flop
Seat 2: Lurst (big blind) showed [As 8s] and lost with high card Ace
Seat 3: buy-in86 showed [5c Qc] and won ($19.88) with two pair, Queens and Fives
Seat 4: mixailll99 folded before Flop (didn't bet)
Seat 5: pr0tecto folded before Flop (didn't bet)
Seat 6: ArcticBearDK (button) folded before Flop (didn't bet)


PokerStars Hand #220329430128:  Hold'em No Limit ($0.25/$0.50 USD) - 2020/11/12 18:32:24 ET
Table 'Tarvos III' 6-max Seat #1 is the button
Seat 1: redbrain0817 ($125.56 in chips)
Seat 2: Lurst ($51.80 in chips)
Seat 3: buy-in86 ($14.10 in chips)
Seat 4: mixailll99 ($76.83 in chips)
Seat 5: pr0tecto ($51.49 in chips)
Seat 6: ArcticBearDK ($69.17 in chips)
Lurst: posts small blind $0.25
buy-in86: posts big blind $0.50
*** HOLE CARDS ***
mixailll99: folds
pr0tecto: folds
ArcticBearDK: raises $1 to $1.50
redbrain0817: folds
Lurst: calls $1.25
buy-in86: calls $1
*** FLOP *** [9d 6c Qh]
Lurst: checks
buy-in86: checks
ArcticBearDK: bets $2.75
Lurst: calls $2.75
buy-in86: folds
*** TURN *** [9d 6c Qh] [Th]
Lurst: checks
ArcticBearDK: bets $6.50
Lurst: calls $6.50
*** RIVER *** [9d 6c Qh Th] [4d]
Lurst: checks
ArcticBearDK: checks
*** SHOW DOWN ***
Lurst: shows [Ks Qs] (a pair of Queens)
ArcticBearDK: shows [Kh Qc] (a pair of Queens)
Lurst collected $10.93 from pot
ArcticBearDK collected $10.92 from pot
*** SUMMARY ***
Total pot $23 | Rake $1.15
Board [9d 6c Qh Th 4d]
Seat 1: redbrain0817 (button) folded before Flop (didn't bet)
Seat 2: Lurst (small blind) showed [Ks Qs] and won ($10.93) with a pair of Queens
Seat 3: buy-in86 (big blind) folded on the Flop
Seat 4: mixailll99 folded before Flop (didn't bet)
Seat 5: pr0tecto folded before Flop (didn't bet)
Seat 6: ArcticBearDK showed [Kh Qc] and won ($10.92) with a pair of Queens


PokerStars Hand #220329491063:  Hold'em No Limit ($0.25/$0.50 USD) - 2020/11/12 18:34:14 ET
Table 'Tarvos III' 6-max Seat #3 is the button
Seat 1: redbrain0817 ($125.56 in chips)
Seat 2: Lurst ($53.98 in chips)
Seat 3: buy-in86 ($12.35 in chips)
Seat 4: mixailll99 ($76.33 in chips)
Seat 5: pr0tecto ($50.24 in chips)
Seat 6: ArcticBearDK ($69.34 in chips)
mixailll99: posts small blind $0.25
pr0tecto: posts big blind $0.50
*** HOLE CARDS ***
ArcticBearDK: folds
redbrain0817: folds
Lurst: raises $1 to $1.50
buy-in86: calls $1.50
mixailll99: folds
pr0tecto: folds
*** FLOP *** [Qc 6c 2d]
Lurst: bets $1.82
buy-in86: calls $1.82
*** TURN *** [Qc 6c 2d] [Qh]
Lurst: bets $4
buy-in86: raises $5.03 to $9.03 and is all-in
Lurst: calls $5.03
*** RIVER *** [Qc 6c 2d Qh] [9s]
*** SHOW DOWN ***
Lurst: shows [Tc Th] (two pair, Queens and Tens)
buy-in86: shows [Ac As] (two pair, Aces and Queens)
buy-in86 collected $24.18 from pot
*** SUMMARY ***
Total pot $25.45 | Rake $1.27
Board [Qc 6c 2d Qh 9s]
Seat 1: redbrain0817 folded before Flop (didn't bet)
Seat 2: Lurst showed [Tc Th] and lost with two pair, Queens and Tens
Seat 3: buy-in86 (button) showed [Ac As] and won ($24.18) with two pair, Aces and Queens
Seat 4: mixailll99 (small blind) folded before Flop
Seat 5: pr0tecto (big blind) folded before Flop
Seat 6: ArcticBearDK folded before Flop (didn't bet)


PokerStars Hand #220329848492:  Hold'em No Limit ($0.25/$0.50 USD) - 2020/11/12 18:46:22 ET
Table 'Tarvos III' 6-max Seat #4 is the button
Seat 1: redbrain0817 ($127.19 in chips)
Seat 2: Lurst ($52.10 in chips)
Seat 3: buy-in86 ($15.93 in chips)
Seat 4: mixailll99 ($84.26 in chips)
Seat 5: pr0tecto ($49.50 in chips)
Seat 6: ArcticBearDK ($69.93 in chips)
pr0tecto: posts small blind $0.25
ArcticBearDK: posts big blind $0.50
*** HOLE CARDS ***
redbrain0817: folds
Lurst: raises $1 to $1.50
buy-in86: calls $1.50
mixailll99: raises $4.75 to $6.25
pr0tecto: folds
ArcticBearDK: folds
Lurst: folds
buy-in86: raises $9.68 to $15.93 and is all-in
mixailll99: calls $9.68
*** FLOP *** [6c Ks 4c]
*** TURN *** [6c Ks 4c] [7d]
*** RIVER *** [6c Ks 4c 7d] [Jc]
*** SHOW DOWN ***
buy-in86: shows [Ah 7h] (a pair of Sevens)
mixailll99: shows [Qs Qh] (a pair of Queens)
mixailll99 collected $32.40 from pot
*** SUMMARY ***
Total pot $34.11 | Rake $1.71
Board [6c Ks 4c 7d Jc]
Seat 1: redbrain0817 folded before Flop (didn't bet)
Seat 2: Lurst folded before Flop
Seat 3: buy-in86 showed [Ah 7h] and lost with a pair of Sevens
Seat 4: mixailll99 (button) showed [Qs Qh] and won ($32.40) with a pair of Queens
Seat 5: pr0tecto (small blind) folded before Flop
Seat 6: ArcticBearDK (big blind) folded before Flop


PokerStars Hand #224493539105:  Hold'em No Limit ($0.25/$0.50 USD) - 2021/03/05 16:36:56 ET
Table 'Tezcatlipoca III' 6-max Seat #6 is the button
Seat 1: ArcticBearDK ($52.80 in chips)
Seat 2: pashka148 ($50 in chips)
Seat 3: MaximUSNG ($50 in chips)
Seat 4: easy_sarcasm ($50 in chips)
Seat 5: feelgroundik ($50 in chips)
Seat 6: lukeyfab12 ($44.80 in chips)
ArcticBearDK: posts small blind $0.25
pashka148: posts big blind $0.50
*** HOLE CARDS ***
MaximUSNG: folds
easy_sarcasm: raises $1 to $1.50
feelgroundik: raises $3.50 to $5
lukeyfab12: folds
ArcticBearDK: folds
pashka148: folds
easy_sarcasm: calls $3.50
*** FLOP *** [6c Js 2h]
easy_sarcasm: checks
feelgroundik: checks
*** TURN *** [6c Js 2h] [Jh]
easy_sarcasm: bets $5.21
feelgroundik: calls $5.21
*** RIVER *** [6c Js 2h Jh] [4c]
easy_sarcasm: checks
feelgroundik: checks
*** SHOW DOWN ***
easy_sarcasm: shows [9s 9d] (two pair, Jacks and Nines)
feelgroundik: mucks hand
easy_sarcasm collected $20.11 from pot
*** SUMMARY ***
Total pot $21.17 | Rake $1.06
Board [6c Js 2h Jh 4c]
Seat 1: ArcticBearDK (small blind) folded before Flop
Seat 2: pashka148 (big blind) folded before Flop
Seat 3: MaximUSNG folded before Flop (didn't bet)
Seat 4: easy_sarcasm showed [9s 9d] and won ($20.11) with two pair, Jacks and Nines
Seat 5: feelgroundik mucked
Seat 6: lukeyfab12 (button) folded before Flop (didn't bet)


PokerStars Hand #224493830869:  Hold'em No Limit ($0.25/$0.50 USD) - 2021/03/05 16:43:17 ET
Table 'Tezcatlipoca III' 6-max Seat #2 is the button
Seat 1: ArcticBearDK ($51.80 in chips)
Seat 2: pashka148 ($50.75 in chips)
Seat 3: MaximUSNG ($50 in chips)
Seat 4: easy_sarcasm ($59.90 in chips)
Seat 5: feelgroundik ($50 in chips)
Seat 6: lukeyfab12 ($60.07 in chips)
MaximUSNG: posts small blind $0.25
easy_sarcasm: posts big blind $0.50
*** HOLE CARDS ***
feelgroundik: raises $1 to $1.50
lukeyfab12 has timed out
lukeyfab12: folds
ArcticBearDK: folds
pashka148: folds
MaximUSNG: folds
easy_sarcasm: calls $1
*** FLOP *** [2d 8c 8h]
easy_sarcasm: checks
feelgroundik: checks
*** TURN *** [2d 8c 8h] [5d]
easy_sarcasm: bets $2
feelgroundik: calls $2
*** RIVER *** [2d 8c 8h 5d] [Ah]
easy_sarcasm: checks
feelgroundik: bets $1.75
easy_sarcasm: raises $5.71 to $7.46
feelgroundik: calls $5.71
*** SHOW DOWN ***
easy_sarcasm: shows [Qd Kd] (a pair of Eights)
feelgroundik: shows [As 4s] (two pair, Aces and Eights)
feelgroundik collected $21.06 from pot
*** SUMMARY ***
Total pot $22.17 | Rake $1.11
Board [2d 8c 8h 5d Ah]
Seat 1: ArcticBearDK folded before Flop (didn't bet)
Seat 2: pashka148 (button) folded before Flop (didn't bet)
Seat 3: MaximUSNG (small blind) folded before Flop
Seat 4: easy_sarcasm (big blind) showed [Qd Kd] and lost with a pair of Eights
Seat 5: feelgroundik showed [As 4s] and won ($21.06) with two pair, Aces and Eights
Seat 6: lukeyfab12 folded before Flop (didn't bet)


PokerStars Hand #224493932125:  Hold'em No Limit ($0.25/$0.50 USD) - 2021/03/05 16:45:33 ET
Table 'Tezcatlipoca III' 6-max Seat #2 is the button
Seat 1: ArcticBearDK ($53.72 in chips)
Seat 2: pashka148 ($50.75 in chips)
Seat 3: MaximUSNG ($50 in chips)
Seat 4: easy_sarcasm ($50 in chips)
Seat 6: lukeyfab12 ($60.82 in chips)
MaximUSNG: posts small blind $0.25
easy_sarcasm: posts big blind $0.50
dimakryt1: sits out
*** HOLE CARDS ***
lukeyfab12: raises $0.50 to $1
ArcticBearDK: folds
pashka148: folds
MaximUSNG: folds
easy_sarcasm: raises $4.50 to $5.50
lukeyfab12: calls $4.50
*** FLOP *** [Qh 6c 7h]
easy_sarcasm: bets $3.42
lukeyfab12: calls $3.42
*** TURN *** [Qh 6c 7h] [3d]
easy_sarcasm: checks
lukeyfab12: checks
*** RIVER *** [Qh 6c 7h 3d] [Kd]
easy_sarcasm: bets $8.77
lukeyfab12: calls $8.77
*** SHOW DOWN ***
easy_sarcasm: shows [Kh Ac] (a pair of Kings)
lukeyfab12: mucks hand
easy_sarcasm collected $33.85 from pot
*** SUMMARY ***
Total pot $35.63 | Rake $1.78
Board [Qh 6c 7h 3d Kd]
Seat 1: ArcticBearDK folded before Flop (didn't bet)
Seat 2: pashka148 (button) folded before Flop (didn't bet)
Seat 3: MaximUSNG (small blind) folded before Flop
Seat 4: easy_sarcasm (big blind) showed [Kh Ac] and won ($33.85) with a pair of Kings
Seat 6: lukeyfab12 mucked


PokerStars Hand #224494004322:  Hold'em No Limit ($0.25/$0.50 USD) - 2021/03/05 16:47:09 ET
Table 'Tezcatlipoca III' 6-max Seat #5 is the button
Seat 1: ArcticBearDK ($53.72 in chips)
Seat 2: pashka148 ($50.75 in chips)
Seat 3: MaximUSNG ($50.75 in chips)
Seat 4: easy_sarcasm ($64.21 in chips)
Seat 5: dimakryt1 ($50 in chips)
Seat 6: lukeyfab12 ($44.90 in chips)
lukeyfab12: posts small blind $0.25
ArcticBearDK: posts big blind $0.50
*** HOLE CARDS ***
pashka148: raises $0.75 to $1.25
MaximUSNG: folds
easy_sarcasm: folds
dimakryt1: folds
lukeyfab12: raises $0.75 to $2
ArcticBearDK: folds
pashka148: raises $4 to $6
lukeyfab12: calls $4
*** FLOP *** [4d 4s 7h]
lukeyfab12: bets $5.94
pashka148: calls $5.94
*** TURN *** [4d 4s 7h] [7d]
lukeyfab12: bets $5.50
pashka148: raises $33.31 to $38.81 and is all-in
lukeyfab12: calls $27.46 and is all-in
Uncalled bet ($5.85) returned to pashka148
*** RIVER *** [4d 4s 7h 7d] [Ks]
*** SHOW DOWN ***
lukeyfab12: shows [8s 9d] (two pair, Sevens and Fours)
pashka148: shows [Qh Qs] (two pair, Queens and Sevens)
pashka148 collected $88.30 from pot
*** SUMMARY ***
Total pot $90.30 | Rake $2
Board [4d 4s 7h 7d Ks]
Seat 1: ArcticBearDK (big blind) folded before Flop
Seat 2: pashka148 showed [Qh Qs] and won ($88.30) with two pair, Queens and Sevens
Seat 3: MaximUSNG folded before Flop (didn't bet)
Seat 4: easy_sarcasm folded before Flop (didn't bet)
Seat 5: dimakryt1 (button) folded before Flop (didn't bet)
Seat 6: lukeyfab12 (small blind) showed [8s 9d] and lost with two pair, Sevens and Fours


PokerStars Hand #219634119259:  Hold'em No Limit ($0.25/$0.50 USD) - 2020/10/22 15:54:38 ET
Table 'Thernoe IV' 6-max Seat #1 is the button
Seat 1: SIBISH ($50 in chips)
Seat 2: THEitinBEST ($167.48 in chips)
Seat 3: dorzund ($50 in chips)
Seat 4: RiverCathy ($59.88 in chips)
Seat 6: alwerrashed ($49.90 in chips)
THEitinBEST: posts small blind $0.25
dorzund: posts big blind $0.50
ArcticBearDK: sits out
*** HOLE CARDS ***
RiverCathy: folds
alwerrashed: folds
SIBISH: folds
THEitinBEST: raises $1 to $1.50
dorzund: calls $1
*** FLOP *** [4c 7c 5c]
THEitinBEST: checks
dorzund: bets $1.88
THEitinBEST: calls $1.88
*** TURN *** [4c 7c 5c] [5h]
THEitinBEST: checks
dorzund: bets $4.24
THEitinBEST: calls $4.24
*** RIVER *** [4c 7c 5c 5h] [Qd]
THEitinBEST: checks
dorzund: checks
*** SHOW DOWN ***
THEitinBEST: shows [Kc Jd] (a pair of Fives)
dorzund: shows [7s 6d] (two pair, Sevens and Fives)
dorzund collected $14.48 from pot
*** SUMMARY ***
Total pot $15.24 | Rake $0.76
Board [4c 7c 5c 5h Qd]
Seat 1: SIBISH (button) folded before Flop (didn't bet)
Seat 2: THEitinBEST (small blind) showed [Kc Jd] and lost with a pair of Fives
Seat 3: dorzund (big blind) showed [7s 6d] and won ($14.48) with two pair, Sevens and Fives
Seat 4: RiverCathy folded before Flop (didn't bet)
Seat 6: alwerrashed folded before Flop (didn't bet)


PokerStars Hand #219634173907:  Hold'em No Limit ($0.25/$0.50 USD) - 2020/10/22 15:56:26 ET
Table 'Thernoe IV' 6-max Seat #3 is the button
Seat 1: SIBISH ($50 in chips)
Seat 2: THEitinBEST ($159.86 in chips)
Seat 3: dorzund ($56.61 in chips)
Seat 4: RiverCathy ($60.13 in chips)
Seat 5: ArcticBearDK ($50 in chips)
Seat 6: alwerrashed ($49.90 in chips)
RiverCathy: posts small blind $0.25
ArcticBearDK: posts big blind $0.50
*** HOLE CARDS ***
alwerrashed: folds
SIBISH: folds
THEitinBEST: raises $0.75 to $1.25
dorzund: folds
RiverCathy: calls $1
ArcticBearDK: folds
*** FLOP *** [2c Qh 3d]
RiverCathy: checks
THEitinBEST: bets $0.86
RiverCathy: calls $0.86
*** TURN *** [2c Qh 3d] [6c]
RiverCathy: checks
THEitinBEST: bets $3.50
RiverCathy: calls $3.50
*** RIVER *** [2c Qh 3d 6c] [6d]
RiverCathy: checks
THEitinBEST: bets $8.35
RiverCathy: calls $8.35
*** SHOW DOWN ***
THEitinBEST: shows [7h 5h] (a pair of Sixes)
RiverCathy: shows [Kc Qs] (two pair, Queens and Sixes)
RiverCathy collected $27 from pot
*** SUMMARY ***
Total pot $28.42 | Rake $1.42
Board [2c Qh 3d 6c 6d]
Seat 1: SIBISH folded before Flop (didn't bet)
Seat 2: THEitinBEST showed [7h 5h] and lost with a pair of Sixes
Seat 3: dorzund (button) folded before Flop (didn't bet)
Seat 4: RiverCathy (small blind) showed [Kc Qs] and won ($27) with two pair, Queens and Sixes
Seat 5: ArcticBearDK (big blind) folded before Flop
Seat 6: alwerrashed folded before Flop (didn't bet)


PokerStars Hand #219634327778:  Hold'em No Limit ($0.25/$0.50 USD) - 2020/10/22 16:01:50 ET
Table 'Thernoe IV' 6-max Seat #1 is the button
Seat 1: SIBISH ($56.95 in chips)
Seat 2: THEitinBEST ($162.01 in chips)
Seat 5: ArcticBearDK ($50 in chips)
Seat 6: alwerrashed ($34.84 in chips)
THEitinBEST: posts small blind $0.25
dorzund: is sitting out
ArcticBearDK: posts big blind $0.50
*** HOLE CARDS ***
dorzund leaves the table
alwerrashed: calls $0.50
Lurst joins the table at seat #3
SIBISH has timed out
SIBISH: folds
THEitinBEST: folds
ArcticBearDK: checks
*** FLOP *** [2d Kd 5h]
ArcticBearDK: checks
alwerrashed: checks
*** TURN *** [2d Kd 5h] [7d]
ArcticBearDK: bets $0.75
alwerrashed: calls $0.75
*** RIVER *** [2d Kd 5h 7d] [3h]
ArcticBearDK: checks
alwerrashed: checks
*** SHOW DOWN ***
ArcticBearDK: shows [5s Jc] (a pair of Fives)
alwerrashed: shows [9s 7h] (a pair of Sevens)
alwerrashed collected $2.61 from pot
*** SUMMARY ***
Total pot $2.75 | Rake $0.14
Board [2d Kd 5h 7d 3h]
Seat 1: SIBISH (button) folded before Flop (didn't bet)
Seat 2: THEitinBEST (small blind) folded before Flop
Seat 5: ArcticBearDK (big blind) showed [5s Jc] and lost with a pair of Fives
Seat 6: alwerrashed showed [9s 7h] and won ($2.61) with a pair of Sevens


PokerStars Hand #219634353889:  Hold'em No Limit ($0.25/$0.50 USD) - 2020/10/22 16:02:35 ET
Table 'Thernoe IV' 6-max Seat #5 is the button
Seat 1: SIBISH ($56.95 in chips)
Seat 2: THEitinBEST ($161.76 in chips)
Seat 5: ArcticBearDK ($50.50 in chips)
Seat 6: alwerrashed ($35.70 in chips)
alwerrashed: posts small blind $0.25
SIBISH: posts big blind $0.50
Lurst: sits out
*** HOLE CARDS ***
THEitinBEST: folds
ArcticBearDK: raises $0.85 to $1.35
alwerrashed: calls $1.10
SIBISH: folds
*** FLOP *** [4d Qc Qh]
alwerrashed: checks
ArcticBearDK: bets $2
alwerrashed: calls $2
*** TURN *** [4d Qc Qh] [7c]
alwerrashed: checks
ArcticBearDK: bets $4
alwerrashed: calls $4
*** RIVER *** [4d Qc Qh 7c] [Kh]
alwerrashed: checks
ArcticBearDK: checks
*** SHOW DOWN ***
alwerrashed: shows [3c 4c] (two pair, Queens and Fours)
ArcticBearDK: shows [Tc Ts] (two pair, Queens and Tens)
ArcticBearDK collected $14.45 from pot
*** SUMMARY ***
Total pot $15.20 | Rake $0.75
Board [4d Qc Qh 7c Kh]
Seat 1: SIBISH (big blind) folded before Flop
Seat 2: THEitinBEST folded before Flop (didn't bet)
Seat 5: ArcticBearDK (button) showed [Tc Ts] and won ($14.45) with two pair, Queens and Tens
Seat 6: alwerrashed (small blind) showed [3c 4c] and lost with two pair, Queens and Fours


PokerStars Hand #219634383894:  Hold'em No Limit ($0.25/$0.50 USD) - 2020/10/22 16:03:25 ET
Table 'Thernoe IV' 6-max Seat #1 is the button
Seat 1: SIBISH ($56.20 in chips)
Seat 2: THEitinBEST ($161.26 in chips)
Seat 3: Lurst ($50 in chips)
Seat 5: ArcticBearDK ($57.60 in chips)
Seat 6: alwerrashed ($29.10 in chips)
THEitinBEST: posts small blind $0.25
Lurst: posts big blind $0.50
*** HOLE CARDS ***
ArcticBearDK: raises $0.75 to $1.25
alwerrashed: folds
SIBISH: raises $2.62 to $3.87
THEitinBEST: folds
Lurst: folds
ArcticBearDK: calls $2.62
*** FLOP *** [4d 4c 7c]
ArcticBearDK: checks
SIBISH: bets $4.48
ArcticBearDK: calls $4.48
*** TURN *** [4d 4c 7c] [3h]
ArcticBearDK: checks
SIBISH: checks
*** RIVER *** [4d 4c 7c 3h] [Jh]
ArcticBearDK: checks
SIBISH: checks
*** SHOW DOWN ***
ArcticBearDK: shows [9c 9d] (two pair, Nines and Fours)
SIBISH: mucks hand
ArcticBearDK collected $16.58 from pot
*** SUMMARY ***
Total pot $17.45 | Rake $0.87
Board [4d 4c 7c 3h Jh]
Seat 1: SIBISH (button) mucked
Seat 2: THEitinBEST (small blind) folded before Flop
Seat 3: Lurst (big blind) folded before Flop
Seat 5: ArcticBearDK showed [9c 9d] and won ($16.58) with two pair, Nines and Fours
Seat 6: alwerrashed folded before Flop (didn't bet)


PokerStars Hand #219634476488:  Hold'em No Limit ($0.25/$0.50 USD) - 2020/10/22 16:05:58 ET
Table 'Thernoe IV' 6-max Seat #6 is the button
Seat 1: SIBISH ($50 in chips)
Seat 2: THEitinBEST ($158.51 in chips)
Seat 3: Lurst ($55.41 in chips)
Seat 5: ArcticBearDK ($65.08 in chips)
Seat 6: alwerrashed ($27.10 in chips)
SIBISH: posts small blind $0.25
THEitinBEST: posts big blind $0.50
*** HOLE CARDS ***
Lurst: raises $1 to $1.50
ArcticBearDK: folds
alwerrashed: calls $1.50
SIBISH: folds
THEitinBEST: folds
*** FLOP *** [Kh 9d 3d]
Lurst: bets $0.75
alwerrashed: calls $0.75
*** TURN *** [Kh 9d 3d] [Th]
Lurst: bets $1.70
alwerrashed: calls $1.70
*** RIVER *** [Kh 9d 3d Th] [6s]
Lurst: checks
alwerrashed: bets $6.50
Lurst: calls $6.50
*** SHOW DOWN ***
alwerrashed: shows [Qh 4h] (high card King)
Lurst: shows [Ah Td] (a pair of Tens)
Lurst collected $20.57 from pot
*** SUMMARY ***
Total pot $21.65 | Rake $1.08
Board [Kh 9d 3d Th 6s]
Seat 1: SIBISH (small blind) folded before Flop
Seat 2: THEitinBEST (big blind) folded before Flop
Seat 3: Lurst showed [Ah Td] and won ($20.57) with a pair of Tens
Seat 5: ArcticBearDK folded before Flop (didn't bet)
Seat 6: alwerrashed (button) showed [Qh 4h] and lost with high card King


PokerStars Hand #219634518806:  Hold'em No Limit ($0.25/$0.50 USD) - 2020/10/22 16:07:08 ET
Table 'Thernoe IV' 6-max Seat #2 is the button
Seat 1: SIBISH ($50 in chips)
Seat 2: THEitinBEST ($157.76 in chips)
Seat 3: Lurst ($65.03 in chips)
Seat 5: ArcticBearDK ($65.08 in chips)
Seat 6: alwerrashed ($17.40 in chips)
Lurst: posts small blind $0.25
ArcticBearDK: posts big blind $0.50
*** HOLE CARDS ***
alwerrashed: raises $1 to $1.50
SIBISH: folds
THEitinBEST: folds
Lurst: folds
ArcticBearDK: calls $1
*** FLOP *** [2c Qc Th]
ArcticBearDK: checks
alwerrashed: checks
*** TURN *** [2c Qc Th] [6s]
ArcticBearDK: checks
alwerrashed: checks
*** RIVER *** [2c Qc Th 6s] [Jh]
ArcticBearDK: checks
alwerrashed: checks
*** SHOW DOWN ***
ArcticBearDK: shows [Kh 3h] (high card King)
alwerrashed: shows [3d Kd] (high card King)
ArcticBearDK collected $1.55 from pot
alwerrashed collected $1.54 from pot
RiverCathy was removed from the table for failing to post
RiverCathy leaves the table
*** SUMMARY ***
Total pot $3.25 | Rake $0.16
Board [2c Qc Th 6s Jh]
Seat 1: SIBISH folded before Flop (didn't bet)
Seat 2: THEitinBEST (button) folded before Flop (didn't bet)
Seat 3: Lurst (small blind) folded before Flop
Seat 5: ArcticBearDK (big blind) showed [Kh 3h] and won ($1.55) with high card King
Seat 6: alwerrashed showed [3d Kd] and won ($1.54) with high card King


PokerStars Hand #219634537659:  Hold'em No Limit ($0.25/$0.50 USD) - 2020/10/22 16:07:39 ET
Table 'Thernoe IV' 6-max Seat #3 is the button
Seat 1: SIBISH ($50 in chips)
Seat 2: THEitinBEST ($157.76 in chips)
Seat 3: Lurst ($64.78 in chips)
Seat 5: ArcticBearDK ($65.13 in chips)
Seat 6: alwerrashed ($17.44 in chips)
ArcticBearDK: posts small blind $0.25
alwerrashed: posts big blind $0.50
*** HOLE CARDS ***
Iuckyfluke joins the table at seat #4
SIBISH: folds
THEitinBEST: folds
Lurst: folds
ArcticBearDK: raises $1 to $1.50
alwerrashed: calls $1
*** FLOP *** [3s 5h Js]
ArcticBearDK: checks
alwerrashed: checks
*** TURN *** [3s 5h Js] [5c]
ArcticBearDK: checks
alwerrashed: checks
*** RIVER *** [3s 5h Js 5c] [Jh]
ArcticBearDK: checks
alwerrashed: checks
*** SHOW DOWN ***
ArcticBearDK: shows [7c 9c] (two pair, Jacks and Fives)
alwerrashed: shows [9s Kh] (two pair, Jacks and Fives - King kicker)
alwerrashed collected $2.85 from pot
*** SUMMARY ***
Total pot $3 | Rake $0.15
Board [3s 5h Js 5c Jh]
Seat 1: SIBISH folded before Flop (didn't bet)
Seat 2: THEitinBEST folded before Flop (didn't bet)
Seat 3: Lurst (button) folded before Flop (didn't bet)
Seat 5: ArcticBearDK (small blind) showed [7c 9c] and lost with two pair, Jacks and Fives
Seat 6: alwerrashed (big blind) showed [9s Kh] and won ($2.85) with two pair, Jacks and Fives


PokerStars Hand #219634654855:  Hold'em No Limit ($0.25/$0.50 USD) - 2020/10/22 16:10:53 ET
Table 'Thernoe IV' 6-max Seat #4 is the button
Seat 1: SIBISH ($50 in chips)
Seat 2: THEitinBEST ($157.76 in chips)
Seat 3: Lurst ($67.04 in chips)
Seat 4: Iuckyfluke ($50 in chips)
Seat 5: ArcticBearDK ($61.30 in chips)
Seat 6: alwerrashed ($19.98 in chips)
ArcticBearDK: posts small blind $0.25
alwerrashed: posts big blind $0.50
*** HOLE CARDS ***
SIBISH: folds
THEitinBEST: folds
Lurst: folds
Iuckyfluke: raises $0.75 to $1.25
ArcticBearDK: folds
alwerrashed: calls $0.75
*** FLOP *** [4c 7d 9h]
alwerrashed: checks
Iuckyfluke: bets $0.86
alwerrashed: calls $0.86
*** TURN *** [4c 7d 9h] [Ks]
alwerrashed: checks
Iuckyfluke: bets $4
alwerrashed: calls $4
*** RIVER *** [4c 7d 9h Ks] [Ts]
alwerrashed: checks
Iuckyfluke: bets $14
alwerrashed: calls $13.87 and is all-in
Uncalled bet ($0.13) returned to Iuckyfluke
*** SHOW DOWN ***
Iuckyfluke: shows [7c Kh] (two pair, Kings and Sevens)
alwerrashed: shows [9c Tc] (two pair, Tens and Nines)
Iuckyfluke collected $38.21 from pot
*** SUMMARY ***
Total pot $40.21 | Rake $2
Board [4c 7d 9h Ks Ts]
Seat 1: SIBISH folded before Flop (didn't bet)
Seat 2: THEitinBEST folded before Flop (didn't bet)
Seat 3: Lurst folded before Flop (didn't bet)
Seat 4: Iuckyfluke (button) showed [7c Kh] and won ($38.21) with two pair, Kings and Sevens
Seat 5: ArcticBearDK (small blind) folded before Flop
Seat 6: alwerrashed (big blind) showed [9c Tc] and lost with two pair, Tens and Nines


PokerStars Hand #219634722598:  Hold'em No Limit ($0.25/$0.50 USD) - 2020/10/22 16:12:46 ET
Table 'Thernoe IV' 6-max Seat #2 is the button
Seat 1: SIBISH ($52.53 in chips)
Seat 2: THEitinBEST ($157.01 in chips)
Seat 3: Lurst ($67.29 in chips)
Seat 4: Iuckyfluke ($68.23 in chips)
Seat 5: ArcticBearDK ($61.05 in chips)
Seat 6: alwerrashed ($22.67 in chips)
Lurst: posts small blind $0.25
Iuckyfluke: posts big blind $0.50
*** HOLE CARDS ***
ArcticBearDK: folds
alwerrashed: raises $0.50 to $1
SIBISH: folds
THEitinBEST: folds
Lurst: calls $0.75
Iuckyfluke: calls $0.50
*** FLOP *** [3d 8c As]
Lurst: checks
Iuckyfluke: checks
alwerrashed: bets $1.43
Lurst said, "FLUKE"
Lurst: calls $1.43
Iuckyfluke: folds
*** TURN *** [3d 8c As] [Kh]
Lurst: checks
alwerrashed: bets $2.79
Lurst: calls $2.79
*** RIVER *** [3d 8c As Kh] [7h]
Lurst: checks
alwerrashed: bets $5.44
Lurst: calls $5.44
*** SHOW DOWN ***
alwerrashed: shows [Jc Td] (high card Ace)
Lurst: shows [Ac 6c] (a pair of Aces)
Lurst collected $21.20 from pot
*** SUMMARY ***
Total pot $22.32 | Rake $1.12
Board [3d 8c As Kh 7h]
Seat 1: SIBISH folded before Flop (didn't bet)
Seat 2: THEitinBEST (button) folded before Flop (didn't bet)
Seat 3: Lurst (small blind) showed [Ac 6c] and won ($21.20) with a pair of Aces
Seat 4: Iuckyfluke (big blind) folded on the Flop
Seat 5: ArcticBearDK folded before Flop (didn't bet)
Seat 6: alwerrashed showed [Jc Td] and lost with high card Ace


PokerStars Hand #219634788755:  Hold'em No Limit ($0.25/$0.50 USD) - 2020/10/22 16:14:38 ET
Table 'Thernoe IV' 6-max Seat #4 is the button
Seat 1: SIBISH ($52.53 in chips)
Seat 2: THEitinBEST ($157.01 in chips)
Seat 3: Lurst ($77.83 in chips)
Seat 4: Iuckyfluke ($66.98 in chips)
Seat 5: ArcticBearDK ($60.55 in chips)
Seat 6: alwerrashed ($12.76 in chips)
ArcticBearDK: posts small blind $0.25
alwerrashed: posts big blind $0.50
*** HOLE CARDS ***
SIBISH: raises $0.74 to $1.24
THEitinBEST: folds
Lurst: folds
Iuckyfluke: folds
ArcticBearDK: calls $0.99
alwerrashed: folds
*** FLOP *** [4h Tc Js]
ArcticBearDK: checks
SIBISH: bets $0.89
ArcticBearDK: calls $0.89
*** TURN *** [4h Tc Js] [Ah]
ArcticBearDK: checks
SIBISH: checks
*** RIVER *** [4h Tc Js Ah] [7d]
ArcticBearDK: bets $3
SIBISH: calls $3
*** SHOW DOWN ***
ArcticBearDK: shows [Ad Qs] (a pair of Aces)
SIBISH: mucks hand
ArcticBearDK collected $10.22 from pot
*** SUMMARY ***
Total pot $10.76 | Rake $0.54
Board [4h Tc Js Ah 7d]
Seat 1: SIBISH mucked
Seat 2: THEitinBEST folded before Flop (didn't bet)
Seat 3: Lurst folded before Flop (didn't bet)
Seat 4: Iuckyfluke (button) folded before Flop (didn't bet)
Seat 5: ArcticBearDK (small blind) showed [Ad Qs] and won ($10.22) with a pair of Aces
Seat 6: alwerrashed (big blind) folded before Flop


PokerStars Hand #219634858780:  Hold'em No Limit ($0.25/$0.50 USD) - 2020/10/22 16:16:33 ET
Table 'Thernoe IV' 6-max Seat #1 is the button
Seat 1: SIBISH ($50 in chips)
Seat 2: THEitinBEST ($163.92 in chips)
Seat 3: Lurst ($77.83 in chips)
Seat 4: Iuckyfluke ($66.98 in chips)
Seat 5: ArcticBearDK ($64.54 in chips)
Seat 6: alwerrashed ($5.76 in chips)
THEitinBEST: posts small blind $0.25
Lurst: posts big blind $0.50
*** HOLE CARDS ***
Iuckyfluke is disconnected
Iuckyfluke has timed out while disconnected
Iuckyfluke: folds
ArcticBearDK: folds
alwerrashed: calls $0.50
SIBISH: folds
THEitinBEST: folds
Lurst: checks
*** FLOP *** [Qc 6d Ts]
Lurst: checks
alwerrashed: checks
*** TURN *** [Qc 6d Ts] [3h]
Lurst: checks
alwerrashed: checks
*** RIVER *** [Qc 6d Ts 3h] [7s]
Lurst: checks
alwerrashed: checks
*** SHOW DOWN ***
Lurst: shows [4c 9s] (high card Queen)
alwerrashed: shows [2s Ad] (high card Ace)
alwerrashed collected $1.19 from pot
*** SUMMARY ***
Total pot $1.25 | Rake $0.06
Board [Qc 6d Ts 3h 7s]
Seat 1: SIBISH (button) folded before Flop (didn't bet)
Seat 2: THEitinBEST (small blind) folded before Flop
Seat 3: Lurst (big blind) showed [4c 9s] and lost with high card Queen
Seat 4: Iuckyfluke folded before Flop (didn't bet)
Seat 5: ArcticBearDK folded before Flop (didn't bet)
Seat 6: alwerrashed showed [2s Ad] and won ($1.19) with high card Ace


PokerStars Hand #219635128710:  Hold'em No Limit ($0.25/$0.50 USD) - 2020/10/22 16:23:54 ET
Table 'Thernoe IV' 6-max Seat #6 is the button
Seat 1: SIBISH ($50 in chips)
Seat 2: THEitinBEST ($161.03 in chips)
Seat 3: Lurst ($72.24 in chips)
Seat 4: Iuckyfluke ($66.23 in chips)
Seat 5: ArcticBearDK ($79.65 in chips)
Seat 6: alwerrashed ($3.60 in chips)
SIBISH: posts small blind $0.25
THEitinBEST: posts big blind $0.50
*** HOLE CARDS ***
Lurst: folds
Iuckyfluke: folds
ArcticBearDK: raises $0.60 to $1.10
alwerrashed: raises $2.50 to $3.60 and is all-in
SIBISH: folds
THEitinBEST: folds
ArcticBearDK: calls $2.50
*** FLOP *** [6d 8h 4s]
*** TURN *** [6d 8h 4s] [Th]
*** RIVER *** [6d 8h 4s Th] [Ah]
*** SHOW DOWN ***
ArcticBearDK: shows [Td Ac] (two pair, Aces and Tens)
alwerrashed: shows [Jh 8d] (a pair of Eights)
ArcticBearDK collected $7.55 from pot
*** SUMMARY ***
Total pot $7.95 | Rake $0.40
Board [6d 8h 4s Th Ah]
Seat 1: SIBISH (small blind) folded before Flop
Seat 2: THEitinBEST (big blind) folded before Flop
Seat 3: Lurst folded before Flop (didn't bet)
Seat 4: Iuckyfluke folded before Flop (didn't bet)
Seat 5: ArcticBearDK showed [Td Ac] and won ($7.55) with two pair, Aces and Tens
Seat 6: alwerrashed (button) showed [Jh 8d] and lost with a pair of Eights


PokerStars Hand #219640193431:  Hold'em No Limit ($0.25/$0.50 USD) - 2020/10/22 19:08:14 ET
Table 'Thernoe IV' 6-max Seat #4 is the button
Seat 1: Princess687 ($59.44 in chips)
Seat 2: bandluchok ($50 in chips)
Seat 3: BorissKGB ($79.59 in chips)
Seat 4: vIpClubFish ($59.97 in chips)
Seat 5: yaser336 ($31.23 in chips)
yaser336: posts small blind $0.25
Princess687: posts big blind $0.50
*** HOLE CARDS ***
bandluchok: folds
BorissKGB: folds
ArcticBearDK joins the table at seat #6
vIpClubFish: folds
yaser336: calls $0.25
Princess687: checks
*** FLOP *** [9d 2c 8s]
yaser336: bets $0.50
Princess687: calls $0.50
*** TURN *** [9d 2c 8s] [9s]
yaser336: checks
Princess687: checks
*** RIVER *** [9d 2c 8s 9s] [8d]
yaser336: bets $0.50
Princess687: calls $0.50
*** SHOW DOWN ***
yaser336: shows [Kh 7c] (two pair, Nines and Eights)
Princess687: shows [Th Ac] (two pair, Nines and Eights - Ace kicker)
Princess687 collected $2.85 from pot
*** SUMMARY ***
Total pot $3 | Rake $0.15
Board [9d 2c 8s 9s 8d]
Seat 1: Princess687 (big blind) showed [Th Ac] and won ($2.85) with two pair, Nines and Eights
Seat 2: bandluchok folded before Flop (didn't bet)
Seat 3: BorissKGB folded before Flop (didn't bet)
Seat 4: vIpClubFish (button) folded before Flop (didn't bet)
Seat 5: yaser336 (small blind) showed [Kh 7c] and lost with two pair, Nines and Eights

