PokerStars Hand #208958099944:  Hold'em No Limit ($0.25/$0.50 USD) - 2020/02/07 19:15:13 ET
Table 'Aaltje III' 6-max Seat #2 is the button
Seat 1: SWING BOLOO ($36.51 in chips)
Seat 2: romixon36 ($50 in chips)
Seat 3: supersimple2018 ($52.97 in chips)
Seat 4: Flyyguyy403 ($49.52 in chips)
Seat 5: Clamfish0 ($52 in chips)
Seat 6: JuanAlmighty ($51.77 in chips)
supersimple2018: posts small blind $0.25
Flyyguyy403: posts big blind $0.50
*** HOLE CARDS ***
Clamfish0: folds
JuanAlmighty: raises $1 to $1.50
SWING BOLOO: calls $1.50
romixon36: folds
supersimple2018: raises $6 to $7.50
Flyyguyy403: folds
JuanAlmighty: calls $6
SWING BOLOO: calls $6
*** FLOP *** [5d Qd 7d]
supersimple2018: checks
JuanAlmighty: checks
SWING BOLOO: bets $4
supersimple2018: folds
JuanAlmighty: folds
Uncalled bet ($4) returned to SWING BOLOO
SWING BOLOO collected $21.85 from pot
*** SUMMARY ***
Total pot $23 | Rake $1.15
Board [5d Qd 7d]
Seat 1: SWING BOLOO collected ($21.85)
Seat 2: romixon36 (button) folded before Flop (didn't bet)
Seat 3: supersimple2018 (small blind) folded on the Flop
Seat 4: Flyyguyy403 (big blind) folded before Flop
Seat 5: Clamfish0 folded before Flop (didn't bet)
Seat 6: JuanAlmighty folded on the Flop


PokerStars Hand #208958141851:  Hold'em No Limit ($0.25/$0.50 USD) - 2020/02/07 19:16:54 ET
Table 'Aaltje III' 6-max Seat #3 is the button
Seat 1: SWING BOLOO ($50.86 in chips)
Seat 2: romixon36 ($50 in chips)
Seat 3: supersimple2018 ($50 in chips)
Seat 4: Flyyguyy403 ($49.02 in chips)
Seat 5: Clamfish0 ($52 in chips)
Seat 6: JuanAlmighty ($50 in chips)
Flyyguyy403: posts small blind $0.25
Clamfish0: posts big blind $0.50
*** HOLE CARDS ***
JuanAlmighty: raises $1.25 to $1.75
SWING BOLOO: folds
romixon36: folds
supersimple2018: raises $4.25 to $6
Flyyguyy403: folds
Clamfish0: folds
JuanAlmighty: raises $6.50 to $12.50
supersimple2018: raises $37.50 to $50 and is all-in
JuanAlmighty: calls $37.50 and is all-in
*** FLOP *** [Tc 9h 6c]
*** TURN *** [Tc 9h 6c] [7c]
*** RIVER *** [Tc 9h 6c 7c] [Jd]
*** SHOW DOWN ***
JuanAlmighty: shows [As Ah] (a pair of Aces)
supersimple2018: shows [Qs Qd] (a pair of Queens)
JuanAlmighty collected $98.75 from pot
*** SUMMARY ***
Total pot $100.75 | Rake $2
Board [Tc 9h 6c 7c Jd]
Seat 1: SWING BOLOO folded before Flop (didn't bet)
Seat 2: romixon36 folded before Flop (didn't bet)
Seat 3: supersimple2018 (button) showed [Qs Qd] and lost with a pair of Queens
Seat 4: Flyyguyy403 (small blind) folded before Flop
Seat 5: Clamfish0 (big blind) folded before Flop
Seat 6: JuanAlmighty showed [As Ah] and won ($98.75) with a pair of Aces


PokerStars Hand #208959182234:  Hold'em No Limit ($0.25/$0.50 USD) - 2020/02/07 20:01:32 ET
Table 'Bohmia IV' 6-max Seat #5 is the button
Seat 1: Straubje ($49.50 in chips)
Seat 2: Becks Baker ($50 in chips)
Seat 3: mikkas111 ($52.45 in chips)
Seat 5: G.Andrei95 ($50 in chips)
Straubje: posts small blind $0.25
Becks Baker: posts big blind $0.50
*** HOLE CARDS ***
mikkas111: folds
mikkas111 leaves the table
G.Andrei95: folds
Straubje: calls $0.25
vovvesvart joins the table at seat #3
Becks Baker: checks
*** FLOP *** [6s 3s 4h]
max21rus1988 joins the table at seat #4
Rezzonner joins the table at seat #6
Straubje: bets $1
Becks Baker: raises $2.75 to $3.75
Straubje: folds
Uncalled bet ($2.75) returned to Becks Baker
Becks Baker collected $2.85 from pot
*** SUMMARY ***
Total pot $3 | Rake $0.15
Board [6s 3s 4h]
Seat 1: Straubje (small blind) folded on the Flop
Seat 2: Becks Baker (big blind) collected ($2.85)
Seat 3: mikkas111 folded before Flop (didn't bet)
Seat 5: G.Andrei95 (button) folded before Flop (didn't bet)


PokerStars Hand #208959195974:  Hold'em No Limit ($0.25/$0.50 USD) - 2020/02/07 20:02:12 ET
Table 'Bohmia IV' 6-max Seat #1 is the button
Seat 1: Straubje ($48 in chips)
Seat 2: Becks Baker ($51.35 in chips)
Seat 3: vovvesvart ($50 in chips)
Seat 5: G.Andrei95 ($50 in chips)
Becks Baker: posts small blind $0.25
vovvesvart: posts big blind $0.50
max21rus1988: sits out
Rezzonner: sits out
*** HOLE CARDS ***
G.Andrei95: folds
Straubje: calls $0.50
Becks Baker: raises $2 to $2.50
vovvesvart: folds
Straubje: calls $2
*** FLOP *** [3s 8h 9h]
Becks Baker: checks
Straubje: bets $3
Becks Baker: folds
Uncalled bet ($3) returned to Straubje
Straubje collected $5.22 from pot
Straubje: doesn't show hand
*** SUMMARY ***
Total pot $5.50 | Rake $0.28
Board [3s 8h 9h]
Seat 1: Straubje (button) collected ($5.22)
Seat 2: Becks Baker (small blind) folded on the Flop
Seat 3: vovvesvart (big blind) folded before Flop
Seat 5: G.Andrei95 folded before Flop (didn't bet)


PokerStars Hand #208959211670:  Hold'em No Limit ($0.25/$0.50 USD) - 2020/02/07 20:02:57 ET
Table 'Bohmia IV' 6-max Seat #2 is the button
Seat 1: Straubje ($50.72 in chips)
Seat 2: Becks Baker ($50 in chips)
Seat 3: vovvesvart ($49.50 in chips)
Seat 4: max21rus1988 ($50 in chips)
Seat 5: G.Andrei95 ($50 in chips)
vovvesvart: posts small blind $0.25
max21rus1988: posts big blind $0.50
Rezzonner: sits out
*** HOLE CARDS ***
G.Andrei95: folds
Straubje: calls $0.50
Becks Baker: folds
vovvesvart: calls $0.25
max21rus1988: checks
*** FLOP *** [5h Ad Js]
vovvesvart: checks
max21rus1988: checks
Straubje: bets $1.50
vovvesvart: folds
max21rus1988: folds
Uncalled bet ($1.50) returned to Straubje
Straubje collected $1.42 from pot
Straubje: doesn't show hand
*** SUMMARY ***
Total pot $1.50 | Rake $0.08
Board [5h Ad Js]
Seat 1: Straubje collected ($1.42)
Seat 2: Becks Baker (button) folded before Flop (didn't bet)
Seat 3: vovvesvart (small blind) folded on the Flop
Seat 4: max21rus1988 (big blind) folded on the Flop
Seat 5: G.Andrei95 folded before Flop (didn't bet)


PokerStars Hand #208959234900:  Hold'em No Limit ($0.25/$0.50 USD) - 2020/02/07 20:03:41 ET
Table 'Bohmia IV' 6-max Seat #3 is the button
Seat 1: Straubje ($51.64 in chips)
Seat 2: Becks Baker ($50 in chips)
Seat 3: vovvesvart ($49 in chips)
Seat 4: max21rus1988 ($50 in chips)
Seat 6: Rezzonner ($50 in chips)
max21rus1988: posts small blind $0.25
G.Andrei95: is sitting out
Rezzonner: posts big blind $0.50
*** HOLE CARDS ***
Straubje: raises $2 to $2.50
Becks Baker: folds
vovvesvart: calls $2.50
max21rus1988: folds
Rezzonner: folds
*** FLOP *** [Jc 6d Jd]
Straubje: bets $3.50
vovvesvart: calls $3.50
*** TURN *** [Jc 6d Jd] [6h]
Straubje: bets $6
vovvesvart: folds
Uncalled bet ($6) returned to Straubje
Straubje collected $12.11 from pot
Straubje: doesn't show hand
*** SUMMARY ***
Total pot $12.75 | Rake $0.64
Board [Jc 6d Jd 6h]
Seat 1: Straubje collected ($12.11)
Seat 2: Becks Baker folded before Flop (didn't bet)
Seat 3: vovvesvart (button) folded on the Turn
Seat 4: max21rus1988 (small blind) folded before Flop
Seat 6: Rezzonner (big blind) folded before Flop


PokerStars Hand #208959260633:  Hold'em No Limit ($0.25/$0.50 USD) - 2020/02/07 20:04:54 ET
Table 'Bohmia IV' 6-max Seat #4 is the button
Seat 1: Straubje ($57.75 in chips)
Seat 2: Becks Baker ($50 in chips)
Seat 3: vovvesvart ($43 in chips)
Seat 4: max21rus1988 ($50 in chips)
Seat 6: Rezzonner ($50 in chips)
Rezzonner: posts small blind $0.25
Straubje: posts big blind $0.50
*** HOLE CARDS ***
Becks Baker: raises $0.75 to $1.25
vovvesvart: folds
max21rus1988: folds
Rezzonner: folds
Straubje: folds
Uncalled bet ($0.75) returned to Becks Baker
Becks Baker collected $1.25 from pot
*** SUMMARY ***
Total pot $1.25 | Rake $0
Seat 1: Straubje (big blind) folded before Flop
Seat 2: Becks Baker collected ($1.25)
Seat 3: vovvesvart folded before Flop (didn't bet)
Seat 4: max21rus1988 (button) folded before Flop (didn't bet)
Seat 6: Rezzonner (small blind) folded before Flop


PokerStars Hand #208959264938:  Hold'em No Limit ($0.25/$0.50 USD) - 2020/02/07 20:05:06 ET
Table 'Bohmia IV' 6-max Seat #6 is the button
Seat 1: Straubje ($57.25 in chips)
Seat 2: Becks Baker ($50.75 in chips)
Seat 3: vovvesvart ($43 in chips)
Seat 4: max21rus1988 ($50 in chips)
Seat 6: Rezzonner ($50 in chips)
Straubje: posts small blind $0.25
Becks Baker: posts big blind $0.50
G.Andrei95: sits out
*** HOLE CARDS ***
vovvesvart: raises $0.50 to $1
max21rus1988: raises $3.50 to $4.50
Rezzonner: folds
Straubje: folds
Becks Baker: folds
vovvesvart: calls $3.50
*** FLOP *** [7s Js 8h]
vovvesvart: checks
max21rus1988: bets $6.11
vovvesvart: folds
Uncalled bet ($6.11) returned to max21rus1988
max21rus1988 collected $9.26 from pot
max21rus1988: doesn't show hand
*** SUMMARY ***
Total pot $9.75 | Rake $0.49
Board [7s Js 8h]
Seat 1: Straubje (small blind) folded before Flop
Seat 2: Becks Baker (big blind) folded before Flop
Seat 3: vovvesvart folded on the Flop
Seat 4: max21rus1988 collected ($9.26)
Seat 6: Rezzonner (button) folded before Flop (didn't bet)


PokerStars Hand #208959279536:  Hold'em No Limit ($0.25/$0.50 USD) - 2020/02/07 20:05:48 ET
Table 'Bohmia IV' 6-max Seat #1 is the button
Seat 1: Straubje ($57 in chips)
Seat 2: Becks Baker ($50.25 in chips)
Seat 3: vovvesvart ($38.50 in chips)
Seat 4: max21rus1988 ($54.76 in chips)
Seat 6: Rezzonner ($50 in chips)
Becks Baker: posts small blind $0.25
vovvesvart: posts big blind $0.50
G.Andrei95: sits out
*** HOLE CARDS ***
max21rus1988: folds
Rezzonner: folds
Straubje: raises $1.50 to $2
Becks Baker: folds
vovvesvart: calls $1.50
*** FLOP *** [7d 2d 9c]
vovvesvart: checks
Straubje: bets $3
vovvesvart: calls $3
*** TURN *** [7d 2d 9c] [7h]
vovvesvart: checks
Straubje: bets $8
vovvesvart: calls $8
*** RIVER *** [7d 2d 9c 7h] [Ts]
vovvesvart: checks
Straubje: checks
*** SHOW DOWN ***
vovvesvart: shows [2h 6h] (two pair, Sevens and Deuces)
Straubje: shows [Ks 9h] (two pair, Nines and Sevens)
Straubje collected $24.94 from pot
*** SUMMARY ***
Total pot $26.25 | Rake $1.31
Board [7d 2d 9c 7h Ts]
Seat 1: Straubje (button) showed [Ks 9h] and won ($24.94) with two pair, Nines and Sevens
Seat 2: Becks Baker (small blind) folded before Flop
Seat 3: vovvesvart (big blind) showed [2h 6h] and lost with two pair, Sevens and Deuces
Seat 4: max21rus1988 folded before Flop (didn't bet)
Seat 6: Rezzonner folded before Flop (didn't bet)


PokerStars Hand #208959296629:  Hold'em No Limit ($0.25/$0.50 USD) - 2020/02/07 20:06:38 ET
Table 'Bohmia IV' 6-max Seat #2 is the button
Seat 1: Straubje ($68.94 in chips)
Seat 2: Becks Baker ($50 in chips)
Seat 3: vovvesvart ($25.50 in chips)
Seat 4: max21rus1988 ($54.76 in chips)
Seat 6: Rezzonner ($50 in chips)
vovvesvart: posts small blind $0.25
max21rus1988: posts big blind $0.50
G.Andrei95: sits out
*** HOLE CARDS ***
Rezzonner: raises $0.75 to $1.25
Straubje: raises $2.25 to $3.50
Becks Baker: folds
vovvesvart: calls $3.25
max21rus1988: folds
Rezzonner: calls $2.25
*** FLOP *** [Kh 9c Jc]
vovvesvart: bets $22 and is all-in
Rezzonner: folds
Straubje: calls $22
*** TURN *** [Kh 9c Jc] [3c]
*** RIVER *** [Kh 9c Jc 3c] [Js]
*** SHOW DOWN ***
vovvesvart: shows [4d Kc] (two pair, Kings and Jacks)
Straubje: shows [Ah Th] (a pair of Jacks)
vovvesvart collected $53 from pot
*** SUMMARY ***
Total pot $55 | Rake $2
Board [Kh 9c Jc 3c Js]
Seat 1: Straubje showed [Ah Th] and lost with a pair of Jacks
Seat 2: Becks Baker (button) folded before Flop (didn't bet)
Seat 3: vovvesvart (small blind) showed [4d Kc] and won ($53) with two pair, Kings and Jacks
Seat 4: max21rus1988 (big blind) folded before Flop
Seat 6: Rezzonner folded on the Flop


PokerStars Hand #208959311551:  Hold'em No Limit ($0.25/$0.50 USD) - 2020/02/07 20:07:20 ET
Table 'Bohmia IV' 6-max Seat #3 is the button
Seat 1: Straubje ($43.44 in chips)
Seat 2: Becks Baker ($50 in chips)
Seat 3: vovvesvart ($53 in chips)
Seat 4: max21rus1988 ($54.26 in chips)
Seat 5: G.Andrei95 ($50 in chips)
Seat 6: Rezzonner ($50 in chips)
max21rus1988: posts small blind $0.25
G.Andrei95: posts big blind $0.50
*** HOLE CARDS ***
Rezzonner: raises $0.75 to $1.25
Straubje: folds
Becks Baker: folds
vovvesvart: raises $51.75 to $53 and is all-in
max21rus1988: folds
G.Andrei95: folds
Rezzonner: folds
Uncalled bet ($51.75) returned to vovvesvart
vovvesvart collected $3.25 from pot
vovvesvart: doesn't show hand
*** SUMMARY ***
Total pot $3.25 | Rake $0
Seat 1: Straubje folded before Flop (didn't bet)
Seat 2: Becks Baker folded before Flop (didn't bet)
Seat 3: vovvesvart (button) collected ($3.25)
Seat 4: max21rus1988 (small blind) folded before Flop
Seat 5: G.Andrei95 (big blind) folded before Flop
Seat 6: Rezzonner folded before Flop


PokerStars Hand #208959319122:  Hold'em No Limit ($0.25/$0.50 USD) - 2020/02/07 20:07:42 ET
Table 'Bohmia IV' 6-max Seat #4 is the button
Seat 1: Straubje ($43.44 in chips)
Seat 2: Becks Baker ($50 in chips)
Seat 3: vovvesvart ($55 in chips)
Seat 4: max21rus1988 ($54.01 in chips)
Seat 5: G.Andrei95 ($50 in chips)
Seat 6: Rezzonner ($50 in chips)
G.Andrei95: posts small blind $0.25
Rezzonner: posts big blind $0.50
*** HOLE CARDS ***
Straubje: raises $2 to $2.50
Becks Baker: folds
vovvesvart: folds
max21rus1988: folds
G.Andrei95: folds
Rezzonner: folds
Uncalled bet ($2) returned to Straubje
Straubje collected $1.25 from pot
Straubje: doesn't show hand
*** SUMMARY ***
Total pot $1.25 | Rake $0
Seat 1: Straubje collected ($1.25)
Seat 2: Becks Baker folded before Flop (didn't bet)
Seat 3: vovvesvart folded before Flop (didn't bet)
Seat 4: max21rus1988 (button) folded before Flop (didn't bet)
Seat 5: G.Andrei95 (small blind) folded before Flop
Seat 6: Rezzonner (big blind) folded before Flop


PokerStars Hand #208959325197:  Hold'em No Limit ($0.25/$0.50 USD) - 2020/02/07 20:08:00 ET
Table 'Bohmia IV' 6-max Seat #5 is the button
Seat 1: Straubje ($44.19 in chips)
Seat 2: Becks Baker ($50 in chips)
Seat 3: vovvesvart ($55 in chips)
Seat 4: max21rus1988 ($54.01 in chips)
Seat 5: G.Andrei95 ($50 in chips)
Seat 6: Rezzonner ($50 in chips)
Rezzonner: posts small blind $0.25
Straubje: posts big blind $0.50
*** HOLE CARDS ***
Becks Baker: folds
vovvesvart: folds
max21rus1988: folds
G.Andrei95: folds
Rezzonner: raises $1 to $1.50
Straubje: calls $1
*** FLOP *** [8c 6c 5d]
Rezzonner: checks
Straubje: bets $0.50
Rezzonner: calls $0.50
*** TURN *** [8c 6c 5d] [Qh]
Rezzonner: checks
Straubje: bets $2.50
Rezzonner: calls $2.50
*** RIVER *** [8c 6c 5d Qh] [5c]
Rezzonner: checks
Straubje: bets $4
Rezzonner: folds
Uncalled bet ($4) returned to Straubje
Straubje collected $8.55 from pot
Straubje: doesn't show hand
*** SUMMARY ***
Total pot $9 | Rake $0.45
Board [8c 6c 5d Qh 5c]
Seat 1: Straubje (big blind) collected ($8.55)
Seat 2: Becks Baker folded before Flop (didn't bet)
Seat 3: vovvesvart folded before Flop (didn't bet)
Seat 4: max21rus1988 folded before Flop (didn't bet)
Seat 5: G.Andrei95 (button) folded before Flop (didn't bet)
Seat 6: Rezzonner (small blind) folded on the River


PokerStars Hand #208959345728:  Hold'em No Limit ($0.25/$0.50 USD) - 2020/02/07 20:08:59 ET
Table 'Bohmia IV' 6-max Seat #6 is the button
Seat 1: Straubje ($48.24 in chips)
Seat 2: Becks Baker ($50 in chips)
Seat 3: vovvesvart ($55 in chips)
Seat 4: max21rus1988 ($54.01 in chips)
Seat 5: G.Andrei95 ($50 in chips)
Seat 6: Rezzonner ($50 in chips)
Straubje: posts small blind $0.25
Becks Baker: posts big blind $0.50
*** HOLE CARDS ***
vovvesvart: raises $1 to $1.50
max21rus1988: folds
G.Andrei95: folds
Rezzonner: raises $2.25 to $3.75
Straubje: folds
Becks Baker: folds
vovvesvart: calls $2.25
*** FLOP *** [Qs 3s Kc]
vovvesvart: checks
Rezzonner: bets $3.82
vovvesvart: calls $3.82
*** TURN *** [Qs 3s Kc] [Ks]
vovvesvart: checks
Rezzonner: bets $11.50
vovvesvart: folds
Uncalled bet ($11.50) returned to Rezzonner
Rezzonner collected $15.10 from pot
Rezzonner: doesn't show hand
*** SUMMARY ***
Total pot $15.89 | Rake $0.79
Board [Qs 3s Kc Ks]
Seat 1: Straubje (small blind) folded before Flop
Seat 2: Becks Baker (big blind) folded before Flop
Seat 3: vovvesvart folded on the Turn
Seat 4: max21rus1988 folded before Flop (didn't bet)
Seat 5: G.Andrei95 folded before Flop (didn't bet)
Seat 6: Rezzonner (button) collected ($15.10)


PokerStars Hand #208959370883:  Hold'em No Limit ($0.25/$0.50 USD) - 2020/02/07 20:10:11 ET
Table 'Bohmia IV' 6-max Seat #1 is the button
Seat 1: Straubje ($47.99 in chips)
Seat 2: Becks Baker ($50 in chips)
Seat 3: vovvesvart ($47.43 in chips)
Seat 4: max21rus1988 ($54.01 in chips)
Seat 5: G.Andrei95 ($50 in chips)
Seat 6: Rezzonner ($57.53 in chips)
Becks Baker: posts small blind $0.25
vovvesvart: posts big blind $0.50
*** HOLE CARDS ***
max21rus1988: folds
G.Andrei95: raises $0.75 to $1.25
Rezzonner: folds
Straubje: calls $1.25
Becks Baker: folds
vovvesvart: calls $0.75
*** FLOP *** [8d 4c Kd]
vovvesvart: checks
G.Andrei95: checks
Straubje: checks
*** TURN *** [8d 4c Kd] [5h]
vovvesvart: bets $1.90
G.Andrei95: folds
Straubje: raises $1.90 to $3.80
vovvesvart: raises $42.38 to $46.18 and is all-in
Straubje: folds
Uncalled bet ($42.38) returned to vovvesvart
vovvesvart collected $11.02 from pot
vovvesvart: doesn't show hand
*** SUMMARY ***
Total pot $11.60 | Rake $0.58
Board [8d 4c Kd 5h]
Seat 1: Straubje (button) folded on the Turn
Seat 2: Becks Baker (small blind) folded before Flop
Seat 3: vovvesvart (big blind) collected ($11.02)
Seat 4: max21rus1988 folded before Flop (didn't bet)
Seat 5: G.Andrei95 folded on the Turn
Seat 6: Rezzonner folded before Flop (didn't bet)


PokerStars Hand #208959429446:  Hold'em No Limit ($0.25/$0.50 USD) - 2020/02/07 20:12:46 ET
Table 'Bohmia IV' 6-max Seat #3 is the button
Seat 1: Straubje ($34.97 in chips)
Seat 2: Becks Baker ($50 in chips)
Seat 3: vovvesvart ($50.43 in chips)
Seat 4: max21rus1988 ($53.51 in chips)
Seat 5: G.Andrei95 ($61.66 in chips)
Seat 6: Rezzonner ($57.53 in chips)
max21rus1988: posts small blind $0.25
G.Andrei95: posts big blind $0.50
*** HOLE CARDS ***
Rezzonner: raises $0.75 to $1.25
Straubje: folds
Becks Baker: folds
vovvesvart: calls $1.25
max21rus1988: folds
G.Andrei95: calls $0.75
*** FLOP *** [3c 2d 6h]
G.Andrei95: checks
Rezzonner: checks
vovvesvart: bets $1.90
G.Andrei95: calls $1.90
Rezzonner: folds
*** TURN *** [3c 2d 6h] [9s]
G.Andrei95: checks
vovvesvart: bets $7.41
G.Andrei95: folds
Uncalled bet ($7.41) returned to vovvesvart
vovvesvart collected $7.41 from pot
vovvesvart: doesn't show hand
*** SUMMARY ***
Total pot $7.80 | Rake $0.39
Board [3c 2d 6h 9s]
Seat 1: Straubje folded before Flop (didn't bet)
Seat 2: Becks Baker folded before Flop (didn't bet)
Seat 3: vovvesvart (button) collected ($7.41)
Seat 4: max21rus1988 (small blind) folded before Flop
Seat 5: G.Andrei95 (big blind) folded on the Turn
Seat 6: Rezzonner folded on the Flop


PokerStars Hand #208959397747:  Hold'em No Limit ($0.25/$0.50 USD) - 2020/02/07 20:11:29 ET
Table 'Bohmia IV' 6-max Seat #2 is the button
Seat 1: Straubje ($42.94 in chips)
Seat 2: Becks Baker ($50 in chips)
Seat 3: vovvesvart ($53.40 in chips)
Seat 4: max21rus1988 ($54.01 in chips)
Seat 5: G.Andrei95 ($50 in chips)
Seat 6: Rezzonner ($57.53 in chips)
vovvesvart: posts small blind $0.25
max21rus1988: posts big blind $0.50
*** HOLE CARDS ***
G.Andrei95: raises $0.75 to $1.25
Rezzonner: folds
Straubje: calls $1.25
Becks Baker: calls $1.25
vovvesvart: calls $1
max21rus1988: folds
*** FLOP *** [8h Kc Ts]
vovvesvart: checks
G.Andrei95: bets $1.72
Straubje: calls $1.72
Becks Baker: folds
vovvesvart: calls $1.72
*** TURN *** [8h Kc Ts] [9s]
vovvesvart: checks
G.Andrei95: checks
Straubje: bets $5
vovvesvart: folds
G.Andrei95: calls $5
*** RIVER *** [8h Kc Ts 9s] [Qd]
G.Andrei95: checks
Straubje: checks
*** SHOW DOWN ***
G.Andrei95: shows [Kh Ac] (a pair of Kings)
Straubje: mucks hand
G.Andrei95 collected $19.63 from pot
*** SUMMARY ***
Total pot $20.66 | Rake $1.03
Board [8h Kc Ts 9s Qd]
Seat 1: Straubje mucked
Seat 2: Becks Baker (button) folded on the Flop
Seat 3: vovvesvart (small blind) folded on the Turn
Seat 4: max21rus1988 (big blind) folded before Flop
Seat 5: G.Andrei95 showed [Kh Ac] and won ($19.63) with a pair of Kings
Seat 6: Rezzonner folded before Flop (didn't bet)


PokerStars Hand #208959447432:  Hold'em No Limit ($0.25/$0.50 USD) - 2020/02/07 20:13:38 ET
Table 'Bohmia IV' 6-max Seat #4 is the button
Seat 1: Straubje ($48.73 in chips)
Seat 2: Becks Baker ($50 in chips)
Seat 3: vovvesvart ($54.69 in chips)
Seat 4: max21rus1988 ($53.26 in chips)
Seat 5: G.Andrei95 ($58.51 in chips)
Seat 6: Rezzonner ($56.28 in chips)
G.Andrei95: posts small blind $0.25
Rezzonner: posts big blind $0.50
*** HOLE CARDS ***
Straubje: folds
Becks Baker: folds
vovvesvart: raises $1 to $1.50
max21rus1988: folds
G.Andrei95: folds
Rezzonner: folds
Uncalled bet ($1) returned to vovvesvart
vovvesvart collected $1.25 from pot
vovvesvart: doesn't show hand
*** SUMMARY ***
Total pot $1.25 | Rake $0
Seat 1: Straubje folded before Flop (didn't bet)
Seat 2: Becks Baker folded before Flop (didn't bet)
Seat 3: vovvesvart collected ($1.25)
Seat 4: max21rus1988 (button) folded before Flop (didn't bet)
Seat 5: G.Andrei95 (small blind) folded before Flop
Seat 6: Rezzonner (big blind) folded before Flop


PokerStars Hand #208959452357:  Hold'em No Limit ($0.25/$0.50 USD) - 2020/02/07 20:13:53 ET
Table 'Bohmia IV' 6-max Seat #5 is the button
Seat 1: Straubje ($48.73 in chips)
Seat 2: Becks Baker ($50 in chips)
Seat 3: vovvesvart ($55.44 in chips)
Seat 4: max21rus1988 ($53.26 in chips)
Seat 5: G.Andrei95 ($58.26 in chips)
Seat 6: Rezzonner ($55.78 in chips)
Rezzonner: posts small blind $0.25
Straubje: posts big blind $0.50
*** HOLE CARDS ***
Becks Baker: folds
vovvesvart: raises $0.50 to $1
max21rus1988: folds
G.Andrei95: folds
Rezzonner: folds
Straubje: calls $0.50
*** FLOP *** [3h Qd 2h]
Straubje: checks
vovvesvart: bets $1.07
Straubje has timed out
Straubje: folds
Uncalled bet ($1.07) returned to vovvesvart
vovvesvart collected $2.14 from pot
vovvesvart: doesn't show hand
*** SUMMARY ***
Total pot $2.25 | Rake $0.11
Board [3h Qd 2h]
Seat 1: Straubje (big blind) folded on the Flop
Seat 2: Becks Baker folded before Flop (didn't bet)
Seat 3: vovvesvart collected ($2.14)
Seat 4: max21rus1988 folded before Flop (didn't bet)
Seat 5: G.Andrei95 (button) folded before Flop (didn't bet)
Seat 6: Rezzonner (small blind) folded before Flop


PokerStars Hand #208959475341:  Hold'em No Limit ($0.25/$0.50 USD) - 2020/02/07 20:15:01 ET
Table 'Bohmia IV' 6-max Seat #6 is the button
Seat 2: Becks Baker ($50 in chips)
Seat 3: vovvesvart ($56.58 in chips)
Seat 4: max21rus1988 ($53.26 in chips)
Seat 5: G.Andrei95 ($58.26 in chips)
Seat 6: Rezzonner ($55.53 in chips)
Becks Baker: posts small blind $0.25
vovvesvart: posts big blind $0.50
*** HOLE CARDS ***
max21rus1988: folds
G.Andrei95: raises $0.75 to $1.25
Rezzonner: raises $2.75 to $4
Becks Baker: folds
vovvesvart: calls $3.50
G.Andrei95: calls $2.75
*** FLOP *** [7c 3d Tc]
vovvesvart: checks
G.Andrei95: checks
Rezzonner: bets $7.68
vovvesvart: calls $7.68
G.Andrei95: folds
*** TURN *** [7c 3d Tc] [Ah]
vovvesvart: checks
Rezzonner: checks
*** RIVER *** [7c 3d Tc Ah] [7s]
vovvesvart: checks
Rezzonner: checks
*** SHOW DOWN ***
vovvesvart: shows [3h 5c] (two pair, Sevens and Threes)
Rezzonner: mucks hand
vovvesvart collected $26.23 from pot
*** SUMMARY ***
Total pot $27.61 | Rake $1.38
Board [7c 3d Tc Ah 7s]
Seat 2: Becks Baker (small blind) folded before Flop
Seat 3: vovvesvart (big blind) showed [3h 5c] and won ($26.23) with two pair, Sevens and Threes
Seat 4: max21rus1988 folded before Flop (didn't bet)
Seat 5: G.Andrei95 folded on the Flop
Seat 6: Rezzonner (button) mucked


PokerStars Hand #208959498461:  Hold'em No Limit ($0.25/$0.50 USD) - 2020/02/07 20:16:09 ET
Table 'Bohmia IV' 6-max Seat #2 is the button
Seat 1: Straubje ($47.73 in chips)
Seat 2: Becks Baker ($50 in chips)
Seat 3: vovvesvart ($71.13 in chips)
Seat 4: max21rus1988 ($53.26 in chips)
Seat 5: G.Andrei95 ($54.26 in chips)
Seat 6: Rezzonner ($50 in chips)
vovvesvart: posts small blind $0.25
max21rus1988: posts big blind $0.50
Straubje: posts small blind $0.25
*** HOLE CARDS ***
G.Andrei95: folds
Rezzonner: folds
Straubje: calls $0.50
Becks Baker: folds
vovvesvart: raises $0.50 to $1
max21rus1988: raises $4 to $5
Straubje: calls $4.50
vovvesvart: folds
*** FLOP *** [4c Kc 7h]
max21rus1988: bets $7.06
Straubje: raises $10.06 to $17.12
max21rus1988: raises $31.14 to $48.26 and is all-in
Straubje: calls $25.36 and is all-in
Uncalled bet ($5.78) returned to max21rus1988
*** TURN *** [4c Kc 7h] [6c]
*** RIVER *** [4c Kc 7h 6c] [Td]
*** SHOW DOWN ***
max21rus1988: shows [As Kd] (a pair of Kings)
Straubje: shows [Tc 7d] (two pair, Tens and Sevens)
Straubje cashed out the hand for $20.53 | Cash Out Fee $0.21
*** SUMMARY ***
Total pot $96.21 | Rake $2
Board [4c Kc 7h 6c Td]
Seat 1: Straubje showed [Tc 7d] and won ($94.21) with two pair, Tens and Sevens (pot not awarded as player cashed out)
Seat 2: Becks Baker (button) folded before Flop (didn't bet)
Seat 3: vovvesvart (small blind) folded before Flop
Seat 4: max21rus1988 (big blind) showed [As Kd] and lost with a pair of Kings
Seat 5: G.Andrei95 folded before Flop (didn't bet)
Seat 6: Rezzonner folded before Flop (didn't bet)


PokerStars Hand #208959521680:  Hold'em No Limit ($0.25/$0.50 USD) - 2020/02/07 20:17:19 ET
Table 'Bohmia IV' 6-max Seat #3 is the button
Seat 1: Straubje ($20.53 in chips)
Seat 2: Becks Baker ($50 in chips)
Seat 3: vovvesvart ($70.13 in chips)
Seat 4: max21rus1988 ($50 in chips)
Seat 5: G.Andrei95 ($54.26 in chips)
Seat 6: Rezzonner ($50 in chips)
max21rus1988: posts small blind $0.25
G.Andrei95: posts big blind $0.50
*** HOLE CARDS ***
Rezzonner: raises $0.75 to $1.25
Straubje: calls $1.25
Becks Baker: folds
vovvesvart: calls $1.25
max21rus1988 said, "nice cash out bro))"
max21rus1988: folds
G.Andrei95: folds
*** FLOP *** [6c 9s 6s]
Rezzonner: checks
Straubje: checks
vovvesvart: checks
*** TURN *** [6c 9s 6s] [4d]
Rezzonner: checks
Straubje: checks
vovvesvart: bets $2.14
Rezzonner: folds
Straubje has timed out
Straubje: folds
Uncalled bet ($2.14) returned to vovvesvart
vovvesvart collected $4.28 from pot
vovvesvart: doesn't show hand
*** SUMMARY ***
Total pot $4.50 | Rake $0.22
Board [6c 9s 6s 4d]
Seat 1: Straubje folded on the Turn
Seat 2: Becks Baker folded before Flop (didn't bet)
Seat 3: vovvesvart (button) collected ($4.28)
Seat 4: max21rus1988 (small blind) folded before Flop
Seat 5: G.Andrei95 (big blind) folded before Flop
Seat 6: Rezzonner folded on the Turn


PokerStars Hand #208959557239:  Hold'em No Limit ($0.25/$0.50 USD) - 2020/02/07 20:18:39 ET
Table 'Bohmia IV' 6-max Seat #4 is the button
Seat 2: Becks Baker ($50 in chips)
Seat 3: vovvesvart ($73.16 in chips)
Seat 4: max21rus1988 ($50 in chips)
Seat 5: G.Andrei95 ($53.76 in chips)
Seat 6: Rezzonner ($50 in chips)
G.Andrei95: posts small blind $0.25
Rezzonner: posts big blind $0.50
*** HOLE CARDS ***
Becks Baker: raises $0.75 to $1.25
vovvesvart: calls $1.25
max21rus1988: folds
G.Andrei95: folds
Rezzonner: folds
*** FLOP *** [8h 9c 5h]
Becks Baker: checks
vovvesvart: bets $3.09
Becks Baker: folds
Uncalled bet ($3.09) returned to vovvesvart
vovvesvart collected $3.09 from pot
vovvesvart: doesn't show hand
*** SUMMARY ***
Total pot $3.25 | Rake $0.16
Board [8h 9c 5h]
Seat 2: Becks Baker folded on the Flop
Seat 3: vovvesvart collected ($3.09)
Seat 4: max21rus1988 (button) folded before Flop (didn't bet)
Seat 5: G.Andrei95 (small blind) folded before Flop
Seat 6: Rezzonner (big blind) folded before Flop


PokerStars Hand #208959567955:  Hold'em No Limit ($0.25/$0.50 USD) - 2020/02/07 20:19:11 ET
Table 'Bohmia IV' 6-max Seat #5 is the button
Seat 1: Straubje ($50 in chips)
Seat 2: Becks Baker ($50 in chips)
Seat 3: vovvesvart ($75 in chips)
Seat 4: max21rus1988 ($50 in chips)
Seat 5: G.Andrei95 ($53.51 in chips)
Seat 6: Rezzonner ($50 in chips)
Rezzonner: posts small blind $0.25
Straubje: posts big blind $0.50
*** HOLE CARDS ***
Becks Baker: folds
vovvesvart: raises $1 to $1.50
max21rus1988: folds
G.Andrei95: calls $1.50
Rezzonner: folds
Straubje: calls $1
*** FLOP *** [Ac Th Ts]
Straubje: checks
vovvesvart: bets $0.50
G.Andrei95: folds
Straubje: calls $0.50
*** TURN *** [Ac Th Ts] [3h]
Straubje: checks
vovvesvart: checks
*** RIVER *** [Ac Th Ts 3h] [Jh]
Straubje: checks
vovvesvart: checks
*** SHOW DOWN ***
Straubje: shows [2d 6h] (a pair of Tens)
vovvesvart: shows [9d Jd] (two pair, Jacks and Tens)
vovvesvart collected $5.46 from pot
*** SUMMARY ***
Total pot $5.75 | Rake $0.29
Board [Ac Th Ts 3h Jh]
Seat 1: Straubje (big blind) showed [2d 6h] and lost with a pair of Tens
Seat 2: Becks Baker folded before Flop (didn't bet)
Seat 3: vovvesvart showed [9d Jd] and won ($5.46) with two pair, Jacks and Tens
Seat 4: max21rus1988 folded before Flop (didn't bet)
Seat 5: G.Andrei95 (button) folded on the Flop
Seat 6: Rezzonner (small blind) folded before Flop


PokerStars Hand #208959589426:  Hold'em No Limit ($0.25/$0.50 USD) - 2020/02/07 20:20:16 ET
Table 'Bohmia IV' 6-max Seat #6 is the button
Seat 1: Straubje ($48 in chips)
Seat 2: Becks Baker ($50 in chips)
Seat 3: vovvesvart ($78.46 in chips)
Seat 4: max21rus1988 ($50 in chips)
Seat 5: G.Andrei95 ($52.01 in chips)
Seat 6: Rezzonner ($50 in chips)
Straubje: posts small blind $0.25
Becks Baker: posts big blind $0.50
*** HOLE CARDS ***
vovvesvart: raises $0.50 to $1
max21rus1988: folds
G.Andrei95: folds
Rezzonner: folds
Straubje: calls $0.75
Becks Baker: folds
*** FLOP *** [Ks Kc Jd]
Straubje: bets $1.50
vovvesvart: calls $1.50
*** TURN *** [Ks Kc Jd] [Kd]
Straubje: checks
vovvesvart: checks
*** RIVER *** [Ks Kc Jd Kd] [8s]
Straubje: checks
vovvesvart: checks
*** SHOW DOWN ***
Straubje: shows [Qh 4h] (three of a kind, Kings)
vovvesvart: shows [6d 6c] (a full house, Kings full of Sixes)
vovvesvart collected $5.22 from pot
*** SUMMARY ***
Total pot $5.50 | Rake $0.28
Board [Ks Kc Jd Kd 8s]
Seat 1: Straubje (small blind) showed [Qh 4h] and lost with three of a kind, Kings
Seat 2: Becks Baker (big blind) folded before Flop
Seat 3: vovvesvart showed [6d 6c] and won ($5.22) with a full house, Kings full of Sixes
Seat 4: max21rus1988 folded before Flop (didn't bet)
Seat 5: G.Andrei95 folded before Flop (didn't bet)
Seat 6: Rezzonner (button) folded before Flop (didn't bet)


PokerStars Hand #208959604043:  Hold'em No Limit ($0.25/$0.50 USD) - 2020/02/07 20:21:00 ET
Table 'Bohmia IV' 6-max Seat #1 is the button
Seat 1: Straubje ($45.50 in chips)
Seat 2: Becks Baker ($50 in chips)
Seat 3: vovvesvart ($81.18 in chips)
Seat 4: max21rus1988 ($50 in chips)
Seat 5: G.Andrei95 ($52.01 in chips)
Seat 6: Rezzonner ($50 in chips)
Becks Baker: posts small blind $0.25
vovvesvart: posts big blind $0.50
*** HOLE CARDS ***
max21rus1988: folds
G.Andrei95: folds
Rezzonner: folds
Straubje: calls $0.50
Becks Baker: folds
vovvesvart: checks
*** FLOP *** [Kd 7c 3h]
vovvesvart: checks
Straubje: bets $1
vovvesvart: folds
Uncalled bet ($1) returned to Straubje
Straubje collected $1.19 from pot
Straubje: doesn't show hand
*** SUMMARY ***
Total pot $1.25 | Rake $0.06
Board [Kd 7c 3h]
Seat 1: Straubje (button) collected ($1.19)
Seat 2: Becks Baker (small blind) folded before Flop
Seat 3: vovvesvart (big blind) folded on the Flop
Seat 4: max21rus1988 folded before Flop (didn't bet)
Seat 5: G.Andrei95 folded before Flop (didn't bet)
Seat 6: Rezzonner folded before Flop (didn't bet)


PokerStars Hand #208959614485:  Hold'em No Limit ($0.25/$0.50 USD) - 2020/02/07 20:21:31 ET
Table 'Bohmia IV' 6-max Seat #2 is the button
Seat 1: Straubje ($46.19 in chips)
Seat 2: Becks Baker ($50 in chips)
Seat 3: vovvesvart ($80.68 in chips)
Seat 4: max21rus1988 ($50 in chips)
Seat 5: G.Andrei95 ($52.01 in chips)
Seat 6: Rezzonner ($50 in chips)
vovvesvart: posts small blind $0.25
max21rus1988: posts big blind $0.50
*** HOLE CARDS ***
G.Andrei95: folds
Rezzonner: folds
Straubje: calls $0.50
Becks Baker: folds
vovvesvart: calls $0.25
max21rus1988: checks
*** FLOP *** [2c 5s 9h]
vovvesvart: checks
max21rus1988: checks
Straubje: bets $1.50
vovvesvart: folds
max21rus1988: folds
Uncalled bet ($1.50) returned to Straubje
Straubje collected $1.42 from pot
Straubje: doesn't show hand
*** SUMMARY ***
Total pot $1.50 | Rake $0.08
Board [2c 5s 9h]
Seat 1: Straubje collected ($1.42)
Seat 2: Becks Baker (button) folded before Flop (didn't bet)
Seat 3: vovvesvart (small blind) folded on the Flop
Seat 4: max21rus1988 (big blind) folded on the Flop
Seat 5: G.Andrei95 folded before Flop (didn't bet)
Seat 6: Rezzonner folded before Flop (didn't bet)


PokerStars Hand #208959660391:  Hold'em No Limit ($0.25/$0.50 USD) - 2020/02/07 20:23:51 ET
Table 'Bohmia IV' 6-max Seat #4 is the button
Seat 1: Straubje ($45.61 in chips)
Seat 2: Becks Baker ($54.44 in chips)
Seat 3: vovvesvart ($78.68 in chips)
Seat 4: max21rus1988 ($50 in chips)
Seat 5: G.Andrei95 ($50.51 in chips)
Seat 6: Rezzonner ($50 in chips)
G.Andrei95: posts small blind $0.25
Rezzonner: posts big blind $0.50
*** HOLE CARDS ***
Straubje: folds
Becks Baker: folds
vovvesvart: raises $0.50 to $1
max21rus1988: folds
G.Andrei95: folds
Rezzonner: calls $0.50
*** FLOP *** [3h Kh 2c]
Rezzonner: checks
vovvesvart: checks
*** TURN *** [3h Kh 2c] [6h]
Rezzonner: checks
vovvesvart: bets $1.07
Rezzonner: calls $1.07
*** RIVER *** [3h Kh 2c 6h] [5h]
Rezzonner: checks
vovvesvart: checks
*** SHOW DOWN ***
Rezzonner: shows [Th Ad] (a flush, King high)
vovvesvart: mucks hand
Rezzonner collected $4.17 from pot
*** SUMMARY ***
Total pot $4.39 | Rake $0.22
Board [3h Kh 2c 6h 5h]
Seat 1: Straubje folded before Flop (didn't bet)
Seat 2: Becks Baker folded before Flop (didn't bet)
Seat 3: vovvesvart mucked
Seat 4: max21rus1988 (button) folded before Flop (didn't bet)
Seat 5: G.Andrei95 (small blind) folded before Flop
Seat 6: Rezzonner (big blind) showed [Th Ad] and won ($4.17) with a flush, King high


PokerStars Hand #208959630222:  Hold'em No Limit ($0.25/$0.50 USD) - 2020/02/07 20:22:19 ET
Table 'Bohmia IV' 6-max Seat #3 is the button
Seat 1: Straubje ($47.11 in chips)
Seat 2: Becks Baker ($50 in chips)
Seat 3: vovvesvart ($80.18 in chips)
Seat 4: max21rus1988 ($50 in chips)
Seat 5: G.Andrei95 ($52.01 in chips)
Seat 6: Rezzonner ($50 in chips)
max21rus1988: posts small blind $0.25
G.Andrei95: posts big blind $0.50
*** HOLE CARDS ***
Rezzonner: folds
Straubje: calls $0.50
Becks Baker: raises $1 to $1.50
vovvesvart: calls $1.50
max21rus1988: folds
G.Andrei95: calls $1
Straubje: calls $1
*** FLOP *** [9d 4h 8h]
G.Andrei95: checks
Straubje: checks
Becks Baker: checks
vovvesvart: checks
*** TURN *** [9d 4h 8h] [2h]
G.Andrei95: checks
Straubje: checks
Becks Baker: bets $3.86
vovvesvart: folds
G.Andrei95: folds
Straubje: folds
Uncalled bet ($3.86) returned to Becks Baker
Becks Baker collected $5.94 from pot
*** SUMMARY ***
Total pot $6.25 | Rake $0.31
Board [9d 4h 8h 2h]
Seat 1: Straubje folded on the Turn
Seat 2: Becks Baker collected ($5.94)
Seat 3: vovvesvart (button) folded on the Turn
Seat 4: max21rus1988 (small blind) folded before Flop
Seat 5: G.Andrei95 (big blind) folded on the Turn
Seat 6: Rezzonner folded before Flop (didn't bet)


PokerStars Hand #208959675961:  Hold'em No Limit ($0.25/$0.50 USD) - 2020/02/07 20:24:38 ET
Table 'Bohmia IV' 6-max Seat #5 is the button
Seat 1: Straubje ($45.61 in chips)
Seat 2: Becks Baker ($54.44 in chips)
Seat 3: vovvesvart ($76.61 in chips)
Seat 4: max21rus1988 ($50 in chips)
Seat 5: G.Andrei95 ($50.26 in chips)
Seat 6: Rezzonner ($52.10 in chips)
Rezzonner: posts small blind $0.25
Straubje: posts big blind $0.50
*** HOLE CARDS ***
Becks Baker: raises $0.75 to $1.25
vovvesvart has timed out
vovvesvart: folds
max21rus1988: folds
G.Andrei95: folds
Rezzonner: folds
Straubje: raises $1.75 to $3
Becks Baker: folds
Uncalled bet ($1.75) returned to Straubje
Straubje collected $2.75 from pot
Straubje: doesn't show hand
*** SUMMARY ***
Total pot $2.75 | Rake $0
Seat 1: Straubje (big blind) collected ($2.75)
Seat 2: Becks Baker folded before Flop
Seat 3: vovvesvart folded before Flop (didn't bet)
Seat 4: max21rus1988 folded before Flop (didn't bet)
Seat 5: G.Andrei95 (button) folded before Flop (didn't bet)
Seat 6: Rezzonner (small blind) folded before Flop


PokerStars Hand #208959688936:  Hold'em No Limit ($0.25/$0.50 USD) - 2020/02/07 20:25:17 ET
Table 'Bohmia IV' 6-max Seat #6 is the button
Seat 1: Straubje ($47.11 in chips)
Seat 2: Becks Baker ($53.19 in chips)
Seat 3: vovvesvart ($76.61 in chips)
Seat 4: max21rus1988 ($50 in chips)
Seat 5: G.Andrei95 ($50.26 in chips)
Seat 6: Rezzonner ($51.85 in chips)
Straubje: posts small blind $0.25
Becks Baker: posts big blind $0.50
*** HOLE CARDS ***
vovvesvart: raises $0.50 to $1
max21rus1988: folds
G.Andrei95: folds
Rezzonner: folds
Straubje: calls $0.75
Becks Baker: calls $0.50
*** FLOP *** [3d 6d 7h]
Straubje: checks
Becks Baker: checks
vovvesvart: checks
*** TURN *** [3d 6d 7h] [8c]
Straubje: bets $1.50
Becks Baker: folds
vovvesvart: calls $1.50
*** RIVER *** [3d 6d 7h 8c] [5d]
Straubje: bets $3
vovvesvart: raises $3 to $6
Straubje: calls $3
*** SHOW DOWN ***
vovvesvart: shows [9h Jc] (a straight, Five to Nine)
Straubje: mucks hand
vovvesvart collected $17.10 from pot
*** SUMMARY ***
Total pot $18 | Rake $0.90
Board [3d 6d 7h 8c 5d]
Seat 1: Straubje (small blind) mucked
Seat 2: Becks Baker (big blind) folded on the Turn
Seat 3: vovvesvart showed [9h Jc] and won ($17.10) with a straight, Five to Nine
Seat 4: max21rus1988 folded before Flop (didn't bet)
Seat 5: G.Andrei95 folded before Flop (didn't bet)
Seat 6: Rezzonner (button) folded before Flop (didn't bet)


PokerStars Hand #208959708268:  Hold'em No Limit ($0.25/$0.50 USD) - 2020/02/07 20:26:16 ET
Table 'Bohmia IV' 6-max Seat #1 is the button
Seat 1: Straubje ($38.61 in chips)
Seat 2: Becks Baker ($52.19 in chips)
Seat 3: vovvesvart ($85.21 in chips)
Seat 4: max21rus1988 ($50 in chips)
Seat 5: G.Andrei95 ($50.26 in chips)
Seat 6: Rezzonner ($51.85 in chips)
Becks Baker: posts small blind $0.25
vovvesvart: posts big blind $0.50
*** HOLE CARDS ***
max21rus1988: folds
G.Andrei95: folds
Rezzonner: raises $0.75 to $1.25
Straubje: calls $1.25
Becks Baker: calls $1
vovvesvart: calls $0.75
*** FLOP *** [Qd 2h Jc]
Becks Baker: checks
vovvesvart: checks
Rezzonner: bets $3.14
Straubje: folds
Becks Baker: folds
vovvesvart: folds
Uncalled bet ($3.14) returned to Rezzonner
Rezzonner collected $4.75 from pot
Rezzonner: doesn't show hand
*** SUMMARY ***
Total pot $5 | Rake $0.25
Board [Qd 2h Jc]
Seat 1: Straubje (button) folded on the Flop
Seat 2: Becks Baker (small blind) folded on the Flop
Seat 3: vovvesvart (big blind) folded on the Flop
Seat 4: max21rus1988 folded before Flop (didn't bet)
Seat 5: G.Andrei95 folded before Flop (didn't bet)
Seat 6: Rezzonner collected ($4.75)


PokerStars Hand #208959723761:  Hold'em No Limit ($0.25/$0.50 USD) - 2020/02/07 20:27:03 ET
Table 'Bohmia IV' 6-max Seat #2 is the button
Seat 1: Straubje ($48.75 in chips)
Seat 2: Becks Baker ($50.94 in chips)
Seat 3: vovvesvart ($83.96 in chips)
Seat 4: max21rus1988 ($50 in chips)
Seat 5: G.Andrei95 ($50.26 in chips)
Seat 6: Rezzonner ($55.35 in chips)
vovvesvart: posts small blind $0.25
max21rus1988: posts big blind $0.50
*** HOLE CARDS ***
G.Andrei95: folds
Rezzonner: folds
Straubje: folds
Becks Baker: raises $0.75 to $1.25
vovvesvart: calls $1
max21rus1988: folds
*** FLOP *** [9s Ts 6d]
vovvesvart: checks
Becks Baker: bets $1.85
vovvesvart: calls $1.85
*** TURN *** [9s Ts 6d] [As]
vovvesvart: checks
Becks Baker: bets $6.36
vovvesvart: folds
Uncalled bet ($6.36) returned to Becks Baker
Becks Baker collected $6.36 from pot
*** SUMMARY ***
Total pot $6.70 | Rake $0.34
Board [9s Ts 6d As]
Seat 1: Straubje folded before Flop (didn't bet)
Seat 2: Becks Baker (button) collected ($6.36)
Seat 3: vovvesvart (small blind) folded on the Turn
Seat 4: max21rus1988 (big blind) folded before Flop
Seat 5: G.Andrei95 folded before Flop (didn't bet)
Seat 6: Rezzonner folded before Flop (didn't bet)


PokerStars Hand #208959746722:  Hold'em No Limit ($0.25/$0.50 USD) - 2020/02/07 20:28:13 ET
Table 'Bohmia IV' 6-max Seat #3 is the button
Seat 1: Straubje ($48.75 in chips)
Seat 2: Becks Baker ($54.20 in chips)
Seat 3: vovvesvart ($80.86 in chips)
Seat 4: max21rus1988 ($50 in chips)
Seat 5: G.Andrei95 ($50.26 in chips)
Seat 6: Rezzonner ($55.35 in chips)
max21rus1988: posts small blind $0.25
G.Andrei95: posts big blind $0.50
*** HOLE CARDS ***
Rezzonner: folds
Straubje has timed out
Straubje: folds
Becks Baker: folds
vovvesvart has timed out
vovvesvart: folds
max21rus1988: raises $0.75 to $1.25
G.Andrei95: folds
Uncalled bet ($0.75) returned to max21rus1988
max21rus1988 collected $1 from pot
max21rus1988: doesn't show hand
*** SUMMARY ***
Total pot $1 | Rake $0
Seat 1: Straubje folded before Flop (didn't bet)
Seat 2: Becks Baker folded before Flop (didn't bet)
Seat 3: vovvesvart (button) folded before Flop (didn't bet)
Seat 4: max21rus1988 (small blind) collected ($1)
Seat 5: G.Andrei95 (big blind) folded before Flop
Seat 6: Rezzonner folded before Flop (didn't bet)


PokerStars Hand #208959759830:  Hold'em No Limit ($0.25/$0.50 USD) - 2020/02/07 20:28:44 ET
Table 'Bohmia IV' 6-max Seat #4 is the button
Seat 1: Straubje ($48.75 in chips)
Seat 2: Becks Baker ($54.20 in chips)
Seat 3: vovvesvart ($80.86 in chips)
Seat 4: max21rus1988 ($50.50 in chips)
Seat 5: G.Andrei95 ($50 in chips)
Seat 6: Rezzonner ($55.35 in chips)
G.Andrei95: posts small blind $0.25
Rezzonner: posts big blind $0.50
*** HOLE CARDS ***
Straubje: folds
Becks Baker: folds
vovvesvart: raises $0.50 to $1
max21rus1988: folds
G.Andrei95: raises $3.50 to $4.50
Rezzonner: raises $6.75 to $11.25
vovvesvart: folds
G.Andrei95: folds
Uncalled bet ($6.75) returned to Rezzonner
Rezzonner collected $10 from pot
Rezzonner: doesn't show hand
*** SUMMARY ***
Total pot $10 | Rake $0
Seat 1: Straubje folded before Flop (didn't bet)
Seat 2: Becks Baker folded before Flop (didn't bet)
Seat 3: vovvesvart folded before Flop
Seat 4: max21rus1988 (button) folded before Flop (didn't bet)
Seat 5: G.Andrei95 (small blind) folded before Flop
Seat 6: Rezzonner (big blind) collected ($10)


PokerStars Hand #208959770696:  Hold'em No Limit ($0.25/$0.50 USD) - 2020/02/07 20:29:18 ET
Table 'Bohmia IV' 6-max Seat #5 is the button
Seat 1: Straubje ($48.75 in chips)
Seat 2: Becks Baker ($54.20 in chips)
Seat 3: vovvesvart ($79.86 in chips)
Seat 4: max21rus1988 ($50.50 in chips)
Seat 5: G.Andrei95 ($50 in chips)
Seat 6: Rezzonner ($60.85 in chips)
Rezzonner: posts small blind $0.25
Straubje: posts big blind $0.50
*** HOLE CARDS ***
Becks Baker: folds
vovvesvart: raises $1 to $1.50
max21rus1988: folds
G.Andrei95: folds
Rezzonner: folds
Straubje: calls $1
*** FLOP *** [3h 3d Kh]
Straubje: bets $2
vovvesvart: folds
Uncalled bet ($2) returned to Straubje
Straubje collected $3.09 from pot
Straubje: doesn't show hand
*** SUMMARY ***
Total pot $3.25 | Rake $0.16
Board [3h 3d Kh]
Seat 1: Straubje (big blind) collected ($3.09)
Seat 2: Becks Baker folded before Flop (didn't bet)
Seat 3: vovvesvart folded on the Flop
Seat 4: max21rus1988 folded before Flop (didn't bet)
Seat 5: G.Andrei95 (button) folded before Flop (didn't bet)
Seat 6: Rezzonner (small blind) folded before Flop


PokerStars Hand #208959779992:  Hold'em No Limit ($0.25/$0.50 USD) - 2020/02/07 20:29:47 ET
Table 'Bohmia IV' 6-max Seat #6 is the button
Seat 1: Straubje ($50.34 in chips)
Seat 2: Becks Baker ($54.20 in chips)
Seat 3: vovvesvart ($78.36 in chips)
Seat 4: max21rus1988 ($50.50 in chips)
Seat 5: G.Andrei95 ($50 in chips)
Seat 6: Rezzonner ($60.60 in chips)
Straubje: posts small blind $0.25
Becks Baker: posts big blind $0.50
*** HOLE CARDS ***
vovvesvart: folds
max21rus1988: raises $0.75 to $1.25
G.Andrei95: folds
Rezzonner: folds
Straubje: folds
Becks Baker: calls $0.75
*** FLOP *** [Js 5d Tc]
Becks Baker: checks
max21rus1988: bets $1.31
Becks Baker: calls $1.31
*** TURN *** [Js 5d Tc] [4c]
Becks Baker: checks
max21rus1988: bets $3.82
Becks Baker: folds
Uncalled bet ($3.82) returned to max21rus1988
max21rus1988 collected $5.10 from pot
max21rus1988: doesn't show hand
*** SUMMARY ***
Total pot $5.37 | Rake $0.27
Board [Js 5d Tc 4c]
Seat 1: Straubje (small blind) folded before Flop
Seat 2: Becks Baker (big blind) folded on the Turn
Seat 3: vovvesvart folded before Flop (didn't bet)
Seat 4: max21rus1988 collected ($5.10)
Seat 5: G.Andrei95 folded before Flop (didn't bet)
Seat 6: Rezzonner (button) folded before Flop (didn't bet)


PokerStars Hand #208959830465:  Hold'em No Limit ($0.25/$0.50 USD) - 2020/02/07 20:32:08 ET
Table 'Bohmia IV' 6-max Seat #3 is the button
Seat 1: Straubje ($50.09 in chips)
Seat 2: Becks Baker ($56.79 in chips)
Seat 3: vovvesvart ($124.93 in chips)
Seat 4: max21rus1988 ($50 in chips)
Seat 5: G.Andrei95 ($50 in chips)
Seat 6: Rezzonner ($59.35 in chips)
max21rus1988: posts small blind $0.25
G.Andrei95: posts big blind $0.50
*** HOLE CARDS ***
Rezzonner: folds
Straubje: calls $0.50
Becks Baker: folds
vovvesvart: folds
max21rus1988: folds
G.Andrei95: checks
*** FLOP *** [3d 8c Tc]
G.Andrei95: checks
Straubje: bets $2
G.Andrei95: folds
Uncalled bet ($2) returned to Straubje
Straubje collected $1.19 from pot
Straubje: doesn't show hand
*** SUMMARY ***
Total pot $1.25 | Rake $0.06
Board [3d 8c Tc]
Seat 1: Straubje collected ($1.19)
Seat 2: Becks Baker folded before Flop (didn't bet)
Seat 3: vovvesvart (button) folded before Flop (didn't bet)
Seat 4: max21rus1988 (small blind) folded before Flop
Seat 5: G.Andrei95 (big blind) folded on the Flop
Seat 6: Rezzonner folded before Flop (didn't bet)


PokerStars Hand #208959822949:  Hold'em No Limit ($0.25/$0.50 USD) - 2020/02/07 20:31:44 ET
Table 'Bohmia IV' 6-max Seat #2 is the button
Seat 2: Becks Baker ($56.79 in chips)
Seat 3: vovvesvart ($72.64 in chips)
Seat 4: max21rus1988 ($53.04 in chips)
Seat 5: G.Andrei95 ($50 in chips)
Seat 6: Rezzonner ($60.60 in chips)
vovvesvart: posts small blind $0.25
max21rus1988: posts big blind $0.50
*** HOLE CARDS ***
G.Andrei95: folds
Rezzonner: raises $0.75 to $1.25
Becks Baker: folds
vovvesvart: raises $71.39 to $72.64 and is all-in
max21rus1988: calls $52.54 and is all-in
Rezzonner: folds
Uncalled bet ($19.60) returned to vovvesvart
*** FLOP *** [5d Qs 6d]
*** TURN *** [5d Qs 6d] [Tc]
*** RIVER *** [5d Qs 6d Tc] [4c]
*** SHOW DOWN ***
vovvesvart: shows [Js Jc] (a pair of Jacks)
max21rus1988: shows [As Ks] (high card Ace)
vovvesvart collected $105.33 from pot
*** SUMMARY ***
Total pot $107.33 | Rake $2
Board [5d Qs 6d Tc 4c]
Seat 2: Becks Baker (button) folded before Flop (didn't bet)
Seat 3: vovvesvart (small blind) showed [Js Jc] and won ($105.33) with a pair of Jacks
Seat 4: max21rus1988 (big blind) showed [As Ks] and lost with high card Ace
Seat 5: G.Andrei95 folded before Flop (didn't bet)
Seat 6: Rezzonner folded before Flop


PokerStars Hand #208959798371:  Hold'em No Limit ($0.25/$0.50 USD) - 2020/02/07 20:30:44 ET
Table 'Bohmia IV' 6-max Seat #1 is the button
Seat 1: Straubje ($50.09 in chips)
Seat 2: Becks Baker ($51.64 in chips)
Seat 3: vovvesvart ($78.36 in chips)
Seat 4: max21rus1988 ($53.04 in chips)
Seat 5: G.Andrei95 ($50 in chips)
Seat 6: Rezzonner ($60.60 in chips)
Becks Baker: posts small blind $0.25
vovvesvart: posts big blind $0.50
*** HOLE CARDS ***
max21rus1988: folds
G.Andrei95: folds
Rezzonner: folds
Straubje has timed out
Straubje: folds
Becks Baker: raises $1 to $1.50
vovvesvart: calls $1
*** FLOP *** [7d 5h 8c]
Becks Baker: checks
vovvesvart: bets $1.43
Becks Baker: calls $1.43
*** TURN *** [7d 5h 8c] [5c]
Becks Baker: checks
vovvesvart: bets $2.79
Becks Baker: raises $9.90 to $12.69
vovvesvart: folds
Uncalled bet ($9.90) returned to Becks Baker
Becks Baker collected $10.87 from pot
*** SUMMARY ***
Total pot $11.44 | Rake $0.57
Board [7d 5h 8c 5c]
Seat 1: Straubje (button) folded before Flop (didn't bet)
Seat 2: Becks Baker (small blind) collected ($10.87)
Seat 3: vovvesvart (big blind) folded on the Turn
Seat 4: max21rus1988 folded before Flop (didn't bet)
Seat 5: G.Andrei95 folded before Flop (didn't bet)
Seat 6: Rezzonner folded before Flop (didn't bet)


PokerStars Hand #208959841843:  Hold'em No Limit ($0.25/$0.50 USD) - 2020/02/07 20:32:44 ET
Table 'Bohmia IV' 6-max Seat #4 is the button
Seat 1: Straubje ($50.78 in chips)
Seat 2: Becks Baker ($56.79 in chips)
Seat 3: vovvesvart ($124.93 in chips)
Seat 4: max21rus1988 ($50 in chips)
Seat 5: G.Andrei95 ($50 in chips)
Seat 6: Rezzonner ($59.35 in chips)
G.Andrei95: posts small blind $0.25
Rezzonner: posts big blind $0.50
*** HOLE CARDS ***
Straubje: calls $0.50
Becks Baker: raises $2 to $2.50
vovvesvart: calls $2.50
max21rus1988: folds
G.Andrei95: folds
Rezzonner: folds
Straubje: calls $2
*** FLOP *** [2s 9s Ad]
Straubje: checks
Becks Baker: bets $3.92
vovvesvart: calls $3.92
Straubje: folds
*** TURN *** [2s 9s Ad] [5c]
Becks Baker: bets $10.69
vovvesvart: folds
Uncalled bet ($10.69) returned to Becks Baker
Becks Baker collected $15.29 from pot
*** SUMMARY ***
Total pot $16.09 | Rake $0.80
Board [2s 9s Ad 5c]
Seat 1: Straubje folded on the Flop
Seat 2: Becks Baker collected ($15.29)
Seat 3: vovvesvart folded on the Turn
Seat 4: max21rus1988 (button) folded before Flop (didn't bet)
Seat 5: G.Andrei95 (small blind) folded before Flop
Seat 6: Rezzonner (big blind) folded before Flop


PokerStars Hand #208959892868:  Hold'em No Limit ($0.25/$0.50 USD) - 2020/02/07 20:35:24 ET
Table 'Bohmia IV' 6-max Seat #6 is the button
Seat 1: Straubje ($63.36 in chips)
Seat 2: Becks Baker ($65.66 in chips)
Seat 3: vovvesvart ($106.51 in chips)
Seat 4: max21rus1988 ($50 in chips)
Seat 5: G.Andrei95 ($50 in chips)
Seat 6: Rezzonner ($54.35 in chips)
Straubje: posts small blind $0.25
Becks Baker: posts big blind $0.50
*** HOLE CARDS ***
vovvesvart: raises $0.50 to $1
max21rus1988: folds
G.Andrei95: folds
Rezzonner: folds
Straubje: folds
Becks Baker: folds
Uncalled bet ($0.50) returned to vovvesvart
vovvesvart collected $1.25 from pot
vovvesvart: doesn't show hand
*** SUMMARY ***
Total pot $1.25 | Rake $0
Seat 1: Straubje (small blind) folded before Flop
Seat 2: Becks Baker (big blind) folded before Flop
Seat 3: vovvesvart collected ($1.25)
Seat 4: max21rus1988 folded before Flop (didn't bet)
Seat 5: G.Andrei95 folded before Flop (didn't bet)
Seat 6: Rezzonner (button) folded before Flop (didn't bet)


PokerStars Hand #208959867059:  Hold'em No Limit ($0.25/$0.50 USD) - 2020/02/07 20:34:03 ET
Table 'Bohmia IV' 6-max Seat #5 is the button
Seat 1: Straubje ($48.28 in chips)
Seat 2: Becks Baker ($65.66 in chips)
Seat 3: vovvesvart ($118.51 in chips)
Seat 4: max21rus1988 ($50 in chips)
Seat 5: G.Andrei95 ($50 in chips)
Seat 6: Rezzonner ($58.85 in chips)
Rezzonner: posts small blind $0.25
Straubje: posts big blind $0.50
*** HOLE CARDS ***
Becks Baker: folds
vovvesvart: raises $0.50 to $1
max21rus1988: folds
G.Andrei95: folds
Rezzonner: raises $3.50 to $4.50
Straubje: calls $4
vovvesvart: calls $3.50
*** FLOP *** [7h 8d 8s]
Rezzonner: checks
Straubje: bets $7.50
vovvesvart: calls $7.50
Rezzonner: folds
*** TURN *** [7h 8d 8s] [5d]
Straubje: checks
vovvesvart: checks
*** RIVER *** [7h 8d 8s 5d] [5h]
Straubje: bets $13
vovvesvart: folds
Uncalled bet ($13) returned to Straubje
Straubje collected $27.08 from pot
Straubje: doesn't show hand
*** SUMMARY ***
Total pot $28.50 | Rake $1.42
Board [7h 8d 8s 5d 5h]
Seat 1: Straubje (big blind) collected ($27.08)
Seat 2: Becks Baker folded before Flop (didn't bet)
Seat 3: vovvesvart folded on the River
Seat 4: max21rus1988 folded before Flop (didn't bet)
Seat 5: G.Andrei95 (button) folded before Flop (didn't bet)
Seat 6: Rezzonner (small blind) folded on the Flop


PokerStars Hand #208959897502:  Hold'em No Limit ($0.25/$0.50 USD) - 2020/02/07 20:35:39 ET
Table 'Bohmia IV' 6-max Seat #1 is the button
Seat 1: Straubje ($63.11 in chips)
Seat 2: Becks Baker ($65.16 in chips)
Seat 3: vovvesvart ($107.26 in chips)
Seat 4: max21rus1988 ($50 in chips)
Seat 5: G.Andrei95 ($50 in chips)
Seat 6: Rezzonner ($54.35 in chips)
Becks Baker: posts small blind $0.25
vovvesvart: posts big blind $0.50
*** HOLE CARDS ***
max21rus1988: raises $0.75 to $1.25
G.Andrei95: folds
Rezzonner: calls $1.25
Straubje: folds
Becks Baker: folds
vovvesvart: calls $0.75
*** FLOP *** [9d Qc 2h]
vovvesvart: checks
max21rus1988: checks
Rezzonner: checks
*** TURN *** [9d Qc 2h] [As]
vovvesvart: checks
max21rus1988: bets $1.90
Rezzonner: folds
vovvesvart: calls $1.90
*** RIVER *** [9d Qc 2h As] [3s]
vovvesvart: checks
max21rus1988: bets $4.25
vovvesvart: raises $4.25 to $8.50
max21rus1988: calls $4.25
*** SHOW DOWN ***
vovvesvart: shows [2s 3h] (two pair, Threes and Deuces)
max21rus1988: mucks hand
vovvesvart collected $23.56 from pot
*** SUMMARY ***
Total pot $24.80 | Rake $1.24
Board [9d Qc 2h As 3s]
Seat 1: Straubje (button) folded before Flop (didn't bet)
Seat 2: Becks Baker (small blind) folded before Flop
Seat 3: vovvesvart (big blind) showed [2s 3h] and won ($23.56) with two pair, Threes and Deuces
Seat 4: max21rus1988 mucked
Seat 5: G.Andrei95 folded before Flop (didn't bet)
Seat 6: Rezzonner folded on the Turn


PokerStars Hand #208959918758:  Hold'em No Limit ($0.25/$0.50 USD) - 2020/02/07 20:36:45 ET
Table 'Bohmia IV' 6-max Seat #2 is the button
Seat 1: Straubje ($63.11 in chips)
Seat 2: Becks Baker ($64.91 in chips)
Seat 3: vovvesvart ($119.17 in chips)
Seat 4: max21rus1988 ($50 in chips)
Seat 5: G.Andrei95 ($50 in chips)
Seat 6: Rezzonner ($53.10 in chips)
vovvesvart: posts small blind $0.25
max21rus1988: posts big blind $0.50
*** HOLE CARDS ***
G.Andrei95: folds
Rezzonner: folds
Straubje: folds
Becks Baker: raises $0.75 to $1.25
vovvesvart: calls $1
max21rus1988: calls $0.75
*** FLOP *** [9c 4h Jh]
vovvesvart: checks
max21rus1988: checks
Becks Baker: bets $1.78
vovvesvart: calls $1.78
max21rus1988: folds
*** TURN *** [9c 4h Jh] [3s]
vovvesvart: checks
Becks Baker: checks
*** RIVER *** [9c 4h Jh 3s] [6h]
vovvesvart: bets $6.94
Becks Baker: calls $6.94
*** SHOW DOWN ***
vovvesvart: shows [4s 6c] (two pair, Sixes and Fours)
Becks Baker: mucks hand
vovvesvart collected $20.13 from pot
*** SUMMARY ***
Total pot $21.19 | Rake $1.06
Board [9c 4h Jh 3s 6h]
Seat 1: Straubje folded before Flop (didn't bet)
Seat 2: Becks Baker (button) mucked
Seat 3: vovvesvart (small blind) showed [4s 6c] and won ($20.13) with two pair, Sixes and Fours
Seat 4: max21rus1988 (big blind) folded on the Flop
Seat 5: G.Andrei95 folded before Flop (didn't bet)
Seat 6: Rezzonner folded before Flop (didn't bet)


PokerStars Hand #208959942421:  Hold'em No Limit ($0.25/$0.50 USD) - 2020/02/07 20:37:39 ET
Table 'Bohmia IV' 6-max Seat #3 is the button
Seat 1: Straubje ($63.11 in chips)
Seat 2: Becks Baker ($54.94 in chips)
Seat 3: vovvesvart ($129.33 in chips)
Seat 4: max21rus1988 ($50 in chips)
Seat 5: G.Andrei95 ($50 in chips)
Seat 6: Rezzonner ($53.10 in chips)
max21rus1988: posts small blind $0.25
G.Andrei95: posts big blind $0.50
*** HOLE CARDS ***
Rezzonner: folds
Straubje: calls $0.50
Becks Baker: folds
vovvesvart: raises $1.75 to $2.25
max21rus1988: folds
G.Andrei95: folds
Straubje: calls $1.75
*** FLOP *** [Ks 4d Kc]
Straubje: checks
vovvesvart: bets $2.50
Straubje: folds
Uncalled bet ($2.50) returned to vovvesvart
vovvesvart collected $4.99 from pot
vovvesvart: doesn't show hand
*** SUMMARY ***
Total pot $5.25 | Rake $0.26
Board [Ks 4d Kc]
Seat 1: Straubje folded on the Flop
Seat 2: Becks Baker folded before Flop (didn't bet)
Seat 3: vovvesvart (button) collected ($4.99)
Seat 4: max21rus1988 (small blind) folded before Flop
Seat 5: G.Andrei95 (big blind) folded before Flop
Seat 6: Rezzonner folded before Flop (didn't bet)


PokerStars Hand #208959952286:  Hold'em No Limit ($0.25/$0.50 USD) - 2020/02/07 20:38:11 ET
Table 'Bohmia IV' 6-max Seat #4 is the button
Seat 1: Straubje ($60.86 in chips)
Seat 2: Becks Baker ($54.94 in chips)
Seat 3: vovvesvart ($132.07 in chips)
Seat 4: max21rus1988 ($50 in chips)
Seat 5: G.Andrei95 ($50 in chips)
Seat 6: Rezzonner ($53.10 in chips)
G.Andrei95: posts small blind $0.25
Rezzonner: posts big blind $0.50
*** HOLE CARDS ***
Straubje: calls $0.50
Becks Baker: folds
vovvesvart: calls $0.50
max21rus1988: folds
G.Andrei95: calls $0.25
Rezzonner: checks
*** FLOP *** [7d 6s Js]
G.Andrei95: checks
Rezzonner: checks
Straubje: checks
vovvesvart: bets $1.90
G.Andrei95: folds
Rezzonner: folds
Straubje: calls $1.90
*** TURN *** [7d 6s Js] [Qh]
Straubje: bets $4.50
vovvesvart: folds
Uncalled bet ($4.50) returned to Straubje
Straubje collected $5.51 from pot
Straubje: doesn't show hand
*** SUMMARY ***
Total pot $5.80 | Rake $0.29
Board [7d 6s Js Qh]
Seat 1: Straubje collected ($5.51)
Seat 2: Becks Baker folded before Flop (didn't bet)
Seat 3: vovvesvart folded on the Turn
Seat 4: max21rus1988 (button) folded before Flop (didn't bet)
Seat 5: G.Andrei95 (small blind) folded on the Flop
Seat 6: Rezzonner (big blind) folded on the Flop


PokerStars Hand #208959967174:  Hold'em No Limit ($0.25/$0.50 USD) - 2020/02/07 20:38:58 ET
Table 'Bohmia IV' 6-max Seat #5 is the button
Seat 1: Straubje ($63.97 in chips)
Seat 2: Becks Baker ($54.94 in chips)
Seat 3: vovvesvart ($129.67 in chips)
Seat 4: max21rus1988 ($50 in chips)
Seat 5: G.Andrei95 ($50 in chips)
Seat 6: Rezzonner ($52.60 in chips)
Rezzonner: posts small blind $0.25
Straubje: posts big blind $0.50
*** HOLE CARDS ***
Becks Baker: raises $0.75 to $1.25
vovvesvart: calls $1.25
max21rus1988: folds
G.Andrei95: folds
Rezzonner: folds
Straubje: calls $0.75
*** FLOP *** [9d 5c 5h]
Straubje: checks
Becks Baker: checks
vovvesvart: bets $1.90
Straubje: calls $1.90
Becks Baker: calls $1.90
*** TURN *** [9d 5c 5h] [4h]
Straubje: checks
Becks Baker: checks
vovvesvart: checks
*** RIVER *** [9d 5c 5h 4h] [Kd]
Straubje: bets $8.50
Becks Baker: folds
vovvesvart: folds
Uncalled bet ($8.50) returned to Straubje
Straubje collected $9.22 from pot
Straubje: doesn't show hand
*** SUMMARY ***
Total pot $9.70 | Rake $0.48
Board [9d 5c 5h 4h Kd]
Seat 1: Straubje (big blind) collected ($9.22)
Seat 2: Becks Baker folded on the River
Seat 3: vovvesvart folded on the River
Seat 4: max21rus1988 folded before Flop (didn't bet)
Seat 5: G.Andrei95 (button) folded before Flop (didn't bet)
Seat 6: Rezzonner (small blind) folded before Flop


PokerStars Hand #208960008274:  Hold'em No Limit ($0.25/$0.50 USD) - 2020/02/07 20:40:40 ET
Table 'Bohmia IV' 6-max Seat #1 is the button
Seat 1: Straubje ($68.54 in chips)
Seat 2: Becks Baker ($53.14 in chips)
Seat 3: vovvesvart ($126.52 in chips)
Seat 4: max21rus1988 ($50 in chips)
Seat 5: G.Andrei95 ($50 in chips)
Seat 6: Rezzonner ($52.35 in chips)
Becks Baker: posts small blind $0.25
vovvesvart: posts big blind $0.50
*** HOLE CARDS ***
max21rus1988: folds
G.Andrei95: folds
Rezzonner: raises $0.75 to $1.25
Straubje: calls $1.25
Becks Baker: folds
vovvesvart: calls $0.75
*** FLOP *** [9s 7h Td]
vovvesvart: checks
Rezzonner: bets $2.51
Straubje: folds
vovvesvart: folds
Uncalled bet ($2.51) returned to Rezzonner
Rezzonner collected $3.80 from pot
Rezzonner: doesn't show hand
*** SUMMARY ***
Total pot $4 | Rake $0.20
Board [9s 7h Td]
Seat 1: Straubje (button) folded on the Flop
Seat 2: Becks Baker (small blind) folded before Flop
Seat 3: vovvesvart (big blind) folded on the Flop
Seat 4: max21rus1988 folded before Flop (didn't bet)
Seat 5: G.Andrei95 folded before Flop (didn't bet)
Seat 6: Rezzonner collected ($3.80)


PokerStars Hand #208959994913:  Hold'em No Limit ($0.25/$0.50 USD) - 2020/02/07 20:39:58 ET
Table 'Bohmia IV' 6-max Seat #6 is the button
Seat 1: Straubje ($70.04 in chips)
Seat 2: Becks Baker ($51.79 in chips)
Seat 3: vovvesvart ($126.52 in chips)
Seat 4: max21rus1988 ($50 in chips)
Seat 5: G.Andrei95 ($50 in chips)
Seat 6: Rezzonner ($52.35 in chips)
Straubje: posts small blind $0.25
Becks Baker: posts big blind $0.50
*** HOLE CARDS ***
vovvesvart: folds
max21rus1988: folds
G.Andrei95: folds
Rezzonner: folds
Straubje: calls $0.25
Becks Baker: checks
*** FLOP *** [2s As 6c]
Straubje: bets $1
Becks Baker: raises $2.75 to $3.75
Straubje: folds
Uncalled bet ($2.75) returned to Becks Baker
Becks Baker collected $2.85 from pot
*** SUMMARY ***
Total pot $3 | Rake $0.15
Board [2s As 6c]
Seat 1: Straubje (small blind) folded on the Flop
Seat 2: Becks Baker (big blind) collected ($2.85)
Seat 3: vovvesvart folded before Flop (didn't bet)
Seat 4: max21rus1988 folded before Flop (didn't bet)
Seat 5: G.Andrei95 folded before Flop (didn't bet)
Seat 6: Rezzonner (button) folded before Flop (didn't bet)


PokerStars Hand #208960025893:  Hold'em No Limit ($0.25/$0.50 USD) - 2020/02/07 20:41:37 ET
Table 'Bohmia IV' 6-max Seat #2 is the button
Seat 1: Straubje ($67.29 in chips)
Seat 2: Becks Baker ($52.89 in chips)
Seat 3: vovvesvart ($125.27 in chips)
Seat 4: max21rus1988 ($50 in chips)
Seat 5: G.Andrei95 ($50 in chips)
Seat 6: Rezzonner ($54.90 in chips)
vovvesvart: posts small blind $0.25
max21rus1988: posts big blind $0.50
*** HOLE CARDS ***
G.Andrei95: folds
Rezzonner: folds
Straubje: raises $1.50 to $2
Becks Baker: folds
vovvesvart: calls $1.75
max21rus1988: calls $1.50
*** FLOP *** [Kc 7d 3h]
vovvesvart: checks
max21rus1988: checks
Straubje: bets $4
vovvesvart: calls $4
max21rus1988: folds
*** TURN *** [Kc 7d 3h] [Td]
vovvesvart: checks
Straubje: checks
*** RIVER *** [Kc 7d 3h Td] [4c]
vovvesvart: bets $0.50
Straubje: raises $13.50 to $14
vovvesvart: calls $13.50
*** SHOW DOWN ***
Straubje: shows [5s 6d] (a straight, Three to Seven)
vovvesvart: mucks hand
Straubje collected $40 from pot
*** SUMMARY ***
Total pot $42 | Rake $2
Board [Kc 7d 3h Td 4c]
Seat 1: Straubje showed [5s 6d] and won ($40) with a straight, Three to Seven
Seat 2: Becks Baker (button) folded before Flop (didn't bet)
Seat 3: vovvesvart (small blind) mucked
Seat 4: max21rus1988 (big blind) folded on the Flop
Seat 5: G.Andrei95 folded before Flop (didn't bet)
Seat 6: Rezzonner folded before Flop (didn't bet)


PokerStars Hand #208960041486:  Hold'em No Limit ($0.25/$0.50 USD) - 2020/02/07 20:42:26 ET
Table 'Bohmia IV' 6-max Seat #3 is the button
Seat 1: Straubje ($87.29 in chips)
Seat 2: Becks Baker ($52.89 in chips)
Seat 3: vovvesvart ($105.27 in chips)
Seat 4: max21rus1988 ($50 in chips)
Seat 5: G.Andrei95 ($50 in chips)
Seat 6: Rezzonner ($54.90 in chips)
max21rus1988: posts small blind $0.25
G.Andrei95: posts big blind $0.50
*** HOLE CARDS ***
Rezzonner: raises $0.75 to $1.25
Straubje: folds
Becks Baker: folds
vovvesvart: calls $1.25
max21rus1988: folds
G.Andrei95: folds
*** FLOP *** [Jd Kc 4d]
Rezzonner: checks
vovvesvart: checks
*** TURN *** [Jd Kc 4d] [4c]
Rezzonner: checks
vovvesvart: bets $3.09
Rezzonner: calls $3.09
*** RIVER *** [Jd Kc 4d 4c] [Th]
Rezzonner: checks
vovvesvart: checks
*** SHOW DOWN ***
Rezzonner: shows [6d 6c] (two pair, Sixes and Fours)
vovvesvart: mucks hand
Rezzonner collected $8.96 from pot
*** SUMMARY ***
Total pot $9.43 | Rake $0.47
Board [Jd Kc 4d 4c Th]
Seat 1: Straubje folded before Flop (didn't bet)
Seat 2: Becks Baker folded before Flop (didn't bet)
Seat 3: vovvesvart (button) mucked
Seat 4: max21rus1988 (small blind) folded before Flop
Seat 5: G.Andrei95 (big blind) folded before Flop
Seat 6: Rezzonner showed [6d 6c] and won ($8.96) with two pair, Sixes and Fours


PokerStars Hand #208960058205:  Hold'em No Limit ($0.25/$0.50 USD) - 2020/02/07 20:43:19 ET
Table 'Bohmia IV' 6-max Seat #4 is the button
Seat 1: Straubje ($87.29 in chips)
Seat 2: Becks Baker ($52.89 in chips)
Seat 3: vovvesvart ($100.93 in chips)
Seat 4: max21rus1988 ($50 in chips)
Seat 5: G.Andrei95 ($50 in chips)
Seat 6: Rezzonner ($59.52 in chips)
G.Andrei95: posts small blind $0.25
Rezzonner: posts big blind $0.50
*** HOLE CARDS ***
Straubje: folds
Becks Baker: raises $0.75 to $1.25
vovvesvart: folds
max21rus1988: folds
G.Andrei95: folds
Rezzonner: folds
Uncalled bet ($0.75) returned to Becks Baker
Becks Baker collected $1.25 from pot
*** SUMMARY ***
Total pot $1.25 | Rake $0
Seat 1: Straubje folded before Flop (didn't bet)
Seat 2: Becks Baker collected ($1.25)
Seat 3: vovvesvart folded before Flop (didn't bet)
Seat 4: max21rus1988 (button) folded before Flop (didn't bet)
Seat 5: G.Andrei95 (small blind) folded before Flop
Seat 6: Rezzonner (big blind) folded before Flop


PokerStars Hand #208960063442:  Hold'em No Limit ($0.25/$0.50 USD) - 2020/02/07 20:43:36 ET
Table 'Bohmia IV' 6-max Seat #5 is the button
Seat 1: Straubje ($87.29 in chips)
Seat 2: Becks Baker ($53.64 in chips)
Seat 3: vovvesvart ($100.93 in chips)
Seat 4: max21rus1988 ($50 in chips)
Seat 5: G.Andrei95 ($50 in chips)
Seat 6: Rezzonner ($59.02 in chips)
Rezzonner: posts small blind $0.25
Straubje: posts big blind $0.50
*** HOLE CARDS ***
Becks Baker: raises $0.75 to $1.25
vovvesvart: calls $1.25
max21rus1988: folds
G.Andrei95: folds
Rezzonner: calls $1
Straubje: calls $0.75
*** FLOP *** [Td 2d 9d]
Rezzonner: checks
Straubje: checks
Becks Baker: checks
vovvesvart: bets $2.38
Rezzonner: folds
Straubje: folds
Becks Baker: folds
Uncalled bet ($2.38) returned to vovvesvart
vovvesvart collected $4.75 from pot
vovvesvart: doesn't show hand
*** SUMMARY ***
Total pot $5 | Rake $0.25
Board [Td 2d 9d]
Seat 1: Straubje (big blind) folded on the Flop
Seat 2: Becks Baker folded on the Flop
Seat 3: vovvesvart collected ($4.75)
Seat 4: max21rus1988 folded before Flop (didn't bet)
Seat 5: G.Andrei95 (button) folded before Flop (didn't bet)
Seat 6: Rezzonner (small blind) folded on the Flop


PokerStars Hand #208960073257:  Hold'em No Limit ($0.25/$0.50 USD) - 2020/02/07 20:44:08 ET
Table 'Bohmia IV' 6-max Seat #6 is the button
Seat 1: Straubje ($86.04 in chips)
Seat 2: Becks Baker ($52.39 in chips)
Seat 3: vovvesvart ($104.43 in chips)
Seat 4: max21rus1988 ($50 in chips)
Seat 5: G.Andrei95 ($50 in chips)
Seat 6: Rezzonner ($57.77 in chips)
Straubje: posts small blind $0.25
Becks Baker: posts big blind $0.50
*** HOLE CARDS ***
vovvesvart: calls $0.50
max21rus1988: folds
G.Andrei95: folds
Rezzonner: folds
Straubje: calls $0.25
Becks Baker: raises $2 to $2.50
vovvesvart: calls $2
Straubje: folds
*** FLOP *** [2c 6c 5s]
Becks Baker: checks
vovvesvart: bets $5.22
Becks Baker: folds
Uncalled bet ($5.22) returned to vovvesvart
vovvesvart collected $5.22 from pot
vovvesvart: doesn't show hand
*** SUMMARY ***
Total pot $5.50 | Rake $0.28
Board [2c 6c 5s]
Seat 1: Straubje (small blind) folded before Flop
Seat 2: Becks Baker (big blind) folded on the Flop
Seat 3: vovvesvart collected ($5.22)
Seat 4: max21rus1988 folded before Flop (didn't bet)
Seat 5: G.Andrei95 folded before Flop (didn't bet)
Seat 6: Rezzonner (button) folded before Flop (didn't bet)


PokerStars Hand #208960089830:  Hold'em No Limit ($0.25/$0.50 USD) - 2020/02/07 20:44:47 ET
Table 'Bohmia IV' 6-max Seat #1 is the button
Seat 1: Straubje ($85.54 in chips)
Seat 2: Becks Baker ($50 in chips)
Seat 3: vovvesvart ($107.15 in chips)
Seat 4: max21rus1988 ($50 in chips)
Seat 5: G.Andrei95 ($50 in chips)
Seat 6: Rezzonner ($57.77 in chips)
Becks Baker: posts small blind $0.25
vovvesvart: posts big blind $0.50
*** HOLE CARDS ***
max21rus1988: folds
G.Andrei95: folds
Rezzonner: folds
Straubje: calls $0.50
Becks Baker: folds
vovvesvart: checks
*** FLOP *** [9c 2s Js]
vovvesvart: checks
Straubje: bets $1
vovvesvart: raises $1 to $2
Straubje: calls $1
*** TURN *** [9c 2s Js] [Kh]
vovvesvart: checks
Straubje: checks
*** RIVER *** [9c 2s Js Kh] [9d]
vovvesvart: checks
Straubje: bets $14.50
vovvesvart: folds
Uncalled bet ($14.50) returned to Straubje
Straubje collected $4.99 from pot
Straubje: doesn't show hand
*** SUMMARY ***
Total pot $5.25 | Rake $0.26
Board [9c 2s Js Kh 9d]
Seat 1: Straubje (button) collected ($4.99)
Seat 2: Becks Baker (small blind) folded before Flop
Seat 3: vovvesvart (big blind) folded on the River
Seat 4: max21rus1988 folded before Flop (didn't bet)
Seat 5: G.Andrei95 folded before Flop (didn't bet)
Seat 6: Rezzonner folded before Flop (didn't bet)


PokerStars Hand #208960129771:  Hold'em No Limit ($0.25/$0.50 USD) - 2020/02/07 20:46:56 ET
Table 'Bohmia IV' 6-max Seat #3 is the button
Seat 1: Straubje ($86.78 in chips)
Seat 2: Becks Baker ($50 in chips)
Seat 3: vovvesvart ($100.55 in chips)
Seat 4: max21rus1988 ($50 in chips)
Seat 5: G.Andrei95 ($50 in chips)
Seat 6: Rezzonner ($63.83 in chips)
max21rus1988: posts small blind $0.25
G.Andrei95: posts big blind $0.50
*** HOLE CARDS ***
Rezzonner: folds
Straubje: raises $3.50 to $4
Becks Baker: folds
vovvesvart has timed out
vovvesvart: folds
max21rus1988: folds
G.Andrei95: folds
Uncalled bet ($3.50) returned to Straubje
Straubje collected $1.25 from pot
Straubje: doesn't show hand
*** SUMMARY ***
Total pot $1.25 | Rake $0
Seat 1: Straubje collected ($1.25)
Seat 2: Becks Baker folded before Flop (didn't bet)
Seat 3: vovvesvart (button) folded before Flop (didn't bet)
Seat 4: max21rus1988 (small blind) folded before Flop
Seat 5: G.Andrei95 (big blind) folded before Flop
Seat 6: Rezzonner folded before Flop (didn't bet)


PokerStars Hand #208960102812:  Hold'em No Limit ($0.25/$0.50 USD) - 2020/02/07 20:45:29 ET
Table 'Bohmia IV' 6-max Seat #2 is the button
Seat 1: Straubje ($88.03 in chips)
Seat 2: Becks Baker ($50 in chips)
Seat 3: vovvesvart ($104.65 in chips)
Seat 4: max21rus1988 ($50 in chips)
Seat 5: G.Andrei95 ($50 in chips)
Seat 6: Rezzonner ($57.77 in chips)
vovvesvart: posts small blind $0.25
max21rus1988: posts big blind $0.50
*** HOLE CARDS ***
G.Andrei95: folds
Rezzonner: raises $0.75 to $1.25
Straubje: calls $1.25
Becks Baker: folds
vovvesvart: calls $1
max21rus1988: calls $0.75
*** FLOP *** [6c 3c Tc]
vovvesvart: checks
max21rus1988: checks
Rezzonner: checks
Straubje: checks
*** TURN *** [6c 3c Tc] [Kd]
vovvesvart: checks
max21rus1988: checks
Rezzonner: bets $2.85
Straubje: folds
vovvesvart: calls $2.85
max21rus1988: folds
*** RIVER *** [6c 3c Tc Kd] [3s]
vovvesvart: checks
Rezzonner: bets $6.10
vovvesvart: folds
Uncalled bet ($6.10) returned to Rezzonner
Rezzonner collected $10.16 from pot
Rezzonner: doesn't show hand
*** SUMMARY ***
Total pot $10.70 | Rake $0.54
Board [6c 3c Tc Kd 3s]
Seat 1: Straubje folded on the Turn
Seat 2: Becks Baker (button) folded before Flop (didn't bet)
Seat 3: vovvesvart (small blind) folded on the River
Seat 4: max21rus1988 (big blind) folded on the Turn
Seat 5: G.Andrei95 folded before Flop (didn't bet)
Seat 6: Rezzonner collected ($10.16)


PokerStars Hand #208960143584:  Hold'em No Limit ($0.25/$0.50 USD) - 2020/02/07 20:47:42 ET
Table 'Bohmia IV' 6-max Seat #5 is the button
Seat 1: Straubje ($88.28 in chips)
Seat 2: Becks Baker ($50 in chips)
Seat 3: vovvesvart ($100.55 in chips)
Seat 4: max21rus1988 ($50 in chips)
Seat 5: G.Andrei95 ($50 in chips)
Seat 6: Rezzonner ($63.33 in chips)
Rezzonner: posts small blind $0.25
Straubje: posts big blind $0.50
*** HOLE CARDS ***
Becks Baker: folds
vovvesvart: calls $0.50
max21rus1988: raises $1.25 to $1.75
G.Andrei95: folds
Rezzonner: folds
Straubje: calls $1.25
vovvesvart: raises $98.80 to $100.55 and is all-in
max21rus1988: folds
Straubje: folds
Uncalled bet ($98.80) returned to vovvesvart
vovvesvart collected $5.50 from pot
vovvesvart: doesn't show hand
*** SUMMARY ***
Total pot $5.50 | Rake $0
Seat 1: Straubje (big blind) folded before Flop
Seat 2: Becks Baker folded before Flop (didn't bet)
Seat 3: vovvesvart collected ($5.50)
Seat 4: max21rus1988 folded before Flop
Seat 5: G.Andrei95 (button) folded before Flop (didn't bet)
Seat 6: Rezzonner (small blind) folded before Flop


PokerStars Hand #208960149906:  Hold'em No Limit ($0.25/$0.50 USD) - 2020/02/07 20:48:03 ET
Table 'Bohmia IV' 6-max Seat #6 is the button
Seat 1: Straubje ($86.53 in chips)
Seat 2: Becks Baker ($50 in chips)
Seat 3: vovvesvart ($104.30 in chips)
Seat 4: max21rus1988 ($50 in chips)
Seat 5: G.Andrei95 ($50 in chips)
Seat 6: Rezzonner ($63.08 in chips)
Straubje: posts small blind $0.25
Becks Baker: posts big blind $0.50
*** HOLE CARDS ***
vovvesvart: calls $0.50
max21rus1988: folds
G.Andrei95: raises $1.50 to $2
Rezzonner: folds
Straubje: folds
Becks Baker: folds
vovvesvart: calls $1.50
*** FLOP *** [Jc 4h 7d]
vovvesvart: checks
G.Andrei95: bets $1.13
vovvesvart: calls $1.13
*** TURN *** [Jc 4h 7d] [2d]
vovvesvart: checks
G.Andrei95: checks
*** RIVER *** [Jc 4h 7d 2d] [8d]
vovvesvart: bets $6.66
G.Andrei95: calls $6.66
*** SHOW DOWN ***
vovvesvart: shows [3c 6h] (high card Jack)
G.Andrei95: shows [8h 7h] (two pair, Eights and Sevens)
G.Andrei95 collected $19.31 from pot
*** SUMMARY ***
Total pot $20.33 | Rake $1.02
Board [Jc 4h 7d 2d 8d]
Seat 1: Straubje (small blind) folded before Flop
Seat 2: Becks Baker (big blind) folded before Flop
Seat 3: vovvesvart showed [3c 6h] and lost with high card Jack
Seat 4: max21rus1988 folded before Flop (didn't bet)
Seat 5: G.Andrei95 showed [8h 7h] and won ($19.31) with two pair, Eights and Sevens
Seat 6: Rezzonner (button) folded before Flop (didn't bet)


PokerStars Hand #208960181103:  Hold'em No Limit ($0.25/$0.50 USD) - 2020/02/07 20:49:20 ET
Table 'Bohmia IV' 6-max Seat #1 is the button
Seat 1: Straubje ($86.28 in chips)
Seat 2: Becks Baker ($50 in chips)
Seat 3: vovvesvart ($94.51 in chips)
Seat 4: max21rus1988 ($50 in chips)
Seat 5: G.Andrei95 ($59.52 in chips)
Seat 6: Rezzonner ($63.08 in chips)
Becks Baker: posts small blind $0.25
vovvesvart: posts big blind $0.50
*** HOLE CARDS ***
max21rus1988: folds
G.Andrei95: folds
Rezzonner: folds
Straubje: raises $2 to $2.50
Becks Baker: folds
vovvesvart: raises $92.01 to $94.51 and is all-in
Straubje: calls $83.78 and is all-in
Uncalled bet ($8.23) returned to vovvesvart
*** FLOP *** [Tc Kh 4d]
*** TURN *** [Tc Kh 4d] [2s]
*** RIVER *** [Tc Kh 4d 2s] [5s]
*** SHOW DOWN ***
vovvesvart: shows [Ks Ah] (a pair of Kings)
Straubje: shows [Ac Jd] (high card Ace)
vovvesvart collected $170.81 from pot
Straubje cashed out the hand for $44.48 | Cash Out Fee $0.45
*** SUMMARY ***
Total pot $172.81 | Rake $2
Board [Tc Kh 4d 2s 5s]
Seat 1: Straubje (button) showed [Ac Jd] and lost with high card Ace (cashed out).
Seat 2: Becks Baker (small blind) folded before Flop
Seat 3: vovvesvart (big blind) showed [Ks Ah] and won ($170.81) with a pair of Kings
Seat 4: max21rus1988 folded before Flop (didn't bet)
Seat 5: G.Andrei95 folded before Flop (didn't bet)
Seat 6: Rezzonner folded before Flop (didn't bet)


PokerStars Hand #208960189567:  Hold'em No Limit ($0.25/$0.50 USD) - 2020/02/07 20:49:48 ET
Table 'Bohmia IV' 6-max Seat #2 is the button
Seat 1: Straubje ($44.48 in chips)
Seat 2: Becks Baker ($50 in chips)
Seat 3: vovvesvart ($179.04 in chips)
Seat 4: max21rus1988 ($50 in chips)
Seat 5: G.Andrei95 ($59.52 in chips)
Seat 6: Rezzonner ($63.08 in chips)
vovvesvart: posts small blind $0.25
max21rus1988: posts big blind $0.50
*** HOLE CARDS ***
G.Andrei95: folds
Rezzonner: raises $0.75 to $1.25
Straubje: folds
Becks Baker: folds
vovvesvart: calls $1
max21rus1988: calls $0.75
*** FLOP *** [9d 2c Ts]
vovvesvart: checks
max21rus1988: checks
Rezzonner: checks
*** TURN *** [9d 2c Ts] [2d]
vovvesvart: checks
max21rus1988: bets $2.25
Rezzonner: calls $2.25
vovvesvart: calls $2.25
*** RIVER *** [9d 2c Ts 2d] [3h]
vovvesvart: checks
max21rus1988: checks
Rezzonner: checks
*** SHOW DOWN ***
vovvesvart: shows [2s Th] (a full house, Deuces full of Tens)
max21rus1988: mucks hand
Rezzonner: mucks hand
vovvesvart collected $9.98 from pot
*** SUMMARY ***
Total pot $10.50 | Rake $0.52
Board [9d 2c Ts 2d 3h]
Seat 1: Straubje folded before Flop (didn't bet)
Seat 2: Becks Baker (button) folded before Flop (didn't bet)
Seat 3: vovvesvart (small blind) showed [2s Th] and won ($9.98) with a full house, Deuces full of Tens
Seat 4: max21rus1988 (big blind) mucked
Seat 5: G.Andrei95 folded before Flop (didn't bet)
Seat 6: Rezzonner mucked


PokerStars Hand #208960207014:  Hold'em No Limit ($0.25/$0.50 USD) - 2020/02/07 20:50:45 ET
Table 'Bohmia IV' 6-max Seat #3 is the button
Seat 1: Straubje ($50 in chips)
Seat 2: Becks Baker ($50 in chips)
Seat 3: vovvesvart ($185.52 in chips)
Seat 4: max21rus1988 ($50 in chips)
Seat 5: G.Andrei95 ($59.52 in chips)
Seat 6: Rezzonner ($59.58 in chips)
max21rus1988: posts small blind $0.25
G.Andrei95: posts big blind $0.50
*** HOLE CARDS ***
Rezzonner: folds
Straubje: calls $0.50
Becks Baker: folds
vovvesvart: calls $0.50
max21rus1988: folds
G.Andrei95: checks
*** FLOP *** [As Th Kd]
G.Andrei95: checks
Straubje: checks
vovvesvart: bets $0.50
G.Andrei95: calls $0.50
Straubje: calls $0.50
*** TURN *** [As Th Kd] [Ad]
G.Andrei95: checks
Straubje: checks
vovvesvart: checks
*** RIVER *** [As Th Kd Ad] [5c]
G.Andrei95: checks
Straubje: checks
vovvesvart: checks
*** SHOW DOWN ***
G.Andrei95: shows [8d Tc] (two pair, Aces and Tens)
Straubje: mucks hand
vovvesvart: mucks hand
G.Andrei95 collected $3.09 from pot
*** SUMMARY ***
Total pot $3.25 | Rake $0.16
Board [As Th Kd Ad 5c]
Seat 1: Straubje mucked
Seat 2: Becks Baker folded before Flop (didn't bet)
Seat 3: vovvesvart (button) mucked
Seat 4: max21rus1988 (small blind) folded before Flop
Seat 5: G.Andrei95 (big blind) showed [8d Tc] and won ($3.09) with two pair, Aces and Tens
Seat 6: Rezzonner folded before Flop (didn't bet)


PokerStars Hand #208960220852:  Hold'em No Limit ($0.25/$0.50 USD) - 2020/02/07 20:51:31 ET
Table 'Bohmia IV' 6-max Seat #4 is the button
Seat 1: Straubje ($49 in chips)
Seat 2: Becks Baker ($50 in chips)
Seat 3: vovvesvart ($184.52 in chips)
Seat 4: max21rus1988 ($50 in chips)
Seat 5: G.Andrei95 ($61.61 in chips)
Seat 6: Rezzonner ($59.58 in chips)
G.Andrei95: posts small blind $0.25
Rezzonner: posts big blind $0.50
*** HOLE CARDS ***
Straubje: folds
Becks Baker: folds
vovvesvart: raises $0.50 to $1
max21rus1988: calls $1
G.Andrei95: folds
Rezzonner: calls $0.50
*** FLOP *** [5c 2h 9h]
Rezzonner: checks
vovvesvart: checks
max21rus1988: checks
*** TURN *** [5c 2h 9h] [8d]
Rezzonner: checks
vovvesvart: bets $1.55
max21rus1988: folds
Rezzonner: folds
Uncalled bet ($1.55) returned to vovvesvart
vovvesvart collected $3.09 from pot
vovvesvart: doesn't show hand
*** SUMMARY ***
Total pot $3.25 | Rake $0.16
Board [5c 2h 9h 8d]
Seat 1: Straubje folded before Flop (didn't bet)
Seat 2: Becks Baker folded before Flop (didn't bet)
Seat 3: vovvesvart collected ($3.09)
Seat 4: max21rus1988 (button) folded on the Turn
Seat 5: G.Andrei95 (small blind) folded before Flop
Seat 6: Rezzonner (big blind) folded on the Turn


PokerStars Hand #208960255950:  Hold'em No Limit ($0.25/$0.50 USD) - 2020/02/07 20:53:27 ET
Table 'Bohmia IV' 6-max Seat #1 is the button
Seat 1: Straubje ($55.11 in chips)
Seat 2: Becks Baker ($50 in chips)
Seat 3: vovvesvart ($180.61 in chips)
Seat 4: max21rus1988 ($50 in chips)
Seat 5: G.Andrei95 ($61.36 in chips)
Seat 6: Rezzonner ($58.33 in chips)
Becks Baker: posts small blind $0.25
vovvesvart: posts big blind $0.50
*** HOLE CARDS ***
max21rus1988: raises $0.75 to $1.25
G.Andrei95: folds
Rezzonner: folds
Straubje: folds
Becks Baker: folds
vovvesvart: folds
Uncalled bet ($0.75) returned to max21rus1988
max21rus1988 collected $1.25 from pot
max21rus1988: doesn't show hand
*** SUMMARY ***
Total pot $1.25 | Rake $0
Seat 1: Straubje (button) folded before Flop (didn't bet)
Seat 2: Becks Baker (small blind) folded before Flop
Seat 3: vovvesvart (big blind) folded before Flop
Seat 4: max21rus1988 collected ($1.25)
Seat 5: G.Andrei95 folded before Flop (didn't bet)
Seat 6: Rezzonner folded before Flop (didn't bet)


PokerStars Hand #208960244575:  Hold'em No Limit ($0.25/$0.50 USD) - 2020/02/07 20:52:49 ET
Table 'Bohmia IV' 6-max Seat #6 is the button
Seat 1: Straubje ($52.39 in chips)
Seat 2: Becks Baker ($50 in chips)
Seat 3: vovvesvart ($183.11 in chips)
Seat 4: max21rus1988 ($50 in chips)
Seat 5: G.Andrei95 ($61.36 in chips)
Seat 6: Rezzonner ($58.33 in chips)
Straubje: posts small blind $0.25
Becks Baker: posts big blind $0.50
*** HOLE CARDS ***
vovvesvart: raises $0.50 to $1
max21rus1988: folds
G.Andrei95: folds
Rezzonner: folds
Straubje: calls $0.75
Becks Baker: folds
*** FLOP *** [Ts Kc 8c]
Straubje: bets $1.50
vovvesvart: calls $1.50
*** TURN *** [Ts Kc 8c] [3c]
Straubje: bets $3.50
vovvesvart: folds
Uncalled bet ($3.50) returned to Straubje
Straubje collected $5.22 from pot
Straubje: doesn't show hand
*** SUMMARY ***
Total pot $5.50 | Rake $0.28
Board [Ts Kc 8c 3c]
Seat 1: Straubje (small blind) collected ($5.22)
Seat 2: Becks Baker (big blind) folded before Flop
Seat 3: vovvesvart folded on the Turn
Seat 4: max21rus1988 folded before Flop (didn't bet)
Seat 5: G.Andrei95 folded before Flop (didn't bet)
Seat 6: Rezzonner (button) folded before Flop (didn't bet)


PokerStars Hand #208960236150:  Hold'em No Limit ($0.25/$0.50 USD) - 2020/02/07 20:52:22 ET
Table 'Bohmia IV' 6-max Seat #5 is the button
Seat 1: Straubje ($49 in chips)
Seat 2: Becks Baker ($50 in chips)
Seat 3: vovvesvart ($186.61 in chips)
Seat 4: max21rus1988 ($50 in chips)
Seat 5: G.Andrei95 ($61.36 in chips)
Seat 6: Rezzonner ($58.58 in chips)
Rezzonner: posts small blind $0.25
Straubje: posts big blind $0.50
*** HOLE CARDS ***
Becks Baker: folds
vovvesvart: raises $1 to $1.50
max21rus1988: folds
G.Andrei95: folds
Rezzonner: folds
Straubje: raises $2 to $3.50
vovvesvart: calls $2
*** FLOP *** [2d Jc Qh]
Straubje: bets $4.50
vovvesvart: folds
Uncalled bet ($4.50) returned to Straubje
Straubje collected $6.89 from pot
Straubje: doesn't show hand
*** SUMMARY ***
Total pot $7.25 | Rake $0.36
Board [2d Jc Qh]
Seat 1: Straubje (big blind) collected ($6.89)
Seat 2: Becks Baker folded before Flop (didn't bet)
Seat 3: vovvesvart folded on the Flop
Seat 4: max21rus1988 folded before Flop (didn't bet)
Seat 5: G.Andrei95 (button) folded before Flop (didn't bet)
Seat 6: Rezzonner (small blind) folded before Flop


PokerStars Hand #208960259532:  Hold'em No Limit ($0.25/$0.50 USD) - 2020/02/07 20:53:38 ET
Table 'Bohmia IV' 6-max Seat #2 is the button
Seat 1: Straubje ($55.11 in chips)
Seat 2: Becks Baker ($50 in chips)
Seat 3: vovvesvart ($180.11 in chips)
Seat 4: max21rus1988 ($50.75 in chips)
Seat 5: G.Andrei95 ($61.36 in chips)
Seat 6: Rezzonner ($58.33 in chips)
vovvesvart: posts small blind $0.25
max21rus1988: posts big blind $0.50
*** HOLE CARDS ***
G.Andrei95: folds
Rezzonner: folds
Straubje: calls $0.50
Becks Baker: folds
vovvesvart: calls $0.25
max21rus1988: checks
*** FLOP *** [Ks Kc 4s]
vovvesvart: checks
max21rus1988: checks
Straubje: bets $1.50
vovvesvart: folds
max21rus1988: calls $1.50
*** TURN *** [Ks Kc 4s] [Qc]
max21rus1988: checks
Straubje: checks
*** RIVER *** [Ks Kc 4s Qc] [Ac]
max21rus1988: checks
Straubje: checks
*** SHOW DOWN ***
max21rus1988: shows [Qs 7s] (two pair, Kings and Queens)
Straubje: shows [Jc 4c] (a flush, Ace high)
Straubje collected $4.28 from pot
*** SUMMARY ***
Total pot $4.50 | Rake $0.22
Board [Ks Kc 4s Qc Ac]
Seat 1: Straubje showed [Jc 4c] and won ($4.28) with a flush, Ace high
Seat 2: Becks Baker (button) folded before Flop (didn't bet)
Seat 3: vovvesvart (small blind) folded on the Flop
Seat 4: max21rus1988 (big blind) showed [Qs 7s] and lost with two pair, Kings and Queens
Seat 5: G.Andrei95 folded before Flop (didn't bet)
Seat 6: Rezzonner folded before Flop (didn't bet)


PokerStars Hand #208960270844:  Hold'em No Limit ($0.25/$0.50 USD) - 2020/02/07 20:54:16 ET
Table 'Bohmia IV' 6-max Seat #3 is the button
Seat 1: Straubje ($57.39 in chips)
Seat 2: Becks Baker ($50 in chips)
Seat 3: vovvesvart ($179.61 in chips)
Seat 4: max21rus1988 ($50 in chips)
Seat 5: G.Andrei95 ($61.36 in chips)
Seat 6: Rezzonner ($58.33 in chips)
max21rus1988: posts small blind $0.25
G.Andrei95: posts big blind $0.50
*** HOLE CARDS ***
Rezzonner: folds
Straubje: raises $1.50 to $2
Becks Baker: folds
vovvesvart: calls $2
max21rus1988: calls $1.75
G.Andrei95: folds
*** FLOP *** [Ac 7h Jc]
max21rus1988: checks
Straubje: checks
vovvesvart: checks
*** TURN *** [Ac 7h Jc] [As]
max21rus1988: bets $4.64
Straubje: calls $4.64
vovvesvart: calls $4.64
*** RIVER *** [Ac 7h Jc As] [6h]
max21rus1988: bets $9.70
Straubje: folds
vovvesvart: folds
Uncalled bet ($9.70) returned to max21rus1988
max21rus1988 collected $19.40 from pot
max21rus1988: doesn't show hand
*** SUMMARY ***
Total pot $20.42 | Rake $1.02
Board [Ac 7h Jc As 6h]
Seat 1: Straubje folded on the River
Seat 2: Becks Baker folded before Flop (didn't bet)
Seat 3: vovvesvart (button) folded on the River
Seat 4: max21rus1988 (small blind) collected ($19.40)
Seat 5: G.Andrei95 (big blind) folded before Flop
Seat 6: Rezzonner folded before Flop (didn't bet)


PokerStars Hand #208960297041:  Hold'em No Limit ($0.25/$0.50 USD) - 2020/02/07 20:55:48 ET
Table 'Bohmia IV' 6-max Seat #5 is the button
Seat 1: Straubje ($4.51 in chips)
Seat 2: Becks Baker ($50 in chips)
Seat 3: vovvesvart ($222.47 in chips)
Seat 4: max21rus1988 ($62.76 in chips)
Seat 5: G.Andrei95 ($60.61 in chips)
Seat 6: Rezzonner ($57.83 in chips)
Rezzonner: posts small blind $0.25
Straubje: posts big blind $0.50
*** HOLE CARDS ***
Becks Baker: raises $0.75 to $1.25
vovvesvart: raises $1.25 to $2.50
max21rus1988: folds
G.Andrei95: folds
Rezzonner: folds
Straubje: calls $2
Becks Baker: calls $1.25
*** FLOP *** [5s 7s Qs]
Straubje: bets $2.01 and is all-in
Becks Baker: folds
vovvesvart: calls $2.01
*** TURN *** [5s 7s Qs] [4s]
*** RIVER *** [5s 7s Qs 4s] [4d]
*** SHOW DOWN ***
Straubje: shows [Jc 9s] (a flush, Queen high)
vovvesvart: shows [2s Ks] (a flush, King high)
vovvesvart collected $11.18 from pot
*** SUMMARY ***
Total pot $11.77 | Rake $0.59
Board [5s 7s Qs 4s 4d]
Seat 1: Straubje (big blind) showed [Jc 9s] and lost with a flush, Queen high
Seat 2: Becks Baker folded on the Flop
Seat 3: vovvesvart showed [2s Ks] and won ($11.18) with a flush, King high
Seat 4: max21rus1988 folded before Flop (didn't bet)
Seat 5: G.Andrei95 (button) folded before Flop (didn't bet)
Seat 6: Rezzonner (small blind) folded before Flop


PokerStars Hand #208960283930:  Hold'em No Limit ($0.25/$0.50 USD) - 2020/02/07 20:54:59 ET
Table 'Bohmia IV' 6-max Seat #4 is the button
Seat 1: Straubje ($50.75 in chips)
Seat 2: Becks Baker ($50 in chips)
Seat 3: vovvesvart ($172.97 in chips)
Seat 4: max21rus1988 ($62.76 in chips)
Seat 5: G.Andrei95 ($60.86 in chips)
Seat 6: Rezzonner ($58.33 in chips)
G.Andrei95: posts small blind $0.25
Rezzonner: posts big blind $0.50
*** HOLE CARDS ***
Straubje: raises $1.50 to $2
Becks Baker: folds
vovvesvart: calls $2
max21rus1988: folds
G.Andrei95: folds
Rezzonner: folds
*** FLOP *** [5h 2h Kd]
Straubje: bets $3.50
vovvesvart: calls $3.50
*** TURN *** [5h 2h Kd] [5d]
Straubje: bets $13
vovvesvart: raises $154.47 to $167.47 and is all-in
Straubje: calls $32.25 and is all-in
Uncalled bet ($122.22) returned to vovvesvart
*** RIVER *** [5h 2h Kd 5d] [3h]
*** SHOW DOWN ***
Straubje: shows [Qd Kh] (two pair, Kings and Fives)
vovvesvart: shows [5s 8h] (three of a kind, Fives)
vovvesvart collected $100.25 from pot
Straubje cashed out the hand for $4.51 | Cash Out Fee $0.05
*** SUMMARY ***
Total pot $102.25 | Rake $2
Board [5h 2h Kd 5d 3h]
Seat 1: Straubje showed [Qd Kh] and lost with two pair, Kings and Fives (cashed out).
Seat 2: Becks Baker folded before Flop (didn't bet)
Seat 3: vovvesvart showed [5s 8h] and won ($100.25) with three of a kind, Fives
Seat 4: max21rus1988 (button) folded before Flop (didn't bet)
Seat 5: G.Andrei95 (small blind) folded before Flop
Seat 6: Rezzonner (big blind) folded before Flop


PokerStars Hand #208960306531:  Hold'em No Limit ($0.25/$0.50 USD) - 2020/02/07 20:56:25 ET
Table 'Bohmia IV' 6-max Seat #6 is the button
Seat 1: Straubje ($23.07 in chips)
Seat 2: Becks Baker ($50 in chips)
Seat 3: vovvesvart ($229.14 in chips)
Seat 5: G.Andrei95 ($60.61 in chips)
Seat 6: Rezzonner ($57.58 in chips)
Straubje: posts small blind $0.25
Becks Baker: posts big blind $0.50
*** HOLE CARDS ***
vovvesvart: raises $1 to $1.50
G.Andrei95: folds
Rezzonner: folds
Straubje: calls $1.25
Becks Baker: raises $5.75 to $7.25
vovvesvart: calls $5.75
Straubje: folds
*** FLOP *** [5h 9c 9d]
Becks Baker: checks
vovvesvart: checks
*** TURN *** [5h 9c 9d] [8s]
Becks Baker: bets $5.02
vovvesvart: calls $5.02
*** RIVER *** [5h 9c 9d 8s] [5c]
Becks Baker: checks
vovvesvart: bets $216.87 and is all-in
Becks Baker: calls $37.73 and is all-in
Uncalled bet ($179.14) returned to vovvesvart
*** SHOW DOWN ***
vovvesvart: shows [2h 2d] (two pair, Nines and Fives)
Becks Baker: shows [Kd Ad] (two pair, Nines and Fives - Ace kicker)
Becks Baker collected $99.50 from pot
*** SUMMARY ***
Total pot $101.50 | Rake $2
Board [5h 9c 9d 8s 5c]
Seat 1: Straubje (small blind) folded before Flop
Seat 2: Becks Baker (big blind) showed [Kd Ad] and won ($99.50) with two pair, Nines and Fives
Seat 3: vovvesvart showed [2h 2d] and lost with two pair, Nines and Fives
Seat 5: G.Andrei95 folded before Flop (didn't bet)
Seat 6: Rezzonner (button) folded before Flop (didn't bet)


PokerStars Hand #208960339843:  Hold'em No Limit ($0.25/$0.50 USD) - 2020/02/07 20:58:03 ET
Table 'Bohmia IV' 6-max Seat #1 is the button
Seat 1: Straubje ($50 in chips)
Seat 2: Becks Baker ($99.50 in chips)
Seat 3: vovvesvart ($179.14 in chips)
Seat 5: G.Andrei95 ($60.61 in chips)
Seat 6: Rezzonner ($57.58 in chips)
Becks Baker: posts small blind $0.25
vovvesvart: posts big blind $0.50
*** HOLE CARDS ***
G.Andrei95: folds
Rezzonner: folds
Straubje: raises $1.50 to $2
Becks Baker: folds
vovvesvart: calls $1.50
*** FLOP *** [7s Ts Tc]
vovvesvart: checks
Straubje: checks
*** TURN *** [7s Ts Tc] [5h]
vovvesvart: checks
Straubje: checks
*** RIVER *** [7s Ts Tc 5h] [Kh]
vovvesvart: checks
Straubje: bets $4.50
vovvesvart: folds
Uncalled bet ($4.50) returned to Straubje
Straubje collected $4.04 from pot
Straubje: doesn't show hand
*** SUMMARY ***
Total pot $4.25 | Rake $0.21
Board [7s Ts Tc 5h Kh]
Seat 1: Straubje (button) collected ($4.04)
Seat 2: Becks Baker (small blind) folded before Flop
Seat 3: vovvesvart (big blind) folded on the River
Seat 5: G.Andrei95 folded before Flop (didn't bet)
Seat 6: Rezzonner folded before Flop (didn't bet)


PokerStars Hand #208960348135:  Hold'em No Limit ($0.25/$0.50 USD) - 2020/02/07 20:58:35 ET
Table 'Bohmia IV' 6-max Seat #2 is the button
Seat 1: Straubje ($52.04 in chips)
Seat 2: Becks Baker ($99.25 in chips)
Seat 3: vovvesvart ($177.14 in chips)
Seat 5: G.Andrei95 ($60.61 in chips)
Seat 6: Rezzonner ($57.58 in chips)
vovvesvart: posts small blind $0.25
G.Andrei95: posts big blind $0.50
*** HOLE CARDS ***
Rezzonner: folds
Straubje: calls $0.50
Becks Baker: calls $0.50
vovvesvart: calls $0.25
G.Andrei95: checks
*** FLOP *** [Th 2d 4c]
vovvesvart: bets $0.95
G.Andrei95: folds
Straubje: folds
Becks Baker: folds
Uncalled bet ($0.95) returned to vovvesvart
vovvesvart collected $1.90 from pot
vovvesvart: doesn't show hand
*** SUMMARY ***
Total pot $2 | Rake $0.10
Board [Th 2d 4c]
Seat 1: Straubje folded on the Flop
Seat 2: Becks Baker (button) folded on the Flop
Seat 3: vovvesvart (small blind) collected ($1.90)
Seat 5: G.Andrei95 (big blind) folded on the Flop
Seat 6: Rezzonner folded before Flop (didn't bet)


PokerStars Hand #208960357740:  Hold'em No Limit ($0.25/$0.50 USD) - 2020/02/07 20:59:12 ET
Table 'Bohmia IV' 6-max Seat #3 is the button
Seat 1: Straubje ($51.54 in chips)
Seat 2: Becks Baker ($98.75 in chips)
Seat 3: vovvesvart ($178.54 in chips)
Seat 5: G.Andrei95 ($60.11 in chips)
Seat 6: Rezzonner ($57.58 in chips)
G.Andrei95: posts small blind $0.25
Rezzonner: posts big blind $0.50
*** HOLE CARDS ***
Straubje: folds
Becks Baker: raises $0.75 to $1.25
vovvesvart: calls $1.25
G.Andrei95: folds
Rezzonner: folds
*** FLOP *** [3c Th 5c]
Becks Baker: checks
vovvesvart: bets $1.55
Becks Baker: calls $1.55
*** TURN *** [3c Th 5c] [Qs]
Becks Baker: checks
vovvesvart: checks
*** RIVER *** [3c Th 5c Qs] [2s]
Becks Baker: bets $1.99
vovvesvart: calls $1.99
*** SHOW DOWN ***
Becks Baker: shows [Ts Kd] (a pair of Tens)
vovvesvart: mucks hand
Becks Baker collected $9.81 from pot
*** SUMMARY ***
Total pot $10.33 | Rake $0.52
Board [3c Th 5c Qs 2s]
Seat 1: Straubje folded before Flop (didn't bet)
Seat 2: Becks Baker showed [Ts Kd] and won ($9.81) with a pair of Tens
Seat 3: vovvesvart (button) mucked
Seat 5: G.Andrei95 (small blind) folded before Flop
Seat 6: Rezzonner (big blind) folded before Flop


PokerStars Hand #208960386275:  Hold'em No Limit ($0.25/$0.50 USD) - 2020/02/07 21:01:00 ET
Table 'Bohmia IV' 6-max Seat #6 is the button
Seat 2: Becks Baker ($103.77 in chips)
Seat 3: vovvesvart ($174.50 in chips)
Seat 5: G.Andrei95 ($59.86 in chips)
Seat 6: Rezzonner ($56.83 in chips)
Becks Baker: posts small blind $0.25
vovvesvart: posts big blind $0.50
max21rus1988: sits out
*** HOLE CARDS ***
G.Andrei95: folds
Rezzonner: folds
Becks Baker: folds
Uncalled bet ($0.25) returned to vovvesvart
vovvesvart collected $0.50 from pot
vovvesvart: doesn't show hand
*** SUMMARY ***
Total pot $0.50 | Rake $0
Seat 2: Becks Baker (small blind) folded before Flop
Seat 3: vovvesvart (big blind) collected ($0.50)
Seat 5: G.Andrei95 folded before Flop (didn't bet)
Seat 6: Rezzonner (button) folded before Flop (didn't bet)


PokerStars Hand #208960371285:  Hold'em No Limit ($0.25/$0.50 USD) - 2020/02/07 21:00:04 ET
Table 'Bohmia IV' 6-max Seat #5 is the button
Seat 1: Straubje ($51.54 in chips)
Seat 2: Becks Baker ($103.77 in chips)
Seat 3: vovvesvart ($173.75 in chips)
Seat 5: G.Andrei95 ($59.86 in chips)
Seat 6: Rezzonner ($57.08 in chips)
Rezzonner: posts small blind $0.25
Straubje: posts big blind $0.50
*** HOLE CARDS ***
Becks Baker: folds
vovvesvart: raises $1 to $1.50
G.Andrei95: folds
Rezzonner: folds
Straubje is disconnected
Straubje has timed out while disconnected
Straubje: folds
Uncalled bet ($1) returned to vovvesvart
vovvesvart collected $1.25 from pot
vovvesvart: doesn't show hand
*** SUMMARY ***
Total pot $1.25 | Rake $0
Seat 1: Straubje (big blind) folded before Flop
Seat 2: Becks Baker folded before Flop (didn't bet)
Seat 3: vovvesvart collected ($1.25)
Seat 5: G.Andrei95 (button) folded before Flop (didn't bet)
Seat 6: Rezzonner (small blind) folded before Flop


PokerStars Hand #208960399717:  Hold'em No Limit ($0.25/$0.50 USD) - 2020/02/07 21:01:46 ET
Table 'Bohmia IV' 6-max Seat #3 is the button
Seat 2: Becks Baker ($103.52 in chips)
Seat 3: vovvesvart ($176.10 in chips)
Seat 4: max21rus1988 ($61.26 in chips)
Seat 5: G.Andrei95 ($59.86 in chips)
Seat 6: Rezzonner ($56.83 in chips)
max21rus1988: posts small blind $0.25
G.Andrei95: posts big blind $0.50
*** HOLE CARDS ***
Rezzonner: folds
Becks Baker: folds
vovvesvart: raises $1.25 to $1.75
max21rus1988: folds
G.Andrei95: calls $1.25
*** FLOP *** [7c Kh Ts]
G.Andrei95: checks
vovvesvart: bets $1.78
G.Andrei95: folds
Uncalled bet ($1.78) returned to vovvesvart
vovvesvart collected $3.56 from pot
vovvesvart: doesn't show hand
*** SUMMARY ***
Total pot $3.75 | Rake $0.19
Board [7c Kh Ts]
Seat 2: Becks Baker folded before Flop (didn't bet)
Seat 3: vovvesvart (button) collected ($3.56)
Seat 4: max21rus1988 (small blind) folded before Flop
Seat 5: G.Andrei95 (big blind) folded on the Flop
Seat 6: Rezzonner folded before Flop (didn't bet)


PokerStars Hand #208960388576:  Hold'em No Limit ($0.25/$0.50 USD) - 2020/02/07 21:01:08 ET
Table 'Bohmia IV' 6-max Seat #2 is the button
Seat 2: Becks Baker ($103.52 in chips)
Seat 3: vovvesvart ($174.75 in chips)
Seat 4: max21rus1988 ($62.76 in chips)
Seat 5: G.Andrei95 ($59.86 in chips)
Seat 6: Rezzonner ($56.83 in chips)
vovvesvart: posts small blind $0.25
max21rus1988: posts big blind $0.50
*** HOLE CARDS ***
G.Andrei95: folds
Rezzonner: folds
Becks Baker: folds
vovvesvart: raises $1 to $1.50
max21rus1988: calls $1
*** FLOP *** [Jc Ad Kc]
vovvesvart: bets $1.43
max21rus1988: folds
Uncalled bet ($1.43) returned to vovvesvart
vovvesvart collected $2.85 from pot
vovvesvart: doesn't show hand
*** SUMMARY ***
Total pot $3 | Rake $0.15
Board [Jc Ad Kc]
Seat 2: Becks Baker (button) folded before Flop (didn't bet)
Seat 3: vovvesvart (small blind) collected ($2.85)
Seat 4: max21rus1988 (big blind) folded on the Flop
Seat 5: G.Andrei95 folded before Flop (didn't bet)
Seat 6: Rezzonner folded before Flop (didn't bet)


PokerStars Hand #208960417514:  Hold'em No Limit ($0.25/$0.50 USD) - 2020/02/07 21:02:46 ET
Table 'Bohmia IV' 6-max Seat #5 is the button
Seat 1: Straubje ($51.04 in chips)
Seat 2: Becks Baker ($103.52 in chips)
Seat 3: vovvesvart ($180.20 in chips)
Seat 4: max21rus1988 ($59.26 in chips)
Seat 5: G.Andrei95 ($57.86 in chips)
Seat 6: Rezzonner ($56.33 in chips)
Rezzonner: posts small blind $0.25
Straubje: posts big blind $0.50
*** HOLE CARDS ***
Becks Baker: folds
vovvesvart: raises $0.50 to $1
max21rus1988: folds
G.Andrei95: folds
Rezzonner: calls $0.75
Straubje: calls $0.50
*** FLOP *** [2s Tc 9h]
Rezzonner: checks
Straubje: bets $2
vovvesvart: raises $177.20 to $179.20 and is all-in
Rezzonner: folds
Straubje: folds
Uncalled bet ($177.20) returned to vovvesvart
vovvesvart collected $6.65 from pot
vovvesvart: doesn't show hand
*** SUMMARY ***
Total pot $7 | Rake $0.35
Board [2s Tc 9h]
Seat 1: Straubje (big blind) folded on the Flop
Seat 2: Becks Baker folded before Flop (didn't bet)
Seat 3: vovvesvart collected ($6.65)
Seat 4: max21rus1988 folded before Flop (didn't bet)
Seat 5: G.Andrei95 (button) folded before Flop (didn't bet)
Seat 6: Rezzonner (small blind) folded on the Flop


PokerStars Hand #208960406475:  Hold'em No Limit ($0.25/$0.50 USD) - 2020/02/07 21:02:09 ET
Table 'Bohmia IV' 6-max Seat #4 is the button
Seat 2: Becks Baker ($103.52 in chips)
Seat 3: vovvesvart ($177.91 in chips)
Seat 4: max21rus1988 ($61.01 in chips)
Seat 5: G.Andrei95 ($58.11 in chips)
Seat 6: Rezzonner ($56.83 in chips)
G.Andrei95: posts small blind $0.25
Rezzonner: posts big blind $0.50
Straubje: sits out
*** HOLE CARDS ***
Becks Baker: folds
vovvesvart: raises $1.25 to $1.75
max21rus1988: calls $1.75
G.Andrei95: folds
Rezzonner: folds
*** FLOP *** [7d 7s 6h]
vovvesvart: bets $2.02
max21rus1988: folds
Uncalled bet ($2.02) returned to vovvesvart
vovvesvart collected $4.04 from pot
vovvesvart: doesn't show hand
*** SUMMARY ***
Total pot $4.25 | Rake $0.21
Board [7d 7s 6h]
Seat 2: Becks Baker folded before Flop (didn't bet)
Seat 3: vovvesvart collected ($4.04)
Seat 4: max21rus1988 (button) folded on the Flop
Seat 5: G.Andrei95 (small blind) folded before Flop
Seat 6: Rezzonner (big blind) folded before Flop


PokerStars Hand #208960428209:  Hold'em No Limit ($0.25/$0.50 USD) - 2020/02/07 21:03:23 ET
Table 'Bohmia IV' 6-max Seat #6 is the button
Seat 1: Straubje ($48.04 in chips)
Seat 2: Becks Baker ($103.52 in chips)
Seat 3: vovvesvart ($183.85 in chips)
Seat 4: max21rus1988 ($59.26 in chips)
Seat 5: G.Andrei95 ($57.86 in chips)
Seat 6: Rezzonner ($55.33 in chips)
Straubje: posts small blind $0.25
Becks Baker: posts big blind $0.50
*** HOLE CARDS ***
vovvesvart: raises $0.50 to $1
max21rus1988: folds
G.Andrei95: folds
Rezzonner: folds
Straubje: calls $0.75
Becks Baker: calls $0.50
*** FLOP *** [9s 7d Qc]
Straubje: checks
Becks Baker: checks
vovvesvart: checks
*** TURN *** [9s 7d Qc] [Td]
Straubje: checks
Becks Baker: checks
vovvesvart: checks
*** RIVER *** [9s 7d Qc Td] [Js]
Straubje: checks
Becks Baker: checks
vovvesvart: checks
*** SHOW DOWN ***
Straubje: shows [3h 5c] (high card Queen)
Becks Baker: shows [Ad 6d] (high card Ace)
vovvesvart: shows [As 5s] (high card Ace)
Becks Baker collected $1.43 from pot
vovvesvart collected $1.42 from pot
*** SUMMARY ***
Total pot $3 | Rake $0.15
Board [9s 7d Qc Td Js]
Seat 1: Straubje (small blind) showed [3h 5c] and lost with high card Queen
Seat 2: Becks Baker (big blind) showed [Ad 6d] and won ($1.43) with high card Ace
Seat 3: vovvesvart showed [As 5s] and won ($1.42) with high card Ace
Seat 4: max21rus1988 folded before Flop (didn't bet)
Seat 5: G.Andrei95 folded before Flop (didn't bet)
Seat 6: Rezzonner (button) folded before Flop (didn't bet)


PokerStars Hand #208960442685:  Hold'em No Limit ($0.25/$0.50 USD) - 2020/02/07 21:04:12 ET
Table 'Bohmia IV' 6-max Seat #1 is the button
Seat 1: Straubje ($47.04 in chips)
Seat 2: Becks Baker ($103.95 in chips)
Seat 3: vovvesvart ($184.27 in chips)
Seat 4: max21rus1988 ($59.26 in chips)
Seat 5: G.Andrei95 ($57.86 in chips)
Seat 6: Rezzonner ($55.33 in chips)
Becks Baker: posts small blind $0.25
vovvesvart: posts big blind $0.50
*** HOLE CARDS ***
max21rus1988: folds
G.Andrei95: folds
Rezzonner: folds
Straubje has timed out
Straubje: folds
Becks Baker: raises $1 to $1.50
Straubje is disconnected
vovvesvart: calls $1
*** FLOP *** [5c Qc 9c]
Becks Baker: checks
vovvesvart: checks
*** TURN *** [5c Qc 9c] [3h]
Becks Baker: bets $2.10
vovvesvart: raises $2.10 to $4.20
Becks Baker: calls $2.10
*** RIVER *** [5c Qc 9c 3h] [8d]
Becks Baker: checks
vovvesvart: checks
*** SHOW DOWN ***
Becks Baker: shows [Qh Kd] (a pair of Queens)
vovvesvart: mucks hand
Becks Baker collected $10.83 from pot
*** SUMMARY ***
Total pot $11.40 | Rake $0.57
Board [5c Qc 9c 3h 8d]
Seat 1: Straubje (button) folded before Flop (didn't bet)
Seat 2: Becks Baker (small blind) showed [Qh Kd] and won ($10.83) with a pair of Queens
Seat 3: vovvesvart (big blind) mucked
Seat 4: max21rus1988 folded before Flop (didn't bet)
Seat 5: G.Andrei95 folded before Flop (didn't bet)
Seat 6: Rezzonner folded before Flop (didn't bet)


PokerStars Hand #208960474095:  Hold'em No Limit ($0.25/$0.50 USD) - 2020/02/07 21:05:53 ET
Table 'Bohmia IV' 6-max Seat #3 is the button
Seat 1: Straubje ($28.19 in chips)
Seat 2: Becks Baker ($109.08 in chips)
Seat 3: vovvesvart ($176.07 in chips)
Seat 4: max21rus1988 ($78.61 in chips)
Seat 5: G.Andrei95 ($57.86 in chips)
Seat 6: Rezzonner ($55.33 in chips)
max21rus1988: posts small blind $0.25
G.Andrei95: posts big blind $0.50
*** HOLE CARDS ***
Rezzonner: folds
Straubje: calls $0.50
Becks Baker: folds
vovvesvart: raises $1.75 to $2.25
max21rus1988: folds
G.Andrei95: raises $6 to $8.25
Straubje: folds
vovvesvart: folds
Uncalled bet ($6) returned to G.Andrei95
G.Andrei95 collected $5.25 from pot
G.Andrei95: doesn't show hand
*** SUMMARY ***
Total pot $5.25 | Rake $0
Seat 1: Straubje folded before Flop
Seat 2: Becks Baker folded before Flop (didn't bet)
Seat 3: vovvesvart (button) folded before Flop
Seat 4: max21rus1988 (small blind) folded before Flop
Seat 5: G.Andrei95 (big blind) collected ($5.25)
Seat 6: Rezzonner folded before Flop (didn't bet)


PokerStars Hand #208960462101:  Hold'em No Limit ($0.25/$0.50 USD) - 2020/02/07 21:05:16 ET
Table 'Bohmia IV' 6-max Seat #2 is the button
Seat 1: Straubje ($47.04 in chips)
Seat 2: Becks Baker ($109.08 in chips)
Seat 3: vovvesvart ($178.57 in chips)
Seat 4: max21rus1988 ($59.26 in chips)
Seat 5: G.Andrei95 ($57.86 in chips)
Seat 6: Rezzonner ($55.33 in chips)
vovvesvart: posts small blind $0.25
max21rus1988: posts big blind $0.50
*** HOLE CARDS ***
G.Andrei95: folds
Rezzonner: folds
Straubje: calls $0.50
Becks Baker: folds
vovvesvart: calls $0.25
max21rus1988: raises $2 to $2.50
Straubje: calls $2
vovvesvart: calls $2
*** FLOP *** [3d 6h 6s]
vovvesvart: checks
max21rus1988: bets $2.35
Straubje: calls $2.35
vovvesvart: folds
*** TURN *** [3d 6h 6s] [3s]
max21rus1988: checks
Straubje: bets $4.50
max21rus1988: calls $4.50
*** RIVER *** [3d 6h 6s 3s] [Kh]
max21rus1988: checks
Straubje: bets $9.50
max21rus1988: calls $9.50
*** SHOW DOWN ***
Straubje: shows [7c Jh] (two pair, Sixes and Threes)
max21rus1988: shows [8h 8c] (two pair, Eights and Sixes)
max21rus1988 collected $38.20 from pot
*** SUMMARY ***
Total pot $40.20 | Rake $2
Board [3d 6h 6s 3s Kh]
Seat 1: Straubje showed [7c Jh] and lost with two pair, Sixes and Threes
Seat 2: Becks Baker (button) folded before Flop (didn't bet)
Seat 3: vovvesvart (small blind) folded on the Flop
Seat 4: max21rus1988 (big blind) showed [8h 8c] and won ($38.20) with two pair, Eights and Sixes
Seat 5: G.Andrei95 folded before Flop (didn't bet)
Seat 6: Rezzonner folded before Flop (didn't bet)


PokerStars Hand #208960484013:  Hold'em No Limit ($0.25/$0.50 USD) - 2020/02/07 21:06:27 ET
Table 'Bohmia IV' 6-max Seat #4 is the button
Seat 1: Straubje ($27.69 in chips)
Seat 2: Becks Baker ($109.08 in chips)
Seat 3: vovvesvart ($173.82 in chips)
Seat 4: max21rus1988 ($78.36 in chips)
Seat 5: G.Andrei95 ($60.86 in chips)
Seat 6: Rezzonner ($55.33 in chips)
G.Andrei95: posts small blind $0.25
Rezzonner: posts big blind $0.50
*** HOLE CARDS ***
Straubje: folds
Becks Baker: raises $0.75 to $1.25
vovvesvart: raises $3.25 to $4.50
max21rus1988: folds
G.Andrei95: folds
Rezzonner: folds
Becks Baker: raises $7 to $11.50
vovvesvart: raises $162.32 to $173.82 and is all-in
Becks Baker: folds
Uncalled bet ($162.32) returned to vovvesvart
vovvesvart collected $23.75 from pot
vovvesvart: doesn't show hand
*** SUMMARY ***
Total pot $23.75 | Rake $0
Seat 1: Straubje folded before Flop (didn't bet)
Seat 2: Becks Baker folded before Flop
Seat 3: vovvesvart collected ($23.75)
Seat 4: max21rus1988 (button) folded before Flop (didn't bet)
Seat 5: G.Andrei95 (small blind) folded before Flop
Seat 6: Rezzonner (big blind) folded before Flop


PokerStars Hand #208960506138:  Hold'em No Limit ($0.25/$0.50 USD) - 2020/02/07 21:07:11 ET
Table 'Bohmia IV' 6-max Seat #5 is the button
Seat 2: Becks Baker ($97.58 in chips)
Seat 3: vovvesvart ($186.07 in chips)
Seat 4: max21rus1988 ($78.36 in chips)
Seat 5: G.Andrei95 ($60.61 in chips)
Seat 6: Rezzonner ($54.83 in chips)
Rezzonner: posts small blind $0.25
Straubje has timed out
Straubje: is sitting out
Becks Baker: posts big blind $0.50
*** HOLE CARDS ***
vovvesvart: raises $1.25 to $1.75
max21rus1988: folds
G.Andrei95: folds
Rezzonner: folds
Becks Baker: folds
Uncalled bet ($1.25) returned to vovvesvart
Straubje is disconnected
vovvesvart collected $1.25 from pot
vovvesvart: doesn't show hand
*** SUMMARY ***
Total pot $1.25 | Rake $0
Seat 2: Becks Baker (big blind) folded before Flop
Seat 3: vovvesvart collected ($1.25)
Seat 4: max21rus1988 folded before Flop (didn't bet)
Seat 5: G.Andrei95 (button) folded before Flop (didn't bet)
Seat 6: Rezzonner (small blind) folded before Flop


PokerStars Hand #208960514331:  Hold'em No Limit ($0.25/$0.50 USD) - 2020/02/07 21:07:39 ET
Table 'Bohmia IV' 6-max Seat #6 is the button
Seat 2: Becks Baker ($97.08 in chips)
Seat 3: vovvesvart ($186.82 in chips)
Seat 4: max21rus1988 ($78.36 in chips)
Seat 5: G.Andrei95 ($60.61 in chips)
Seat 6: Rezzonner ($54.58 in chips)
Becks Baker: posts small blind $0.25
vovvesvart: posts big blind $0.50
*** HOLE CARDS ***
max21rus1988: folds
G.Andrei95: raises $0.75 to $1.25
Rezzonner: folds
Becks Baker: folds
vovvesvart: calls $0.75
*** FLOP *** [Kc 2c 5h]
vovvesvart: checks
G.Andrei95: bets $0.86
vovvesvart: raises $4.33 to $5.19
G.Andrei95: folds
Uncalled bet ($4.33) returned to vovvesvart
vovvesvart collected $4.25 from pot
vovvesvart: doesn't show hand
*** SUMMARY ***
Total pot $4.47 | Rake $0.22
Board [Kc 2c 5h]
Seat 2: Becks Baker (small blind) folded before Flop
Seat 3: vovvesvart (big blind) collected ($4.25)
Seat 4: max21rus1988 folded before Flop (didn't bet)
Seat 5: G.Andrei95 folded on the Flop
Seat 6: Rezzonner (button) folded before Flop (didn't bet)


PokerStars Hand #208960524182:  Hold'em No Limit ($0.25/$0.50 USD) - 2020/02/07 21:08:13 ET
Table 'Bohmia IV' 6-max Seat #2 is the button
Seat 2: Becks Baker ($96.83 in chips)
Seat 3: vovvesvart ($188.96 in chips)
Seat 4: max21rus1988 ($78.36 in chips)
Seat 5: G.Andrei95 ($58.50 in chips)
Seat 6: Rezzonner ($54.58 in chips)
vovvesvart: posts small blind $0.25
max21rus1988: posts big blind $0.50
Straubje: sits out
*** HOLE CARDS ***
G.Andrei95: folds
Rezzonner: folds
Becks Baker: raises $0.75 to $1.25
vovvesvart: calls $1
max21rus1988: folds
*** FLOP *** [4h 2c Js]
vovvesvart: checks
Becks Baker: bets $0.75
vovvesvart: calls $0.75
*** TURN *** [4h 2c Js] [2d]
vovvesvart: checks
Becks Baker: checks
*** RIVER *** [4h 2c Js 2d] [Qc]
vovvesvart: checks
Becks Baker: checks
*** SHOW DOWN ***
vovvesvart: shows [6h As] (a pair of Deuces)
Becks Baker: shows [4s Ad] (two pair, Fours and Deuces)
Becks Baker collected $4.28 from pot
*** SUMMARY ***
Total pot $4.50 | Rake $0.22
Board [4h 2c Js 2d Qc]
Seat 2: Becks Baker (button) showed [4s Ad] and won ($4.28) with two pair, Fours and Deuces
Seat 3: vovvesvart (small blind) showed [6h As] and lost with a pair of Deuces
Seat 4: max21rus1988 (big blind) folded before Flop
Seat 5: G.Andrei95 folded before Flop (didn't bet)
Seat 6: Rezzonner folded before Flop (didn't bet)


PokerStars Hand #208960533093:  Hold'em No Limit ($0.25/$0.50 USD) - 2020/02/07 21:08:43 ET
Table 'Bohmia IV' 6-max Seat #3 is the button
Seat 1: Straubje ($50 in chips)
Seat 2: Becks Baker ($99.11 in chips)
Seat 3: vovvesvart ($186.96 in chips)
Seat 4: max21rus1988 ($77.86 in chips)
Seat 5: G.Andrei95 ($58.50 in chips)
Seat 6: Rezzonner ($54.58 in chips)
max21rus1988: posts small blind $0.25
G.Andrei95: posts big blind $0.50
Straubje: posts small & big blinds $0.75
*** HOLE CARDS ***
Rezzonner: raises $1.50 to $2
Straubje: calls $1.50
Becks Baker: folds
vovvesvart: calls $2
max21rus1988: folds
G.Andrei95: folds
*** FLOP *** [5h 4s 3d]
Rezzonner: bets $3.62
Straubje: folds
vovvesvart: calls $3.62
*** TURN *** [5h 4s 3d] [9s]
Rezzonner: bets $8.12
vovvesvart: calls $8.12
*** RIVER *** [5h 4s 3d 9s] [2s]
Rezzonner: checks
vovvesvart: checks
*** SHOW DOWN ***
Rezzonner: shows [8c 8h] (a pair of Eights)
vovvesvart: mucks hand
Rezzonner collected $28.96 from pot
*** SUMMARY ***
Total pot $30.48 | Rake $1.52
Board [5h 4s 3d 9s 2s]
Seat 1: Straubje folded on the Flop
Seat 2: Becks Baker folded before Flop (didn't bet)
Seat 3: vovvesvart (button) mucked
Seat 4: max21rus1988 (small blind) folded before Flop
Seat 5: G.Andrei95 (big blind) folded before Flop
Seat 6: Rezzonner showed [8c 8h] and won ($28.96) with a pair of Eights


PokerStars Hand #208960554342:  Hold'em No Limit ($0.25/$0.50 USD) - 2020/02/07 21:09:55 ET
Table 'Bohmia IV' 6-max Seat #5 is the button
Seat 1: Straubje ($47.75 in chips)
Seat 2: Becks Baker ($99.11 in chips)
Seat 3: vovvesvart ($173.22 in chips)
Seat 4: max21rus1988 ($76.36 in chips)
Seat 5: G.Andrei95 ($57.75 in chips)
Seat 6: Rezzonner ($71.30 in chips)
Rezzonner: posts small blind $0.25
Straubje: posts big blind $0.50
*** HOLE CARDS ***
Becks Baker: folds
vovvesvart: raises $0.50 to $1
max21rus1988: folds
G.Andrei95: folds
Rezzonner: folds
Straubje: calls $0.50
*** FLOP *** [6c Qh 8d]
Straubje: checks
vovvesvart: checks
*** TURN *** [6c Qh 8d] [Js]
Straubje: checks
vovvesvart: checks
*** RIVER *** [6c Qh 8d Js] [4s]
Straubje: bets $2
vovvesvart: folds
Uncalled bet ($2) returned to Straubje
Straubje collected $2.14 from pot
Straubje: doesn't show hand
*** SUMMARY ***
Total pot $2.25 | Rake $0.11
Board [6c Qh 8d Js 4s]
Seat 1: Straubje (big blind) collected ($2.14)
Seat 2: Becks Baker folded before Flop (didn't bet)
Seat 3: vovvesvart folded on the River
Seat 4: max21rus1988 folded before Flop (didn't bet)
Seat 5: G.Andrei95 (button) folded before Flop (didn't bet)
Seat 6: Rezzonner (small blind) folded before Flop


PokerStars Hand #208960549141:  Hold'em No Limit ($0.25/$0.50 USD) - 2020/02/07 21:09:38 ET
Table 'Bohmia IV' 6-max Seat #4 is the button
Seat 1: Straubje ($47.75 in chips)
Seat 2: Becks Baker ($99.11 in chips)
Seat 3: vovvesvart ($173.22 in chips)
Seat 4: max21rus1988 ($77.61 in chips)
Seat 5: G.Andrei95 ($58 in chips)
Seat 6: Rezzonner ($69.80 in chips)
G.Andrei95: posts small blind $0.25
Rezzonner: posts big blind $0.50
*** HOLE CARDS ***
Straubje: folds
Becks Baker: folds
vovvesvart: folds
max21rus1988: raises $0.75 to $1.25
G.Andrei95: folds
Rezzonner: raises $3.75 to $5
max21rus1988: folds
Uncalled bet ($3.75) returned to Rezzonner
Rezzonner collected $2.75 from pot
Rezzonner: doesn't show hand
*** SUMMARY ***
Total pot $2.75 | Rake $0
Seat 1: Straubje folded before Flop (didn't bet)
Seat 2: Becks Baker folded before Flop (didn't bet)
Seat 3: vovvesvart folded before Flop (didn't bet)
Seat 4: max21rus1988 (button) folded before Flop
Seat 5: G.Andrei95 (small blind) folded before Flop
Seat 6: Rezzonner (big blind) collected ($2.75)


PokerStars Hand #208960572603:  Hold'em No Limit ($0.25/$0.50 USD) - 2020/02/07 21:10:58 ET
Table 'Bohmia IV' 6-max Seat #1 is the button
Seat 1: Straubje ($44.39 in chips)
Seat 2: Becks Baker ($98.61 in chips)
Seat 3: vovvesvart ($167.72 in chips)
Seat 4: max21rus1988 ($76.36 in chips)
Seat 5: G.Andrei95 ($66.55 in chips)
Seat 6: Rezzonner ($71.05 in chips)
Becks Baker: posts small blind $0.25
vovvesvart: posts big blind $0.50
*** HOLE CARDS ***
max21rus1988: raises $0.75 to $1.25
G.Andrei95: raises $2.75 to $4
Rezzonner: folds
Straubje: folds
Becks Baker: folds
vovvesvart: calls $3.50
max21rus1988: folds
*** FLOP *** [3h 5h 3c]
vovvesvart: checks
G.Andrei95: bets $8.25
vovvesvart: folds
Uncalled bet ($8.25) returned to G.Andrei95
G.Andrei95 collected $9.02 from pot
G.Andrei95: doesn't show hand
*** SUMMARY ***
Total pot $9.50 | Rake $0.48
Board [3h 5h 3c]
Seat 1: Straubje (button) folded before Flop (didn't bet)
Seat 2: Becks Baker (small blind) folded before Flop
Seat 3: vovvesvart (big blind) folded on the Flop
Seat 4: max21rus1988 folded before Flop
Seat 5: G.Andrei95 collected ($9.02)
Seat 6: Rezzonner folded before Flop (didn't bet)


PokerStars Hand #208960562137:  Hold'em No Limit ($0.25/$0.50 USD) - 2020/02/07 21:10:22 ET
Table 'Bohmia IV' 6-max Seat #6 is the button
Seat 1: Straubje ($48.89 in chips)
Seat 2: Becks Baker ($99.11 in chips)
Seat 3: vovvesvart ($172.22 in chips)
Seat 4: max21rus1988 ($76.36 in chips)
Seat 5: G.Andrei95 ($57.75 in chips)
Seat 6: Rezzonner ($71.05 in chips)
Straubje: posts small blind $0.25
Becks Baker: posts big blind $0.50
*** HOLE CARDS ***
vovvesvart: raises $1 to $1.50
max21rus1988: folds
G.Andrei95: raises $3 to $4.50
Rezzonner: folds
Straubje: calls $4.25
Becks Baker: folds
vovvesvart: calls $3
*** FLOP *** [Jh 8h 9s]
Straubje: checks
vovvesvart: checks
G.Andrei95: bets $4.39
Straubje: folds
vovvesvart: folds
Uncalled bet ($4.39) returned to G.Andrei95
G.Andrei95 collected $13.30 from pot
G.Andrei95: doesn't show hand
*** SUMMARY ***
Total pot $14 | Rake $0.70
Board [Jh 8h 9s]
Seat 1: Straubje (small blind) folded on the Flop
Seat 2: Becks Baker (big blind) folded before Flop
Seat 3: vovvesvart folded on the Flop
Seat 4: max21rus1988 folded before Flop (didn't bet)
Seat 5: G.Andrei95 collected ($13.30)
Seat 6: Rezzonner (button) folded before Flop (didn't bet)


PokerStars Hand #208960590100:  Hold'em No Limit ($0.25/$0.50 USD) - 2020/02/07 21:11:59 ET
Table 'Bohmia IV' 6-max Seat #3 is the button
Seat 1: Straubje ($44.39 in chips)
Seat 2: Becks Baker ($98.36 in chips)
Seat 3: vovvesvart ($162.22 in chips)
Seat 4: max21rus1988 ($76.46 in chips)
Seat 5: G.Andrei95 ($71.57 in chips)
Seat 6: Rezzonner ($71.05 in chips)
max21rus1988: posts small blind $0.25
G.Andrei95: posts big blind $0.50
*** HOLE CARDS ***
Rezzonner: folds
Straubje: folds
Becks Baker: folds
vovvesvart: raises $1.25 to $1.75
max21rus1988: calls $1.50
G.Andrei95: folds
*** FLOP *** [Td 3c Qs]
max21rus1988: checks
vovvesvart: bets $1.90
max21rus1988: folds
Uncalled bet ($1.90) returned to vovvesvart
vovvesvart collected $3.80 from pot
vovvesvart: doesn't show hand
*** SUMMARY ***
Total pot $4 | Rake $0.20
Board [Td 3c Qs]
Seat 1: Straubje folded before Flop (didn't bet)
Seat 2: Becks Baker folded before Flop (didn't bet)
Seat 3: vovvesvart (button) collected ($3.80)
Seat 4: max21rus1988 (small blind) folded on the Flop
Seat 5: G.Andrei95 (big blind) folded before Flop
Seat 6: Rezzonner folded before Flop (didn't bet)


PokerStars Hand #208960583294:  Hold'em No Limit ($0.25/$0.50 USD) - 2020/02/07 21:11:36 ET
Table 'Bohmia IV' 6-max Seat #2 is the button
Seat 1: Straubje ($44.39 in chips)
Seat 2: Becks Baker ($98.36 in chips)
Seat 3: vovvesvart ($163.72 in chips)
Seat 4: max21rus1988 ($75.11 in chips)
Seat 5: G.Andrei95 ($71.57 in chips)
Seat 6: Rezzonner ($71.05 in chips)
vovvesvart: posts small blind $0.25
max21rus1988: posts big blind $0.50
*** HOLE CARDS ***
G.Andrei95: folds
Rezzonner: folds
Straubje: folds
Becks Baker: folds
vovvesvart: raises $1 to $1.50
max21rus1988: calls $1
*** FLOP *** [7s Td 2c]
vovvesvart: checks
max21rus1988: bets $0.94
vovvesvart: folds
Uncalled bet ($0.94) returned to max21rus1988
max21rus1988 collected $2.85 from pot
max21rus1988: doesn't show hand
*** SUMMARY ***
Total pot $3 | Rake $0.15
Board [7s Td 2c]
Seat 1: Straubje folded before Flop (didn't bet)
Seat 2: Becks Baker (button) folded before Flop (didn't bet)
Seat 3: vovvesvart (small blind) folded on the Flop
Seat 4: max21rus1988 (big blind) collected ($2.85)
Seat 5: G.Andrei95 folded before Flop (didn't bet)
Seat 6: Rezzonner folded before Flop (didn't bet)


PokerStars Hand #208960597462:  Hold'em No Limit ($0.25/$0.50 USD) - 2020/02/07 21:12:25 ET
Table 'Bohmia IV' 6-max Seat #4 is the button
Seat 1: Straubje ($44.39 in chips)
Seat 2: Becks Baker ($98.36 in chips)
Seat 3: vovvesvart ($164.27 in chips)
Seat 4: max21rus1988 ($74.71 in chips)
Seat 5: G.Andrei95 ($71.07 in chips)
Seat 6: Rezzonner ($71.05 in chips)
G.Andrei95: posts small blind $0.25
Rezzonner: posts big blind $0.50
*** HOLE CARDS ***
Straubje: folds
Becks Baker: folds
vovvesvart: raises $1 to $1.50
max21rus1988: folds
G.Andrei95: calls $1.25
Rezzonner: calls $1
*** FLOP *** [Qs 3c Ac]
G.Andrei95: checks
Rezzonner: checks
vovvesvart: checks
*** TURN *** [Qs 3c Ac] [7s]
G.Andrei95: checks
Rezzonner: checks
vovvesvart: checks
*** RIVER *** [Qs 3c Ac 7s] [9h]
G.Andrei95: checks
Rezzonner: checks
vovvesvart: bets $2.14
G.Andrei95: folds
Rezzonner: folds
Uncalled bet ($2.14) returned to vovvesvart
vovvesvart collected $4.28 from pot
vovvesvart: doesn't show hand
*** SUMMARY ***
Total pot $4.50 | Rake $0.22
Board [Qs 3c Ac 7s 9h]
Seat 1: Straubje folded before Flop (didn't bet)
Seat 2: Becks Baker folded before Flop (didn't bet)
Seat 3: vovvesvart collected ($4.28)
Seat 4: max21rus1988 (button) folded before Flop (didn't bet)
Seat 5: G.Andrei95 (small blind) folded on the River
Seat 6: Rezzonner (big blind) folded on the River


PokerStars Hand #208960627781:  Hold'em No Limit ($0.25/$0.50 USD) - 2020/02/07 21:14:10 ET
Table 'Bohmia IV' 6-max Seat #6 is the button
Seat 1: Straubje ($43.14 in chips)
Seat 2: Becks Baker ($98.36 in chips)
Seat 3: vovvesvart ($167.05 in chips)
Seat 4: max21rus1988 ($74.71 in chips)
Seat 5: G.Andrei95 ($70.93 in chips)
Seat 6: Rezzonner ($69.30 in chips)
Straubje: posts small blind $0.25
Becks Baker: posts big blind $0.50
*** HOLE CARDS ***
vovvesvart: raises $0.50 to $1
max21rus1988: folds
G.Andrei95: folds
Rezzonner: folds
Straubje: folds
Becks Baker: folds
Uncalled bet ($0.50) returned to vovvesvart
vovvesvart collected $1.25 from pot
vovvesvart: doesn't show hand
*** SUMMARY ***
Total pot $1.25 | Rake $0
Seat 1: Straubje (small blind) folded before Flop
Seat 2: Becks Baker (big blind) folded before Flop
Seat 3: vovvesvart collected ($1.25)
Seat 4: max21rus1988 folded before Flop (didn't bet)
Seat 5: G.Andrei95 folded before Flop (didn't bet)
Seat 6: Rezzonner (button) folded before Flop (didn't bet)


PokerStars Hand #208960632052:  Hold'em No Limit ($0.25/$0.50 USD) - 2020/02/07 21:14:25 ET
Table 'Bohmia IV' 6-max Seat #1 is the button
Seat 1: Straubje ($42.89 in chips)
Seat 2: Becks Baker ($97.86 in chips)
Seat 3: vovvesvart ($167.80 in chips)
Seat 4: max21rus1988 ($74.71 in chips)
Seat 5: G.Andrei95 ($70.93 in chips)
Seat 6: Rezzonner ($69.30 in chips)
Becks Baker: posts small blind $0.25
vovvesvart: posts big blind $0.50
*** HOLE CARDS ***
max21rus1988: raises $0.75 to $1.25
G.Andrei95: folds
Rezzonner: folds
Straubje: calls $1.25
Becks Baker: folds
vovvesvart: calls $0.75
*** FLOP *** [As 3s 6d]
vovvesvart: checks
max21rus1988: checks
Straubje: bets $3
vovvesvart: folds
max21rus1988: folds
Uncalled bet ($3) returned to Straubje
Straubje collected $3.80 from pot
Straubje: doesn't show hand
*** SUMMARY ***
Total pot $4 | Rake $0.20
Board [As 3s 6d]
Seat 1: Straubje (button) collected ($3.80)
Seat 2: Becks Baker (small blind) folded before Flop
Seat 3: vovvesvart (big blind) folded on the Flop
Seat 4: max21rus1988 folded on the Flop
Seat 5: G.Andrei95 folded before Flop (didn't bet)
Seat 6: Rezzonner folded before Flop (didn't bet)


PokerStars Hand #208960621431:  Hold'em No Limit ($0.25/$0.50 USD) - 2020/02/07 21:13:48 ET
Table 'Bohmia IV' 6-max Seat #5 is the button
Seat 1: Straubje ($44.39 in chips)
Seat 2: Becks Baker ($98.36 in chips)
Seat 3: vovvesvart ($167.05 in chips)
Seat 4: max21rus1988 ($74.71 in chips)
Seat 5: G.Andrei95 ($69.57 in chips)
Seat 6: Rezzonner ($69.55 in chips)
Rezzonner: posts small blind $0.25
Straubje: posts big blind $0.50
*** HOLE CARDS ***
Becks Baker: folds
vovvesvart: folds
max21rus1988: folds
G.Andrei95: raises $0.75 to $1.25
Rezzonner: folds
Straubje: calls $0.75
*** FLOP *** [Kd Th 7s]
Straubje: checks
G.Andrei95: bets $1.96
Straubje: folds
Uncalled bet ($1.96) returned to G.Andrei95
G.Andrei95 collected $2.61 from pot
G.Andrei95: doesn't show hand
*** SUMMARY ***
Total pot $2.75 | Rake $0.14
Board [Kd Th 7s]
Seat 1: Straubje (big blind) folded on the Flop
Seat 2: Becks Baker folded before Flop (didn't bet)
Seat 3: vovvesvart folded before Flop (didn't bet)
Seat 4: max21rus1988 folded before Flop (didn't bet)
Seat 5: G.Andrei95 (button) collected ($2.61)
Seat 6: Rezzonner (small blind) folded before Flop


PokerStars Hand #208960639788:  Hold'em No Limit ($0.25/$0.50 USD) - 2020/02/07 21:14:52 ET
Table 'Bohmia IV' 6-max Seat #2 is the button
Seat 1: Straubje ($45.44 in chips)
Seat 2: Becks Baker ($97.61 in chips)
Seat 3: vovvesvart ($166.55 in chips)
Seat 4: max21rus1988 ($73.46 in chips)
Seat 5: G.Andrei95 ($70.93 in chips)
Seat 6: Rezzonner ($69.30 in chips)
vovvesvart: posts small blind $0.25
max21rus1988: posts big blind $0.50
*** HOLE CARDS ***
G.Andrei95: folds
Rezzonner: raises $0.75 to $1.25
Straubje: calls $1.25
Becks Baker: calls $1.25
vovvesvart: calls $1
max21rus1988: folds
*** FLOP *** [Ac Ad Ah]
vovvesvart: checks
Rezzonner: checks
Straubje: checks
Becks Baker: checks
*** TURN *** [Ac Ad Ah] [2s]
vovvesvart: checks
Rezzonner: bets $1.72
Straubje: folds
Becks Baker: folds
vovvesvart: calls $1.72
*** RIVER *** [Ac Ad Ah 2s] [Jh]
vovvesvart: checks
Rezzonner: bets $6
vovvesvart: folds
Uncalled bet ($6) returned to Rezzonner
Rezzonner collected $8.49 from pot
Rezzonner: doesn't show hand
*** SUMMARY ***
Total pot $8.94 | Rake $0.45
Board [Ac Ad Ah 2s Jh]
Seat 1: Straubje folded on the Turn
Seat 2: Becks Baker (button) folded on the Turn
Seat 3: vovvesvart (small blind) folded on the River
Seat 4: max21rus1988 (big blind) folded before Flop
Seat 5: G.Andrei95 folded before Flop (didn't bet)
Seat 6: Rezzonner collected ($8.49)


PokerStars Hand #208960656948:  Hold'em No Limit ($0.25/$0.50 USD) - 2020/02/07 21:15:52 ET
Table 'Bohmia IV' 6-max Seat #3 is the button
Seat 1: Straubje ($44.19 in chips)
Seat 2: Becks Baker ($96.36 in chips)
Seat 3: vovvesvart ($163.58 in chips)
Seat 4: max21rus1988 ($72.96 in chips)
Seat 5: G.Andrei95 ($70.93 in chips)
Seat 6: Rezzonner ($74.82 in chips)
max21rus1988: posts small blind $0.25
G.Andrei95: posts big blind $0.50
*** HOLE CARDS ***
Rezzonner: folds
Straubje: calls $0.50
Becks Baker: folds
vovvesvart: raises $1.75 to $2.25
max21rus1988: folds
G.Andrei95: folds
Straubje: calls $1.75
*** FLOP *** [9h 3c 6d]
Straubje: checks
vovvesvart: bets $2.50
Straubje: calls $2.50
*** TURN *** [9h 3c 6d] [4s]
Straubje: bets $7
vovvesvart: calls $7
*** RIVER *** [9h 3c 6d 4s] [2h]
Straubje: bets $32.44 and is all-in
vovvesvart: folds
Uncalled bet ($32.44) returned to Straubje
Straubje collected $23.04 from pot
Straubje: doesn't show hand
*** SUMMARY ***
Total pot $24.25 | Rake $1.21
Board [9h 3c 6d 4s 2h]
Seat 1: Straubje collected ($23.04)
Seat 2: Becks Baker folded before Flop (didn't bet)
Seat 3: vovvesvart (button) folded on the River
Seat 4: max21rus1988 (small blind) folded before Flop
Seat 5: G.Andrei95 (big blind) folded before Flop
Seat 6: Rezzonner folded before Flop (didn't bet)


PokerStars Hand #208960671060:  Hold'em No Limit ($0.25/$0.50 USD) - 2020/02/07 21:16:37 ET
Table 'Bohmia IV' 6-max Seat #4 is the button
Seat 1: Straubje ($55.48 in chips)
Seat 2: Becks Baker ($96.36 in chips)
Seat 3: vovvesvart ($151.83 in chips)
Seat 4: max21rus1988 ($72.71 in chips)
Seat 5: G.Andrei95 ($70.43 in chips)
Seat 6: Rezzonner ($74.82 in chips)
G.Andrei95: posts small blind $0.25
Rezzonner: posts big blind $0.50
*** HOLE CARDS ***
Straubje: calls $0.50
Becks Baker: folds
vovvesvart: raises $1 to $1.50
max21rus1988: folds
G.Andrei95: folds
Rezzonner: folds
Straubje: calls $1
*** FLOP *** [5c 6d Th]
Straubje: checks
vovvesvart: checks
*** TURN *** [5c 6d Th] [2s]
Straubje: checks
vovvesvart: checks
*** RIVER *** [5c 6d Th 2s] [Kd]
Straubje: checks
vovvesvart: checks
*** SHOW DOWN ***
Straubje: shows [9c Jc] (high card King)
vovvesvart: shows [Js 9s] (high card King)
Straubje collected $1.78 from pot
vovvesvart collected $1.78 from pot
*** SUMMARY ***
Total pot $3.75 | Rake $0.19
Board [5c 6d Th 2s Kd]
Seat 1: Straubje showed [9c Jc] and won ($1.78) with high card King
Seat 2: Becks Baker folded before Flop (didn't bet)
Seat 3: vovvesvart showed [Js 9s] and won ($1.78) with high card King
Seat 4: max21rus1988 (button) folded before Flop (didn't bet)
Seat 5: G.Andrei95 (small blind) folded before Flop
Seat 6: Rezzonner (big blind) folded before Flop


PokerStars Hand #208960680502:  Hold'em No Limit ($0.25/$0.50 USD) - 2020/02/07 21:17:04 ET
Table 'Bohmia IV' 6-max Seat #5 is the button
Seat 1: Straubje ($55.76 in chips)
Seat 2: Becks Baker ($96.36 in chips)
Seat 3: vovvesvart ($152.11 in chips)
Seat 4: max21rus1988 ($72.71 in chips)
Seat 5: G.Andrei95 ($70.18 in chips)
Seat 6: Rezzonner ($74.32 in chips)
Rezzonner: posts small blind $0.25
Straubje: posts big blind $0.50
*** HOLE CARDS ***
Becks Baker: raises $0.75 to $1.25
vovvesvart: calls $1.25
max21rus1988: folds
G.Andrei95: folds
Rezzonner: folds
Straubje: calls $0.75
*** FLOP *** [4h Jc 8c]
Straubje: checks
Becks Baker: checks
vovvesvart: checks
*** TURN *** [4h Jc 8c] [7d]
Straubje: bets $2
Becks Baker: folds
vovvesvart: calls $2
*** RIVER *** [4h Jc 8c 7d] [Ad]
Straubje: bets $2
vovvesvart: raises $2 to $4
Straubje: calls $2
*** SHOW DOWN ***
vovvesvart: shows [Ah 9h] (a pair of Aces)
Straubje: mucks hand
vovvesvart collected $15.20 from pot
*** SUMMARY ***
Total pot $16 | Rake $0.80
Board [4h Jc 8c 7d Ad]
Seat 1: Straubje (big blind) mucked
Seat 2: Becks Baker folded on the Turn
Seat 3: vovvesvart showed [Ah 9h] and won ($15.20) with a pair of Aces
Seat 4: max21rus1988 folded before Flop (didn't bet)
Seat 5: G.Andrei95 (button) folded before Flop (didn't bet)
Seat 6: Rezzonner (small blind) folded before Flop


PokerStars Hand #208960710775:  Hold'em No Limit ($0.25/$0.50 USD) - 2020/02/07 21:18:50 ET
Table 'Bohmia IV' 6-max Seat #1 is the button
Seat 1: Straubje ($45.26 in chips)
Seat 2: Becks Baker ($94.61 in chips)
Seat 3: vovvesvart ($153.60 in chips)
Seat 4: max21rus1988 ($72.71 in chips)
Seat 5: G.Andrei95 ($79.56 in chips)
Seat 6: Rezzonner ($74.07 in chips)
Becks Baker: posts small blind $0.25
vovvesvart: posts big blind $0.50
*** HOLE CARDS ***
max21rus1988: folds
G.Andrei95: raises $0.75 to $1.25
Rezzonner: folds
Straubje: raises $2.75 to $4
Becks Baker: folds
vovvesvart: folds
G.Andrei95: folds
Uncalled bet ($2.75) returned to Straubje
Straubje collected $3.25 from pot
Straubje: doesn't show hand
*** SUMMARY ***
Total pot $3.25 | Rake $0
Seat 1: Straubje (button) collected ($3.25)
Seat 2: Becks Baker (small blind) folded before Flop
Seat 3: vovvesvart (big blind) folded before Flop
Seat 4: max21rus1988 folded before Flop (didn't bet)
Seat 5: G.Andrei95 folded before Flop
Seat 6: Rezzonner folded before Flop (didn't bet)


PokerStars Hand #208960693321:  Hold'em No Limit ($0.25/$0.50 USD) - 2020/02/07 21:17:49 ET
Table 'Bohmia IV' 6-max Seat #6 is the button
Seat 1: Straubje ($48.51 in chips)
Seat 2: Becks Baker ($95.11 in chips)
Seat 3: vovvesvart ($160.06 in chips)
Seat 4: max21rus1988 ($72.71 in chips)
Seat 5: G.Andrei95 ($70.18 in chips)
Seat 6: Rezzonner ($74.07 in chips)
Straubje: posts small blind $0.25
Becks Baker: posts big blind $0.50
*** HOLE CARDS ***
vovvesvart: raises $0.50 to $1
max21rus1988: folds
G.Andrei95: raises $2.25 to $3.25
Rezzonner: folds
Straubje: calls $3
Becks Baker: folds
vovvesvart: calls $2.25
*** FLOP *** [7c Kd As]
Straubje: checks
vovvesvart: checks
G.Andrei95: bets $3.21
Straubje: folds
vovvesvart: calls $3.21
*** TURN *** [7c Kd As] [6s]
vovvesvart: checks
G.Andrei95: checks
*** RIVER *** [7c Kd As 6s] [Kh]
vovvesvart: checks
G.Andrei95: bets $3.96
vovvesvart: folds
Uncalled bet ($3.96) returned to G.Andrei95
G.Andrei95 collected $15.84 from pot
G.Andrei95: doesn't show hand
*** SUMMARY ***
Total pot $16.67 | Rake $0.83
Board [7c Kd As 6s Kh]
Seat 1: Straubje (small blind) folded on the Flop
Seat 2: Becks Baker (big blind) folded before Flop
Seat 3: vovvesvart folded on the River
Seat 4: max21rus1988 folded before Flop (didn't bet)
Seat 5: G.Andrei95 collected ($15.84)
Seat 6: Rezzonner (button) folded before Flop (didn't bet)


PokerStars Hand #208960731991:  Hold'em No Limit ($0.25/$0.50 USD) - 2020/02/07 21:19:37 ET
Table 'Bohmia IV' 6-max Seat #2 is the button
Seat 1: Straubje ($47.26 in chips)
Seat 2: Becks Baker ($94.36 in chips)
Seat 3: vovvesvart ($153.10 in chips)
Seat 4: max21rus1988 ($72.71 in chips)
Seat 5: G.Andrei95 ($78.31 in chips)
Seat 6: Rezzonner ($74.07 in chips)
vovvesvart: posts small blind $0.25
max21rus1988: posts big blind $0.50
*** HOLE CARDS ***
G.Andrei95: folds
Rezzonner: folds
Straubje: calls $0.50
Becks Baker: folds
vovvesvart: raises $1.50 to $2
max21rus1988: folds
Straubje: calls $1.50
*** FLOP *** [Ah Qs Js]
vovvesvart: bets $2.14
Straubje: calls $2.14
*** TURN *** [Ah Qs Js] [4h]
vovvesvart: bets $4.17
Straubje: folds
Uncalled bet ($4.17) returned to vovvesvart
vovvesvart collected $8.34 from pot
vovvesvart: doesn't show hand
*** SUMMARY ***
Total pot $8.78 | Rake $0.44
Board [Ah Qs Js 4h]
Seat 1: Straubje folded on the Turn
Seat 2: Becks Baker (button) folded before Flop (didn't bet)
Seat 3: vovvesvart (small blind) collected ($8.34)
Seat 4: max21rus1988 (big blind) folded before Flop
Seat 5: G.Andrei95 folded before Flop (didn't bet)
Seat 6: Rezzonner folded before Flop (didn't bet)


PokerStars Hand #208960738898:  Hold'em No Limit ($0.25/$0.50 USD) - 2020/02/07 21:20:01 ET
Table 'Bohmia IV' 6-max Seat #3 is the button
Seat 1: Straubje ($43.12 in chips)
Seat 2: Becks Baker ($94.36 in chips)
Seat 3: vovvesvart ($157.30 in chips)
Seat 4: max21rus1988 ($72.21 in chips)
Seat 5: G.Andrei95 ($78.31 in chips)
Seat 6: Rezzonner ($74.07 in chips)
max21rus1988: posts small blind $0.25
G.Andrei95: posts big blind $0.50
*** HOLE CARDS ***
Rezzonner: folds
Straubje: folds
Becks Baker: folds
vovvesvart: raises $1 to $1.50
max21rus1988: folds
G.Andrei95: calls $1
*** FLOP *** [2c Qh Jc]
G.Andrei95: checks
vovvesvart: checks
*** TURN *** [2c Qh Jc] [9h]
G.Andrei95: checks
vovvesvart: bets $3.09
G.Andrei95: folds
Uncalled bet ($3.09) returned to vovvesvart
vovvesvart collected $3.09 from pot
vovvesvart: doesn't show hand
*** SUMMARY ***
Total pot $3.25 | Rake $0.16
Board [2c Qh Jc 9h]
Seat 1: Straubje folded before Flop (didn't bet)
Seat 2: Becks Baker folded before Flop (didn't bet)
Seat 3: vovvesvart (button) collected ($3.09)
Seat 4: max21rus1988 (small blind) folded before Flop
Seat 5: G.Andrei95 (big blind) folded on the Turn
Seat 6: Rezzonner folded before Flop (didn't bet)


PokerStars Hand #208960746606:  Hold'em No Limit ($0.25/$0.50 USD) - 2020/02/07 21:20:28 ET
Table 'Bohmia IV' 6-max Seat #4 is the button
Seat 1: Straubje ($43.12 in chips)
Seat 2: Becks Baker ($94.36 in chips)
Seat 3: vovvesvart ($158.89 in chips)
Seat 4: max21rus1988 ($71.96 in chips)
Seat 5: G.Andrei95 ($76.81 in chips)
Seat 6: Rezzonner ($74.07 in chips)
G.Andrei95: posts small blind $0.25
Rezzonner: posts big blind $0.50
*** HOLE CARDS ***
Straubje: folds
Becks Baker: folds
vovvesvart: raises $1 to $1.50
max21rus1988: folds
G.Andrei95: raises $4 to $5.50
Rezzonner: folds
vovvesvart: folds
Uncalled bet ($4) returned to G.Andrei95
G.Andrei95 collected $3.50 from pot
G.Andrei95: doesn't show hand
*** SUMMARY ***
Total pot $3.50 | Rake $0
Seat 1: Straubje folded before Flop (didn't bet)
Seat 2: Becks Baker folded before Flop (didn't bet)
Seat 3: vovvesvart folded before Flop
Seat 4: max21rus1988 (button) folded before Flop (didn't bet)
Seat 5: G.Andrei95 (small blind) collected ($3.50)
Seat 6: Rezzonner (big blind) folded before Flop


PokerStars Hand #208960754887:  Hold'em No Limit ($0.25/$0.50 USD) - 2020/02/07 21:20:57 ET
Table 'Bohmia IV' 6-max Seat #5 is the button
Seat 1: Straubje ($43.12 in chips)
Seat 2: Becks Baker ($94.36 in chips)
Seat 3: vovvesvart ($157.39 in chips)
Seat 4: max21rus1988 ($71.96 in chips)
Seat 5: G.Andrei95 ($78.81 in chips)
Seat 6: Rezzonner ($73.57 in chips)
Rezzonner: posts small blind $0.25
Straubje: posts big blind $0.50
*** HOLE CARDS ***
Becks Baker: folds
vovvesvart: raises $1 to $1.50
max21rus1988: folds
G.Andrei95: folds
Rezzonner: folds
Straubje: calls $1
*** FLOP *** [Jd 5h 9h]
Straubje: checks
vovvesvart: bets $1.55
Straubje: folds
Uncalled bet ($1.55) returned to vovvesvart
vovvesvart collected $3.09 from pot
vovvesvart: doesn't show hand
*** SUMMARY ***
Total pot $3.25 | Rake $0.16
Board [Jd 5h 9h]
Seat 1: Straubje (big blind) folded on the Flop
Seat 2: Becks Baker folded before Flop (didn't bet)
Seat 3: vovvesvart collected ($3.09)
Seat 4: max21rus1988 folded before Flop (didn't bet)
Seat 5: G.Andrei95 (button) folded before Flop (didn't bet)
Seat 6: Rezzonner (small blind) folded before Flop


PokerStars Hand #208960765185:  Hold'em No Limit ($0.25/$0.50 USD) - 2020/02/07 21:21:34 ET
Table 'Bohmia IV' 6-max Seat #6 is the button
Seat 1: Straubje ($41.62 in chips)
Seat 2: Becks Baker ($94.36 in chips)
Seat 3: vovvesvart ($158.98 in chips)
Seat 4: max21rus1988 ($71.96 in chips)
Seat 5: G.Andrei95 ($78.81 in chips)
Seat 6: Rezzonner ($73.32 in chips)
Straubje: posts small blind $0.25
Becks Baker: posts big blind $0.50
*** HOLE CARDS ***
vovvesvart: raises $0.50 to $1
max21rus1988: folds
G.Andrei95: folds
Rezzonner: folds
Straubje: calls $0.75
Becks Baker: folds
*** FLOP *** [2s 7h 4h]
Straubje: checks
vovvesvart: bets $1.19
Straubje: calls $1.19
*** TURN *** [2s 7h 4h] [Qd]
Straubje: checks
vovvesvart: bets $2.32
Straubje: calls $2.32
*** RIVER *** [2s 7h 4h Qd] [Ah]
Straubje: bets $5
vovvesvart: folds
Uncalled bet ($5) returned to Straubje
Straubje collected $9.04 from pot
Straubje: doesn't show hand
*** SUMMARY ***
Total pot $9.52 | Rake $0.48
Board [2s 7h 4h Qd Ah]
Seat 1: Straubje (small blind) collected ($9.04)
Seat 2: Becks Baker (big blind) folded before Flop
Seat 3: vovvesvart folded on the River
Seat 4: max21rus1988 folded before Flop (didn't bet)
Seat 5: G.Andrei95 folded before Flop (didn't bet)
Seat 6: Rezzonner (button) folded before Flop (didn't bet)


PokerStars Hand #208960799428:  Hold'em No Limit ($0.25/$0.50 USD) - 2020/02/07 21:23:36 ET
Table 'Bohmia IV' 6-max Seat #3 is the button
Seat 1: Straubje ($45.65 in chips)
Seat 2: Becks Baker ($97.36 in chips)
Seat 3: vovvesvart ($152.97 in chips)
Seat 4: max21rus1988 ($71.46 in chips)
Seat 5: G.Andrei95 ($77.56 in chips)
Seat 6: Rezzonner ($73.32 in chips)
max21rus1988: posts small blind $0.25
G.Andrei95: posts big blind $0.50
*** HOLE CARDS ***
Rezzonner: folds
Straubje: raises $2 to $2.50
Becks Baker: folds
vovvesvart: folds
max21rus1988: folds
G.Andrei95: folds
Uncalled bet ($2) returned to Straubje
Straubje collected $1.25 from pot
Straubje: doesn't show hand
*** SUMMARY ***
Total pot $1.25 | Rake $0
Seat 1: Straubje collected ($1.25)
Seat 2: Becks Baker folded before Flop (didn't bet)
Seat 3: vovvesvart (button) folded before Flop (didn't bet)
Seat 4: max21rus1988 (small blind) folded before Flop
Seat 5: G.Andrei95 (big blind) folded before Flop
Seat 6: Rezzonner folded before Flop (didn't bet)


PokerStars Hand #208960793953:  Hold'em No Limit ($0.25/$0.50 USD) - 2020/02/07 21:23:16 ET
Table 'Bohmia IV' 6-max Seat #2 is the button
Seat 1: Straubje ($44.90 in chips)
Seat 2: Becks Baker ($97.36 in chips)
Seat 3: vovvesvart ($153.22 in chips)
Seat 4: max21rus1988 ($71.96 in chips)
Seat 5: G.Andrei95 ($77.56 in chips)
Seat 6: Rezzonner ($73.32 in chips)
vovvesvart: posts small blind $0.25
max21rus1988: posts big blind $0.50
*** HOLE CARDS ***
G.Andrei95: folds
Rezzonner: folds
Straubje: raises $3 to $3.50
Becks Baker: folds
vovvesvart: folds
max21rus1988: folds
Uncalled bet ($3) returned to Straubje
Straubje collected $1.25 from pot
Straubje: doesn't show hand
*** SUMMARY ***
Total pot $1.25 | Rake $0
Seat 1: Straubje collected ($1.25)
Seat 2: Becks Baker (button) folded before Flop (didn't bet)
Seat 3: vovvesvart (small blind) folded before Flop
Seat 4: max21rus1988 (big blind) folded before Flop
Seat 5: G.Andrei95 folded before Flop (didn't bet)
Seat 6: Rezzonner folded before Flop (didn't bet)


PokerStars Hand #208960777631:  Hold'em No Limit ($0.25/$0.50 USD) - 2020/02/07 21:22:18 ET
Table 'Bohmia IV' 6-max Seat #1 is the button
Seat 1: Straubje ($46.15 in chips)
Seat 2: Becks Baker ($93.86 in chips)
Seat 3: vovvesvart ($154.47 in chips)
Seat 4: max21rus1988 ($71.96 in chips)
Seat 5: G.Andrei95 ($78.81 in chips)
Seat 6: Rezzonner ($73.32 in chips)
Becks Baker: posts small blind $0.25
vovvesvart: posts big blind $0.50
*** HOLE CARDS ***
max21rus1988: folds
G.Andrei95: raises $0.75 to $1.25
Rezzonner: folds
Straubje: calls $1.25
Becks Baker: calls $1
vovvesvart: calls $0.75
*** FLOP *** [Kd 5d As]
Becks Baker: checks
vovvesvart: checks
G.Andrei95: checks
Straubje: checks
*** TURN *** [Kd 5d As] [3d]
Becks Baker: bets $3.75
vovvesvart: folds
G.Andrei95: folds
Straubje: folds
Uncalled bet ($3.75) returned to Becks Baker
Becks Baker collected $4.75 from pot
*** SUMMARY ***
Total pot $5 | Rake $0.25
Board [Kd 5d As 3d]
Seat 1: Straubje (button) folded on the Turn
Seat 2: Becks Baker (small blind) collected ($4.75)
Seat 3: vovvesvart (big blind) folded on the Turn
Seat 4: max21rus1988 folded before Flop (didn't bet)
Seat 5: G.Andrei95 folded on the Turn
Seat 6: Rezzonner folded before Flop (didn't bet)


PokerStars Hand #208960821718:  Hold'em No Limit ($0.25/$0.50 USD) - 2020/02/07 21:24:55 ET
Table 'Bohmia IV' 6-max Seat #5 is the button
Seat 1: Straubje ($46.40 in chips)
Seat 2: Becks Baker ($96.11 in chips)
Seat 3: vovvesvart ($158.94 in chips)
Seat 4: max21rus1988 ($71.21 in chips)
Seat 5: G.Andrei95 ($76.81 in chips)
Seat 6: Rezzonner ($68.27 in chips)
Rezzonner: posts small blind $0.25
Straubje: posts big blind $0.50
*** HOLE CARDS ***
Becks Baker: folds
vovvesvart: folds
max21rus1988: folds
G.Andrei95: folds
Rezzonner: folds
Uncalled bet ($0.25) returned to Straubje
Straubje collected $0.50 from pot
Straubje: doesn't show hand
*** SUMMARY ***
Total pot $0.50 | Rake $0
Seat 1: Straubje (big blind) collected ($0.50)
Seat 2: Becks Baker folded before Flop (didn't bet)
Seat 3: vovvesvart folded before Flop (didn't bet)
Seat 4: max21rus1988 folded before Flop (didn't bet)
Seat 5: G.Andrei95 (button) folded before Flop (didn't bet)
Seat 6: Rezzonner (small blind) folded before Flop


PokerStars Hand #208960826903:  Hold'em No Limit ($0.25/$0.50 USD) - 2020/02/07 21:25:13 ET
Table 'Bohmia IV' 6-max Seat #6 is the button
Seat 1: Straubje ($46.65 in chips)
Seat 2: Becks Baker ($96.11 in chips)
Seat 3: vovvesvart ($158.94 in chips)
Seat 4: max21rus1988 ($71.21 in chips)
Seat 5: G.Andrei95 ($76.81 in chips)
Seat 6: Rezzonner ($68.02 in chips)
Straubje: posts small blind $0.25
Becks Baker: posts big blind $0.50
*** HOLE CARDS ***
vovvesvart: folds
max21rus1988: folds
G.Andrei95: folds
Rezzonner: folds
Straubje: raises $2 to $2.50
Becks Baker: folds
Uncalled bet ($2) returned to Straubje
Straubje collected $1 from pot
Straubje: doesn't show hand
*** SUMMARY ***
Total pot $1 | Rake $0
Seat 1: Straubje (small blind) collected ($1)
Seat 2: Becks Baker (big blind) folded before Flop
Seat 3: vovvesvart folded before Flop (didn't bet)
Seat 4: max21rus1988 folded before Flop (didn't bet)
Seat 5: G.Andrei95 folded before Flop (didn't bet)
Seat 6: Rezzonner (button) folded before Flop (didn't bet)


PokerStars Hand #208960832831:  Hold'em No Limit ($0.25/$0.50 USD) - 2020/02/07 21:25:34 ET
Table 'Bohmia IV' 6-max Seat #1 is the button
Seat 1: Straubje ($47.15 in chips)
Seat 2: Becks Baker ($95.61 in chips)
Seat 3: vovvesvart ($158.94 in chips)
Seat 4: max21rus1988 ($71.21 in chips)
Seat 5: G.Andrei95 ($76.81 in chips)
Seat 6: Rezzonner ($68.02 in chips)
Becks Baker: posts small blind $0.25
vovvesvart: posts big blind $0.50
*** HOLE CARDS ***
max21rus1988: raises $0.75 to $1.25
G.Andrei95: folds
Rezzonner: folds
Straubje: folds
Becks Baker: folds
vovvesvart: folds
Uncalled bet ($0.75) returned to max21rus1988
max21rus1988 collected $1.25 from pot
max21rus1988: doesn't show hand
*** SUMMARY ***
Total pot $1.25 | Rake $0
Seat 1: Straubje (button) folded before Flop (didn't bet)
Seat 2: Becks Baker (small blind) folded before Flop
Seat 3: vovvesvart (big blind) folded before Flop
Seat 4: max21rus1988 collected ($1.25)
Seat 5: G.Andrei95 folded before Flop (didn't bet)
Seat 6: Rezzonner folded before Flop (didn't bet)


PokerStars Hand #208960802911:  Hold'em No Limit ($0.25/$0.50 USD) - 2020/02/07 21:23:48 ET
Table 'Bohmia IV' 6-max Seat #4 is the button
Seat 1: Straubje ($46.40 in chips)
Seat 2: Becks Baker ($97.36 in chips)
Seat 3: vovvesvart ($152.97 in chips)
Seat 4: max21rus1988 ($71.21 in chips)
Seat 5: G.Andrei95 ($77.06 in chips)
Seat 6: Rezzonner ($73.32 in chips)
G.Andrei95: posts small blind $0.25
Rezzonner: posts big blind $0.50
*** HOLE CARDS ***
Straubje: folds
Becks Baker: raises $0.75 to $1.25
vovvesvart: calls $1.25
max21rus1988: folds
G.Andrei95: folds
Rezzonner: calls $0.75
*** FLOP *** [5c 4h 6d]
Rezzonner: checks
Becks Baker: checks
vovvesvart: bets $3.80
Rezzonner: calls $3.80
Becks Baker: folds
*** TURN *** [5c 4h 6d] [2c]
Rezzonner: checks
vovvesvart: checks
*** RIVER *** [5c 4h 6d 2c] [4d]
Rezzonner: checks
vovvesvart: bets $5.51
Rezzonner: folds
Uncalled bet ($5.51) returned to vovvesvart
vovvesvart collected $11.02 from pot
vovvesvart: doesn't show hand
*** SUMMARY ***
Total pot $11.60 | Rake $0.58
Board [5c 4h 6d 2c 4d]
Seat 1: Straubje folded before Flop (didn't bet)
Seat 2: Becks Baker folded on the Flop
Seat 3: vovvesvart collected ($11.02)
Seat 4: max21rus1988 (button) folded before Flop (didn't bet)
Seat 5: G.Andrei95 (small blind) folded before Flop
Seat 6: Rezzonner (big blind) folded on the River


PokerStars Hand #208960836089:  Hold'em No Limit ($0.25/$0.50 USD) - 2020/02/07 21:25:46 ET
Table 'Bohmia IV' 6-max Seat #2 is the button
Seat 1: Straubje ($47.15 in chips)
Seat 2: Becks Baker ($95.36 in chips)
Seat 3: vovvesvart ($158.44 in chips)
Seat 4: max21rus1988 ($71.96 in chips)
Seat 5: G.Andrei95 ($76.81 in chips)
Seat 6: Rezzonner ($68.02 in chips)
vovvesvart: posts small blind $0.25
max21rus1988: posts big blind $0.50
*** HOLE CARDS ***
G.Andrei95: folds
Rezzonner: folds
Straubje: raises $2.50 to $3
Becks Baker: folds
vovvesvart: calls $2.75
max21rus1988: calls $2.50
*** FLOP *** [9s 7h Qc]
vovvesvart: checks
max21rus1988: checks
Straubje: bets $6
vovvesvart: calls $6
max21rus1988: folds
*** TURN *** [9s 7h Qc] [4d]
vovvesvart: checks
Straubje: checks
*** RIVER *** [9s 7h Qc 4d] [Ac]
vovvesvart: checks
Straubje: checks
*** SHOW DOWN ***
vovvesvart: shows [Jc Td] (high card Ace)
Straubje: shows [Jh Js] (a pair of Jacks)
Straubje collected $19.95 from pot
*** SUMMARY ***
Total pot $21 | Rake $1.05
Board [9s 7h Qc 4d Ac]
Seat 1: Straubje showed [Jh Js] and won ($19.95) with a pair of Jacks
Seat 2: Becks Baker (button) folded before Flop (didn't bet)
Seat 3: vovvesvart (small blind) showed [Jc Td] and lost with high card Ace
Seat 4: max21rus1988 (big blind) folded on the Flop
Seat 5: G.Andrei95 folded before Flop (didn't bet)
Seat 6: Rezzonner folded before Flop (didn't bet)


PokerStars Hand #208960867024:  Hold'em No Limit ($0.25/$0.50 USD) - 2020/02/07 21:27:25 ET
Table 'Bohmia IV' 6-max Seat #4 is the button
Seat 1: Straubje ($57.10 in chips)
Seat 2: Becks Baker ($95.36 in chips)
Seat 3: vovvesvart ($151.05 in chips)
Seat 4: max21rus1988 ($68.71 in chips)
Seat 5: G.Andrei95 ($76.31 in chips)
Seat 6: Rezzonner ($68.02 in chips)
G.Andrei95: posts small blind $0.25
Rezzonner: posts big blind $0.50
*** HOLE CARDS ***
Straubje: folds
Becks Baker: raises $0.75 to $1.25
vovvesvart: folds
max21rus1988: folds
G.Andrei95: folds
Rezzonner: folds
Uncalled bet ($0.75) returned to Becks Baker
Becks Baker collected $1.25 from pot
*** SUMMARY ***
Total pot $1.25 | Rake $0
Seat 1: Straubje folded before Flop (didn't bet)
Seat 2: Becks Baker collected ($1.25)
Seat 3: vovvesvart folded before Flop (didn't bet)
Seat 4: max21rus1988 (button) folded before Flop (didn't bet)
Seat 5: G.Andrei95 (small blind) folded before Flop
Seat 6: Rezzonner (big blind) folded before Flop


PokerStars Hand #208960849800:  Hold'em No Limit ($0.25/$0.50 USD) - 2020/02/07 21:26:35 ET
Table 'Bohmia IV' 6-max Seat #3 is the button
Seat 1: Straubje ($58.10 in chips)
Seat 2: Becks Baker ($95.36 in chips)
Seat 3: vovvesvart ($149.44 in chips)
Seat 4: max21rus1988 ($68.96 in chips)
Seat 5: G.Andrei95 ($76.81 in chips)
Seat 6: Rezzonner ($68.02 in chips)
max21rus1988: posts small blind $0.25
G.Andrei95: posts big blind $0.50
*** HOLE CARDS ***
Rezzonner: folds
Straubje: calls $0.50
Becks Baker: folds
vovvesvart: raises $0.50 to $1
max21rus1988: folds
G.Andrei95: folds
Straubje: calls $0.50
*** FLOP *** [9c 8s 2c]
Straubje: checks
vovvesvart: bets $1.31
Straubje: folds
Uncalled bet ($1.31) returned to vovvesvart
vovvesvart collected $2.61 from pot
vovvesvart: doesn't show hand
*** SUMMARY ***
Total pot $2.75 | Rake $0.14
Board [9c 8s 2c]
Seat 1: Straubje folded on the Flop
Seat 2: Becks Baker folded before Flop (didn't bet)
Seat 3: vovvesvart (button) collected ($2.61)
Seat 4: max21rus1988 (small blind) folded before Flop
Seat 5: G.Andrei95 (big blind) folded before Flop
Seat 6: Rezzonner folded before Flop (didn't bet)


PokerStars Hand #208960871111:  Hold'em No Limit ($0.25/$0.50 USD) - 2020/02/07 21:27:40 ET
Table 'Bohmia IV' 6-max Seat #5 is the button
Seat 1: Straubje ($57.10 in chips)
Seat 2: Becks Baker ($96.11 in chips)
Seat 3: vovvesvart ($151.05 in chips)
Seat 4: max21rus1988 ($68.71 in chips)
Seat 5: G.Andrei95 ($76.06 in chips)
Seat 6: Rezzonner ($67.52 in chips)
Rezzonner: posts small blind $0.25
Straubje: posts big blind $0.50
*** HOLE CARDS ***
Becks Baker: folds
vovvesvart has timed out
vovvesvart: folds
max21rus1988: folds
G.Andrei95: folds
Rezzonner: raises $1 to $1.50
Straubje: calls $1
*** FLOP *** [Qc 6h 9s]
Rezzonner: checks
Straubje: checks
*** TURN *** [Qc 6h 9s] [4s]
Rezzonner: bets $2.14
Straubje: folds
Uncalled bet ($2.14) returned to Rezzonner
Rezzonner collected $2.85 from pot
Rezzonner: doesn't show hand
*** SUMMARY ***
Total pot $3 | Rake $0.15
Board [Qc 6h 9s 4s]
Seat 1: Straubje (big blind) folded on the Turn
Seat 2: Becks Baker folded before Flop (didn't bet)
Seat 3: vovvesvart folded before Flop (didn't bet)
Seat 4: max21rus1988 folded before Flop (didn't bet)
Seat 5: G.Andrei95 (button) folded before Flop (didn't bet)
Seat 6: Rezzonner (small blind) collected ($2.85)


PokerStars Hand #208960892837:  Hold'em No Limit ($0.25/$0.50 USD) - 2020/02/07 21:28:57 ET
Table 'Bohmia IV' 6-max Seat #6 is the button
Seat 1: Straubje ($55.60 in chips)
Seat 2: Becks Baker ($96.11 in chips)
Seat 3: vovvesvart ($151.05 in chips)
Seat 4: max21rus1988 ($68.71 in chips)
Seat 5: G.Andrei95 ($76.06 in chips)
Seat 6: Rezzonner ($68.87 in chips)
Straubje: posts small blind $0.25
Becks Baker: posts big blind $0.50
*** HOLE CARDS ***
vovvesvart: raises $0.50 to $1
max21rus1988: folds
G.Andrei95: folds
Rezzonner: folds
Straubje: calls $0.75
Becks Baker: calls $0.50
*** FLOP *** [2c 9h 3h]
Straubje: checks
Becks Baker: checks
vovvesvart has timed out
vovvesvart: checks
*** TURN *** [2c 9h 3h] [3d]
Straubje: checks
Becks Baker: bets $1.85
vovvesvart: folds
Straubje: folds
Uncalled bet ($1.85) returned to Becks Baker
Becks Baker collected $2.85 from pot
*** SUMMARY ***
Total pot $3 | Rake $0.15
Board [2c 9h 3h 3d]
Seat 1: Straubje (small blind) folded on the Turn
Seat 2: Becks Baker (big blind) collected ($2.85)
Seat 3: vovvesvart folded on the Turn
Seat 4: max21rus1988 folded before Flop (didn't bet)
Seat 5: G.Andrei95 folded before Flop (didn't bet)
Seat 6: Rezzonner (button) folded before Flop (didn't bet)


PokerStars Hand #208960931550:  Hold'em No Limit ($0.25/$0.50 USD) - 2020/02/07 21:31:03 ET
Table 'Bohmia IV' 6-max Seat #1 is the button
Seat 1: Straubje ($54.60 in chips)
Seat 2: Becks Baker ($97.96 in chips)
Seat 3: vovvesvart ($150.05 in chips)
Seat 4: max21rus1988 ($68.71 in chips)
Seat 5: G.Andrei95 ($76.06 in chips)
Seat 6: Rezzonner ($68.87 in chips)
Becks Baker: posts small blind $0.25
vovvesvart: posts big blind $0.50
*** HOLE CARDS ***
max21rus1988: folds
G.Andrei95: folds
Rezzonner: folds
Straubje: raises $1.50 to $2
Becks Baker: folds
vovvesvart: calls $1.50
*** FLOP *** [Ts Qd 5c]
vovvesvart: checks
Straubje: bets $3.50
vovvesvart: folds
Uncalled bet ($3.50) returned to Straubje
Straubje collected $4.04 from pot
Straubje: doesn't show hand
*** SUMMARY ***
Total pot $4.25 | Rake $0.21
Board [Ts Qd 5c]
Seat 1: Straubje (button) collected ($4.04)
Seat 2: Becks Baker (small blind) folded before Flop
Seat 3: vovvesvart (big blind) folded on the Flop
Seat 4: max21rus1988 folded before Flop (didn't bet)
Seat 5: G.Andrei95 folded before Flop (didn't bet)
Seat 6: Rezzonner folded before Flop (didn't bet)


PokerStars Hand #208960964411:  Hold'em No Limit ($0.25/$0.50 USD) - 2020/02/07 21:33:02 ET
Table 'Bohmia IV' 6-max Seat #3 is the button
Seat 1: Straubje ($56.64 in chips)
Seat 2: Becks Baker ($97.71 in chips)
Seat 3: vovvesvart ($129.26 in chips)
Seat 4: max21rus1988 ($85.62 in chips)
Seat 5: G.Andrei95 ($76.06 in chips)
Seat 6: Rezzonner ($68.87 in chips)
max21rus1988: posts small blind $0.25
G.Andrei95: posts big blind $0.50
*** HOLE CARDS ***
Rezzonner: folds
Straubje: calls $0.50
Becks Baker: folds
vovvesvart has timed out
vovvesvart: folds
max21rus1988: raises $1.75 to $2.25
G.Andrei95: folds
Straubje: calls $1.75
*** FLOP *** [9s Qh 4s]
max21rus1988: bets $3.14
Straubje: folds
Uncalled bet ($3.14) returned to max21rus1988
max21rus1988 collected $4.75 from pot
max21rus1988: doesn't show hand
*** SUMMARY ***
Total pot $5 | Rake $0.25
Board [9s Qh 4s]
Seat 1: Straubje folded on the Flop
Seat 2: Becks Baker folded before Flop (didn't bet)
Seat 3: vovvesvart (button) folded before Flop (didn't bet)
Seat 4: max21rus1988 (small blind) collected ($4.75)
Seat 5: G.Andrei95 (big blind) folded before Flop
Seat 6: Rezzonner folded before Flop (didn't bet)


PokerStars Hand #208960951803:  Hold'em No Limit ($0.25/$0.50 USD) - 2020/02/07 21:32:16 ET
Table 'Bohmia IV' 6-max Seat #2 is the button
Seat 1: Straubje ($56.64 in chips)
Seat 2: Becks Baker ($97.71 in chips)
Seat 3: vovvesvart ($148.05 in chips)
Seat 4: max21rus1988 ($68.71 in chips)
Seat 5: G.Andrei95 ($76.06 in chips)
Seat 6: Rezzonner ($68.87 in chips)
vovvesvart: posts small blind $0.25
max21rus1988: posts big blind $0.50
*** HOLE CARDS ***
G.Andrei95: folds
Rezzonner: folds
Straubje: folds
Becks Baker: folds
vovvesvart: raises $0.50 to $1
max21rus1988: raises $3.25 to $4.25
vovvesvart: calls $3.25
*** FLOP *** [5c 9d Js]
vovvesvart: checks
max21rus1988: bets $4.04
vovvesvart: calls $4.04
*** TURN *** [5c 9d Js] [7d]
vovvesvart: checks
max21rus1988: bets $10.50
vovvesvart: calls $10.50
*** RIVER *** [5c 9d Js 7d] [5h]
vovvesvart: checks
max21rus1988: checks
*** SHOW DOWN ***
vovvesvart: shows [3c 8c] (a pair of Fives)
max21rus1988: shows [Qc Jc] (two pair, Jacks and Fives)
max21rus1988 collected $35.70 from pot
*** SUMMARY ***
Total pot $37.58 | Rake $1.88
Board [5c 9d Js 7d 5h]
Seat 1: Straubje folded before Flop (didn't bet)
Seat 2: Becks Baker (button) folded before Flop (didn't bet)
Seat 3: vovvesvart (small blind) showed [3c 8c] and lost with a pair of Fives
Seat 4: max21rus1988 (big blind) showed [Qc Jc] and won ($35.70) with two pair, Jacks and Fives
Seat 5: G.Andrei95 folded before Flop (didn't bet)
Seat 6: Rezzonner folded before Flop (didn't bet)


PokerStars Hand #208960995697:  Hold'em No Limit ($0.25/$0.50 USD) - 2020/02/07 21:34:52 ET
Table 'Bohmia IV' 6-max Seat #5 is the button
Seat 1: Straubje ($54.39 in chips)
Seat 2: Becks Baker ($101.58 in chips)
Seat 3: vovvesvart ($125.75 in chips)
Seat 4: max21rus1988 ($88.12 in chips)
Seat 5: G.Andrei95 ($75.31 in chips)
Seat 6: Rezzonner ($68.37 in chips)
Rezzonner: posts small blind $0.25
Straubje: posts big blind $0.50
*** HOLE CARDS ***
Becks Baker: raises $0.75 to $1.25
vovvesvart: folds
max21rus1988: folds
G.Andrei95: folds
Rezzonner: folds
Straubje: folds
Uncalled bet ($0.75) returned to Becks Baker
Becks Baker collected $1.25 from pot
*** SUMMARY ***
Total pot $1.25 | Rake $0
Seat 1: Straubje (big blind) folded before Flop
Seat 2: Becks Baker collected ($1.25)
Seat 3: vovvesvart folded before Flop (didn't bet)
Seat 4: max21rus1988 folded before Flop (didn't bet)
Seat 5: G.Andrei95 (button) folded before Flop (didn't bet)
Seat 6: Rezzonner (small blind) folded before Flop


PokerStars Hand #208960975850:  Hold'em No Limit ($0.25/$0.50 USD) - 2020/02/07 21:33:43 ET
Table 'Bohmia IV' 6-max Seat #4 is the button
Seat 1: Straubje ($54.39 in chips)
Seat 2: Becks Baker ($97.71 in chips)
Seat 3: vovvesvart ($129.26 in chips)
Seat 4: max21rus1988 ($88.12 in chips)
Seat 5: G.Andrei95 ($75.56 in chips)
Seat 6: Rezzonner ($68.87 in chips)
G.Andrei95: posts small blind $0.25
Rezzonner: posts big blind $0.50
*** HOLE CARDS ***
Straubje: folds
Becks Baker: raises $0.75 to $1.25
vovvesvart: calls $1.25
max21rus1988: folds
G.Andrei95: folds
Rezzonner: folds
*** FLOP *** [4d Ah 9c]
Becks Baker: checks
vovvesvart: checks
*** TURN *** [4d Ah 9c] [Kh]
Becks Baker: bets $2.26
vovvesvart: calls $2.26
*** RIVER *** [4d Ah 9c Kh] [Ts]
Becks Baker: bets $2.44
vovvesvart: folds
Uncalled bet ($2.44) returned to Becks Baker
Becks Baker collected $7.38 from pot
*** SUMMARY ***
Total pot $7.77 | Rake $0.39
Board [4d Ah 9c Kh Ts]
Seat 1: Straubje folded before Flop (didn't bet)
Seat 2: Becks Baker collected ($7.38)
Seat 3: vovvesvart folded on the River
Seat 4: max21rus1988 (button) folded before Flop (didn't bet)
Seat 5: G.Andrei95 (small blind) folded before Flop
Seat 6: Rezzonner (big blind) folded before Flop


PokerStars Hand #208961002078:  Hold'em No Limit ($0.25/$0.50 USD) - 2020/02/07 21:35:16 ET
Table 'Bohmia IV' 6-max Seat #6 is the button
Seat 1: Straubje ($53.89 in chips)
Seat 2: Becks Baker ($102.33 in chips)
Seat 3: vovvesvart ($125.75 in chips)
Seat 4: max21rus1988 ($88.12 in chips)
Seat 5: G.Andrei95 ($75.31 in chips)
Seat 6: Rezzonner ($68.12 in chips)
Straubje: posts small blind $0.25
Becks Baker: posts big blind $0.50
*** HOLE CARDS ***
vovvesvart: folds
max21rus1988: raises $0.75 to $1.25
G.Andrei95: calls $1.25
Rezzonner: folds
Straubje: folds
Becks Baker: calls $0.75
*** FLOP *** [6s 8d 8s]
Becks Baker: checks
max21rus1988: checks
G.Andrei95: bets $0.95
Becks Baker: folds
max21rus1988: folds
Uncalled bet ($0.95) returned to G.Andrei95
G.Andrei95 collected $3.80 from pot
G.Andrei95: doesn't show hand
*** SUMMARY ***
Total pot $4 | Rake $0.20
Board [6s 8d 8s]
Seat 1: Straubje (small blind) folded before Flop
Seat 2: Becks Baker (big blind) folded on the Flop
Seat 3: vovvesvart folded before Flop (didn't bet)
Seat 4: max21rus1988 folded on the Flop
Seat 5: G.Andrei95 collected ($3.80)
Seat 6: Rezzonner (button) folded before Flop (didn't bet)


PokerStars Hand #208961024922:  Hold'em No Limit ($0.25/$0.50 USD) - 2020/02/07 21:36:26 ET
Table 'Bohmia IV' 6-max Seat #1 is the button
Seat 1: Straubje ($53.64 in chips)
Seat 2: Becks Baker ($101.08 in chips)
Seat 3: vovvesvart ($125.75 in chips)
Seat 4: max21rus1988 ($86.87 in chips)
Seat 5: G.Andrei95 ($77.86 in chips)
Seat 6: Rezzonner ($68.12 in chips)
Becks Baker: posts small blind $0.25
vovvesvart: posts big blind $0.50
*** HOLE CARDS ***
max21rus1988: folds
G.Andrei95: folds
Rezzonner: folds
Straubje: raises $1.50 to $2
Becks Baker: folds
vovvesvart: calls $1.50
*** FLOP *** [5d 2d 4d]
vovvesvart: checks
Straubje: checks
*** TURN *** [5d 2d 4d] [6c]
vovvesvart: bets $0.50
Straubje: folds
Uncalled bet ($0.50) returned to vovvesvart
vovvesvart collected $4.04 from pot
vovvesvart: doesn't show hand
*** SUMMARY ***
Total pot $4.25 | Rake $0.21
Board [5d 2d 4d 6c]
Seat 1: Straubje (button) folded on the Turn
Seat 2: Becks Baker (small blind) folded before Flop
Seat 3: vovvesvart (big blind) collected ($4.04)
Seat 4: max21rus1988 folded before Flop (didn't bet)
Seat 5: G.Andrei95 folded before Flop (didn't bet)
Seat 6: Rezzonner folded before Flop (didn't bet)


PokerStars Hand #208961035809:  Hold'em No Limit ($0.25/$0.50 USD) - 2020/02/07 21:37:05 ET
Table 'Bohmia IV' 6-max Seat #2 is the button
Seat 1: Straubje ($51.64 in chips)
Seat 2: Becks Baker ($100.83 in chips)
Seat 3: vovvesvart ($127.79 in chips)
Seat 5: G.Andrei95 ($77.86 in chips)
Seat 6: Rezzonner ($68.12 in chips)
vovvesvart: posts small blind $0.25
max21rus1988: is sitting out
max21rus1988 leaves the table
G.Andrei95: posts big blind $0.50
*** HOLE CARDS ***
Meskalita joins the table at seat #4
Rezzonner: folds
Straubje: folds
Becks Baker: folds
vovvesvart: raises $1 to $1.50
G.Andrei95: folds
Uncalled bet ($1) returned to vovvesvart
vovvesvart collected $1 from pot
vovvesvart: doesn't show hand
*** SUMMARY ***
Total pot $1 | Rake $0
Seat 1: Straubje folded before Flop (didn't bet)
Seat 2: Becks Baker (button) folded before Flop (didn't bet)
Seat 3: vovvesvart (small blind) collected ($1)
Seat 5: G.Andrei95 (big blind) folded before Flop
Seat 6: Rezzonner folded before Flop (didn't bet)


PokerStars Hand #208961041018:  Hold'em No Limit ($0.25/$0.50 USD) - 2020/02/07 21:37:24 ET
Table 'Bohmia IV' 6-max Seat #3 is the button
Seat 1: Straubje ($51.64 in chips)
Seat 2: Becks Baker ($100.83 in chips)
Seat 3: vovvesvart ($128.29 in chips)
Seat 5: G.Andrei95 ($77.36 in chips)
Seat 6: Rezzonner ($68.12 in chips)
G.Andrei95: posts small blind $0.25
Rezzonner: posts big blind $0.50
*** HOLE CARDS ***
Straubje: calls $0.50
Becks Baker: raises $1.50 to $2
vovvesvart: calls $2
G.Andrei95: folds
Rezzonner: folds
Straubje: calls $1.50
*** FLOP *** [Ts 3d Js]
Straubje: checks
Becks Baker: checks
vovvesvart: checks
*** TURN *** [Ts 3d Js] [4s]
Straubje: checks
Becks Baker: checks
vovvesvart: checks
*** RIVER *** [Ts 3d Js 4s] [Qs]
Straubje: checks
Becks Baker: checks
vovvesvart: checks
*** SHOW DOWN ***
Straubje: shows [9h 7d] (high card Queen)
Becks Baker: shows [5h 5d] (a pair of Fives)
vovvesvart: mucks hand
Becks Baker collected $6.41 from pot
*** SUMMARY ***
Total pot $6.75 | Rake $0.34
Board [Ts 3d Js 4s Qs]
Seat 1: Straubje showed [9h 7d] and lost with high card Queen
Seat 2: Becks Baker showed [5h 5d] and won ($6.41) with a pair of Fives
Seat 3: vovvesvart (button) mucked
Seat 5: G.Andrei95 (small blind) folded before Flop
Seat 6: Rezzonner (big blind) folded before Flop


PokerStars Hand #208961068648:  Hold'em No Limit ($0.25/$0.50 USD) - 2020/02/07 21:39:04 ET
Table 'Bohmia IV' 6-max Seat #6 is the button
Seat 1: Straubje ($48.39 in chips)
Seat 2: Becks Baker ($105.24 in chips)
Seat 3: vovvesvart ($126.29 in chips)
Seat 5: G.Andrei95 ($78.47 in chips)
Seat 6: Rezzonner ($67.37 in chips)
Straubje: posts small blind $0.25
Becks Baker: posts big blind $0.50
Meskalita: sits out
*** HOLE CARDS ***
vovvesvart: raises $0.50 to $1
G.Andrei95: folds
Rezzonner: folds
Straubje: folds
Becks Baker: folds
Uncalled bet ($0.50) returned to vovvesvart
vovvesvart collected $1.25 from pot
vovvesvart: doesn't show hand
*** SUMMARY ***
Total pot $1.25 | Rake $0
Seat 1: Straubje (small blind) folded before Flop
Seat 2: Becks Baker (big blind) folded before Flop
Seat 3: vovvesvart collected ($1.25)
Seat 5: G.Andrei95 folded before Flop (didn't bet)
Seat 6: Rezzonner (button) folded before Flop (didn't bet)


PokerStars Hand #208961053148:  Hold'em No Limit ($0.25/$0.50 USD) - 2020/02/07 21:38:08 ET
Table 'Bohmia IV' 6-max Seat #5 is the button
Seat 1: Straubje ($49.64 in chips)
Seat 2: Becks Baker ($105.24 in chips)
Seat 3: vovvesvart ($126.29 in chips)
Seat 5: G.Andrei95 ($77.11 in chips)
Seat 6: Rezzonner ($67.62 in chips)
Rezzonner: posts small blind $0.25
Straubje: posts big blind $0.50
Meskalita: sits out
*** HOLE CARDS ***
Becks Baker: folds
vovvesvart: folds
G.Andrei95: raises $0.75 to $1.25
Rezzonner: folds
Straubje: calls $0.75
*** FLOP *** [Tc 3s 8d]
Straubje: checks
G.Andrei95: bets $0.86
Straubje: folds
Uncalled bet ($0.86) returned to G.Andrei95
G.Andrei95 collected $2.61 from pot
G.Andrei95: doesn't show hand
*** SUMMARY ***
Total pot $2.75 | Rake $0.14
Board [Tc 3s 8d]
Seat 1: Straubje (big blind) folded on the Flop
Seat 2: Becks Baker folded before Flop (didn't bet)
Seat 3: vovvesvart folded before Flop (didn't bet)
Seat 5: G.Andrei95 (button) collected ($2.61)
Seat 6: Rezzonner (small blind) folded before Flop


PokerStars Hand #208961092279:  Hold'em No Limit ($0.25/$0.50 USD) - 2020/02/07 21:39:20 ET
Table 'Bohmia IV' 6-max Seat #1 is the button
Seat 1: Straubje ($48.14 in chips)
Seat 2: Becks Baker ($104.74 in chips)
Seat 3: vovvesvart ($127.04 in chips)
Seat 5: G.Andrei95 ($78.47 in chips)
Seat 6: Rezzonner ($67.37 in chips)
Becks Baker: posts small blind $0.25
vovvesvart: posts big blind $0.50
Meskalita: sits out
*** HOLE CARDS ***
G.Andrei95: folds
Rezzonner: raises $0.75 to $1.25
Straubje has timed out
Straubje: folds
Becks Baker: folds
vovvesvart: calls $0.75
*** FLOP *** [2c 2d 2h]
vovvesvart: checks
Rezzonner: bets $0.86
vovvesvart: calls $0.86
*** TURN *** [2c 2d 2h] [8c]
vovvesvart: checks
Rezzonner: checks
*** RIVER *** [2c 2d 2h 8c] [9d]
vovvesvart: checks
Rezzonner: bets $3
vovvesvart: calls $3
*** SHOW DOWN ***
Rezzonner: shows [Ts Jh] (three of a kind, Deuces)
vovvesvart: shows [6s Ad] (three of a kind, Deuces - Ace kicker)
vovvesvart collected $9.95 from pot
*** SUMMARY ***
Total pot $10.47 | Rake $0.52
Board [2c 2d 2h 8c 9d]
Seat 1: Straubje (button) folded before Flop (didn't bet)
Seat 2: Becks Baker (small blind) folded before Flop
Seat 3: vovvesvart (big blind) showed [6s Ad] and won ($9.95) with three of a kind, Deuces
Seat 5: G.Andrei95 folded before Flop (didn't bet)
Seat 6: Rezzonner showed [Ts Jh] and lost with three of a kind, Deuces


PokerStars Hand #208961108397:  Hold'em No Limit ($0.25/$0.50 USD) - 2020/02/07 21:40:18 ET
Table 'Bohmia IV' 6-max Seat #2 is the button
Seat 1: Straubje ($48.14 in chips)
Seat 2: Becks Baker ($104.49 in chips)
Seat 3: vovvesvart ($131.88 in chips)
Seat 4: Meskalita ($50 in chips)
Seat 5: G.Andrei95 ($78.47 in chips)
Seat 6: Rezzonner ($62.26 in chips)
vovvesvart: posts small blind $0.25
Meskalita: posts big blind $0.50
*** HOLE CARDS ***
G.Andrei95: folds
Rezzonner: raises $0.75 to $1.25
Straubje: raises $1.75 to $3
Becks Baker: folds
vovvesvart: calls $2.75
Meskalita: folds
Rezzonner: raises $9 to $12
Straubje: raises $36.14 to $48.14 and is all-in
vovvesvart: folds
Rezzonner: calls $36.14
*** FLOP *** [9h 4c 3c]
*** TURN *** [9h 4c 3c] [4d]
*** RIVER *** [9h 4c 3c 4d] [8d]
*** SHOW DOWN ***
Rezzonner: shows [Kh As] (a pair of Fours)
Straubje: shows [Qd Qh] (two pair, Queens and Fours)
Straubje collected $97.78 from pot
*** SUMMARY ***
Total pot $99.78 | Rake $2
Board [9h 4c 3c 4d 8d]
Seat 1: Straubje showed [Qd Qh] and won ($97.78) with two pair, Queens and Fours
Seat 2: Becks Baker (button) folded before Flop (didn't bet)
Seat 3: vovvesvart (small blind) folded before Flop
Seat 4: Meskalita (big blind) folded before Flop
Seat 5: G.Andrei95 folded before Flop (didn't bet)
Seat 6: Rezzonner showed [Kh As] and lost with a pair of Fours


PokerStars Hand #208961125266:  Hold'em No Limit ($0.25/$0.50 USD) - 2020/02/07 21:41:18 ET
Table 'Bohmia IV' 6-max Seat #3 is the button
Seat 1: Straubje ($97.78 in chips)
Seat 2: Becks Baker ($104.49 in chips)
Seat 3: vovvesvart ($128.88 in chips)
Seat 4: Meskalita ($50 in chips)
Seat 5: G.Andrei95 ($78.47 in chips)
Seat 6: Rezzonner ($50 in chips)
Meskalita: posts small blind $0.25
G.Andrei95: posts big blind $0.50
*** HOLE CARDS ***
Rezzonner: folds
Straubje: raises $2 to $2.50
Becks Baker: folds
vovvesvart: folds
Meskalita: folds
G.Andrei95: folds
Uncalled bet ($2) returned to Straubje
Straubje collected $1.25 from pot
Straubje: doesn't show hand
*** SUMMARY ***
Total pot $1.25 | Rake $0
Seat 1: Straubje collected ($1.25)
Seat 2: Becks Baker folded before Flop (didn't bet)
Seat 3: vovvesvart (button) folded before Flop (didn't bet)
Seat 4: Meskalita (small blind) folded before Flop
Seat 5: G.Andrei95 (big blind) folded before Flop
Seat 6: Rezzonner folded before Flop (didn't bet)


PokerStars Hand #208961129876:  Hold'em No Limit ($0.25/$0.50 USD) - 2020/02/07 21:41:35 ET
Table 'Bohmia IV' 6-max Seat #4 is the button
Seat 1: Straubje ($98.53 in chips)
Seat 2: Becks Baker ($104.49 in chips)
Seat 3: vovvesvart ($128.88 in chips)
Seat 4: Meskalita ($50 in chips)
Seat 5: G.Andrei95 ($77.97 in chips)
Seat 6: Rezzonner ($50 in chips)
G.Andrei95: posts small blind $0.25
Rezzonner: posts big blind $0.50
*** HOLE CARDS ***
Straubje: folds
Becks Baker: folds
vovvesvart has timed out
vovvesvart: folds
Meskalita: raises $0.75 to $1.25
G.Andrei95: folds
Rezzonner: raises $3.75 to $5
Meskalita: calls $3.75
*** FLOP *** [4c 3c Td]
Rezzonner: bets $3.21
Meskalita: raises $5.29 to $8.50
Straubje is disconnected
Rezzonner: folds
Uncalled bet ($5.29) returned to Meskalita
Meskalita collected $15.84 from pot
Meskalita: doesn't show hand
*** SUMMARY ***
Total pot $16.67 | Rake $0.83
Board [4c 3c Td]
Seat 1: Straubje folded before Flop (didn't bet)
Seat 2: Becks Baker folded before Flop (didn't bet)
Seat 3: vovvesvart folded before Flop (didn't bet)
Seat 4: Meskalita (button) collected ($15.84)
Seat 5: G.Andrei95 (small blind) folded before Flop
Seat 6: Rezzonner (big blind) folded on the Flop


PokerStars Hand #208961150910:  Hold'em No Limit ($0.25/$0.50 USD) - 2020/02/07 21:42:50 ET
Table 'Bohmia IV' 6-max Seat #5 is the button
Seat 3: vovvesvart ($128.88 in chips)
Seat 4: Meskalita ($57.63 in chips)
Seat 5: G.Andrei95 ($77.72 in chips)
Seat 6: Rezzonner ($50 in chips)
Rezzonner: posts small blind $0.25
Becks Baker: is sitting out
vovvesvart: posts big blind $0.50
*** HOLE CARDS ***
Becks Baker leaves the table
Meskalita: raises $0.75 to $1.25
G.Andrei95: folds
Rezzonner: folds
vovvesvart: calls $0.75
*** FLOP *** [Kh 5c 9c]
vovvesvart: checks
Meskalita: checks
*** TURN *** [Kh 5c 9c] [7d]
vovvesvart: bets $1.31
Meskalita: calls $1.31
*** RIVER *** [Kh 5c 9c 7d] [3h]
vovvesvart: checks
Meskalita: checks
*** SHOW DOWN ***
vovvesvart: shows [7h 6h] (a pair of Sevens)
Meskalita: mucks hand
vovvesvart collected $5.10 from pot
*** SUMMARY ***
Total pot $5.37 | Rake $0.27
Board [Kh 5c 9c 7d 3h]
Seat 3: vovvesvart (big blind) showed [7h 6h] and won ($5.10) with a pair of Sevens
Seat 4: Meskalita mucked
Seat 5: G.Andrei95 (button) folded before Flop (didn't bet)
Seat 6: Rezzonner (small blind) folded before Flop


PokerStars Hand #208961176649:  Hold'em No Limit ($0.25/$0.50 USD) - 2020/02/07 21:44:22 ET
Table 'Bohmia IV' 6-max Seat #3 is the button
Seat 3: vovvesvart ($81.42 in chips)
Seat 4: Meskalita ($54.57 in chips)
Seat 5: G.Andrei95 ($76.47 in chips)
Seat 6: Rezzonner ($101 in chips)
Meskalita: posts small blind $0.25
G.Andrei95: posts big blind $0.50
*** HOLE CARDS ***
Rezzonner: folds
vovvesvart: folds
Meskalita: folds
Uncalled bet ($0.25) returned to G.Andrei95
G.Andrei95 collected $0.50 from pot
G.Andrei95: doesn't show hand
*** SUMMARY ***
Total pot $0.50 | Rake $0
Seat 3: vovvesvart (button) folded before Flop (didn't bet)
Seat 4: Meskalita (small blind) folded before Flop
Seat 5: G.Andrei95 (big blind) collected ($0.50)
Seat 6: Rezzonner folded before Flop (didn't bet)


PokerStars Hand #208961163544:  Hold'em No Limit ($0.25/$0.50 USD) - 2020/02/07 21:43:36 ET
Table 'Bohmia IV' 6-max Seat #6 is the button
Seat 3: vovvesvart ($131.42 in chips)
Seat 4: Meskalita ($55.07 in chips)
Seat 5: G.Andrei95 ($77.72 in chips)
Seat 6: Rezzonner ($50 in chips)
vovvesvart: posts small blind $0.25
Meskalita: posts big blind $0.50
*** HOLE CARDS ***
G.Andrei95: raises $0.75 to $1.25
Rezzonner: raises $2.75 to $4
vovvesvart: calls $3.75
Meskalita: folds
G.Andrei95: folds
*** FLOP *** [7c 4d 8d]
vovvesvart: checks
Rezzonner: bets $4.63
vovvesvart: raises $122.79 to $127.42 and is all-in
Rezzonner: calls $41.37 and is all-in
Uncalled bet ($81.42) returned to vovvesvart
*** TURN *** [7c 4d 8d] [6d]
*** RIVER *** [7c 4d 8d 6d] [4s]
*** SHOW DOWN ***
vovvesvart: shows [4c 3c] (three of a kind, Fours)
Rezzonner: shows [8s 8c] (a full house, Eights full of Fours)
Rezzonner collected $101 from pot
*** SUMMARY ***
Total pot $101.75 | Rake $0.75
Board [7c 4d 8d 6d 4s]
Seat 3: vovvesvart (small blind) showed [4c 3c] and lost with three of a kind, Fours
Seat 4: Meskalita (big blind) folded before Flop
Seat 5: G.Andrei95 folded before Flop
Seat 6: Rezzonner (button) showed [8s 8c] and won ($101) with a full house, Eights full of Fours


PokerStars Hand #208961187537:  Hold'em No Limit ($0.25/$0.50 USD) - 2020/02/07 21:45:02 ET
Table 'Bohmia IV' 6-max Seat #5 is the button
Seat 3: vovvesvart ($83.52 in chips)
Seat 4: Meskalita ($54.32 in chips)
Seat 5: G.Andrei95 ($76.47 in chips)
Seat 6: Rezzonner ($98.93 in chips)
Rezzonner: posts small blind $0.25
vovvesvart: posts big blind $0.50
*** HOLE CARDS ***
Meskalita: raises $0.75 to $1.25
G.Andrei95: folds
Rezzonner: folds
vovvesvart: calls $0.75
*** FLOP *** [4s 5h Jc]
vovvesvart: checks
Meskalita: bets $0.65
vovvesvart: calls $0.65
*** TURN *** [4s 5h Jc] [5d]
vovvesvart: checks
Meskalita: checks
*** RIVER *** [4s 5h Jc 5d] [8d]
vovvesvart: checks
Meskalita: checks
*** SHOW DOWN ***
vovvesvart: shows [3s Qh] (a pair of Fives)
Meskalita: shows [Ac 7h] (a pair of Fives - Ace kicker)
Meskalita collected $3.85 from pot
*** SUMMARY ***
Total pot $4.05 | Rake $0.20
Board [4s 5h Jc 5d 8d]
Seat 3: vovvesvart (big blind) showed [3s Qh] and lost with a pair of Fives
Seat 4: Meskalita showed [Ac 7h] and won ($3.85) with a pair of Fives
Seat 5: G.Andrei95 (button) folded before Flop (didn't bet)
Seat 6: Rezzonner (small blind) folded before Flop


PokerStars Hand #208961178763:  Hold'em No Limit ($0.25/$0.50 USD) - 2020/02/07 21:44:30 ET
Table 'Bohmia IV' 6-max Seat #4 is the button
Seat 3: vovvesvart ($81.42 in chips)
Seat 4: Meskalita ($54.32 in chips)
Seat 5: G.Andrei95 ($76.72 in chips)
Seat 6: Rezzonner ($101 in chips)
G.Andrei95: posts small blind $0.25
Rezzonner: posts big blind $0.50
*** HOLE CARDS ***
vovvesvart: raises $0.50 to $1
Meskalita: folds
G.Andrei95: folds
Rezzonner: calls $0.50
*** FLOP *** [Ks 8h 7c]
Rezzonner: checks
vovvesvart: bets $1.07
Rezzonner: calls $1.07
*** TURN *** [Ks 8h 7c] [Ac]
Rezzonner: checks
vovvesvart: checks
*** RIVER *** [Ks 8h 7c Ac] [5s]
Bula71 joins the table at seat #2
Rezzonner: checks
Bula71 leaves the table
vovvesvart: checks
ZonTTT joins the table at seat #2
*** SHOW DOWN ***
Rezzonner: shows [6d 7s] (a pair of Sevens)
vovvesvart: shows [Td 8d] (a pair of Eights)
vovvesvart collected $4.17 from pot
*** SUMMARY ***
Total pot $4.39 | Rake $0.22
Board [Ks 8h 7c Ac 5s]
Seat 3: vovvesvart showed [Td 8d] and won ($4.17) with a pair of Eights
Seat 4: Meskalita (button) folded before Flop (didn't bet)
Seat 5: G.Andrei95 (small blind) folded before Flop
Seat 6: Rezzonner (big blind) showed [6d 7s] and lost with a pair of Sevens


PokerStars Hand #208961196019:  Hold'em No Limit ($0.25/$0.50 USD) - 2020/02/07 21:45:32 ET
Table 'Bohmia IV' 6-max Seat #6 is the button
Seat 3: vovvesvart ($81.62 in chips)
Seat 4: Meskalita ($56.27 in chips)
Seat 5: G.Andrei95 ($76.47 in chips)
Seat 6: Rezzonner ($98.68 in chips)
vovvesvart: posts small blind $0.25
Meskalita: posts big blind $0.50
*** HOLE CARDS ***
G.Andrei95: raises $0.75 to $1.25
Rezzonner: folds
vovvesvart: calls $1
Meskalita: folds
*** FLOP *** [7s 5s 8c]
vovvesvart: bets $0.50
G.Andrei95: calls $0.50
*** TURN *** [7s 5s 8c] [Ts]
vovvesvart: bets $0.50
G.Andrei95: calls $0.50
*** RIVER *** [7s 5s 8c Ts] [2d]
vovvesvart: checks
G.Andrei95: checks
*** SHOW DOWN ***
vovvesvart: shows [Qc 9h] (high card Queen)
G.Andrei95: shows [Ah Qs] (high card Ace)
G.Andrei95 collected $4.75 from pot
*** SUMMARY ***
Total pot $5 | Rake $0.25
Board [7s 5s 8c Ts 2d]
Seat 3: vovvesvart (small blind) showed [Qc 9h] and lost with high card Queen
Seat 4: Meskalita (big blind) folded before Flop
Seat 5: G.Andrei95 showed [Ah Qs] and won ($4.75) with high card Ace
Seat 6: Rezzonner (button) folded before Flop (didn't bet)


PokerStars Hand #208961223679:  Hold'em No Limit ($0.25/$0.50 USD) - 2020/02/07 21:47:12 ET
Table 'Bohmia IV' 6-max Seat #5 is the button
Seat 1: Straubje ($98.53 in chips)
Seat 3: vovvesvart ($49.62 in chips)
Seat 4: Meskalita ($50.02 in chips)
Seat 5: G.Andrei95 ($114.22 in chips)
Seat 6: Rezzonner ($98.18 in chips)
Rezzonner: posts small blind $0.25
Straubje: posts big blind $0.50
ZonTTT: sits out
*** HOLE CARDS ***
vovvesvart: folds
Meskalita: raises $0.75 to $1.25
G.Andrei95: folds
Rezzonner: folds
Straubje: folds
Uncalled bet ($0.75) returned to Meskalita
G.Andrei95 said, "i fold if u bet"
Meskalita collected $1.25 from pot
Meskalita: doesn't show hand
*** SUMMARY ***
Total pot $1.25 | Rake $0
Seat 1: Straubje (big blind) folded before Flop
Seat 3: vovvesvart folded before Flop (didn't bet)
Seat 4: Meskalita collected ($1.25)
Seat 5: G.Andrei95 (button) folded before Flop (didn't bet)
Seat 6: Rezzonner (small blind) folded before Flop


PokerStars Hand #208961220076:  Hold'em No Limit ($0.25/$0.50 USD) - 2020/02/07 21:46:59 ET
Table 'Bohmia IV' 6-max Seat #4 is the button
Seat 3: vovvesvart ($48.87 in chips)
Seat 4: Meskalita ($50.02 in chips)
Seat 5: G.Andrei95 ($114.47 in chips)
Seat 6: Rezzonner ($98.68 in chips)
G.Andrei95: posts small blind $0.25
Rezzonner: posts big blind $0.50
Straubje: sits out
ZonTTT: sits out
*** HOLE CARDS ***
vovvesvart: raises $1 to $1.50
Meskalita: folds
G.Andrei95: folds
Rezzonner: folds
Uncalled bet ($1) returned to vovvesvart
vovvesvart collected $1.25 from pot
vovvesvart: doesn't show hand
*** SUMMARY ***
Total pot $1.25 | Rake $0
Seat 3: vovvesvart collected ($1.25)
Seat 4: Meskalita (button) folded before Flop (didn't bet)
Seat 5: G.Andrei95 (small blind) folded before Flop
Seat 6: Rezzonner (big blind) folded before Flop


PokerStars Hand #208961202618:  Hold'em No Limit ($0.25/$0.50 USD) - 2020/02/07 21:45:56 ET
Table 'Bohmia IV' 6-max Seat #3 is the button
Seat 3: vovvesvart ($79.37 in chips)
Seat 4: Meskalita ($55.77 in chips)
Seat 5: G.Andrei95 ($78.97 in chips)
Seat 6: Rezzonner ($98.68 in chips)
Meskalita: posts small blind $0.25
G.Andrei95: posts big blind $0.50
ZonTTT: sits out
*** HOLE CARDS ***
Rezzonner: folds
vovvesvart: raises $1 to $1.50
Meskalita: raises $4.25 to $5.75
G.Andrei95: calls $5.25
vovvesvart: calls $4.25
*** FLOP *** [Qs 2c 4c]
Meskalita: checks
G.Andrei95: checks
vovvesvart: bets $8.25
Meskalita: folds
G.Andrei95: calls $8.25
*** TURN *** [Qs 2c 4c] [4h]
G.Andrei95: checks
vovvesvart: bets $16.50
G.Andrei95: calls $16.50
*** RIVER *** [Qs 2c 4c 4h] [8h]
G.Andrei95: checks
vovvesvart: checks
*** SHOW DOWN ***
G.Andrei95: shows [9h 9d] (two pair, Nines and Fours)
vovvesvart: mucks hand
G.Andrei95 collected $66 from pot
*** SUMMARY ***
Total pot $66.75 | Rake $0.75
Board [Qs 2c 4c 4h 8h]
Seat 3: vovvesvart (button) mucked
Seat 4: Meskalita (small blind) folded on the Flop
Seat 5: G.Andrei95 (big blind) showed [9h 9d] and won ($66) with two pair, Nines and Fours
Seat 6: Rezzonner folded before Flop (didn't bet)


PokerStars Hand #208961227752:  Hold'em No Limit ($0.25/$0.50 USD) - 2020/02/07 21:47:26 ET
Table 'Bohmia IV' 6-max Seat #6 is the button
Seat 1: Straubje ($98.03 in chips)
Seat 2: ZonTTT ($50 in chips)
Seat 3: vovvesvart ($49.62 in chips)
Seat 4: Meskalita ($50.77 in chips)
Seat 5: G.Andrei95 ($114.22 in chips)
Seat 6: Rezzonner ($97.93 in chips)
Straubje: posts small blind $0.25
ZonTTT: posts big blind $0.50
*** HOLE CARDS ***
G.Andrei95 said, "again"
vovvesvart: folds
Meskalita: folds
G.Andrei95: folds
Rezzonner: raises $0.75 to $1.25
Straubje: calls $1
ZonTTT: folds
*** FLOP *** [Th 7h Kd]
Straubje: checks
Rezzonner: checks
*** TURN *** [Th 7h Kd] [Jc]
Straubje: checks
Rezzonner: bets $1.55
Straubje: folds
Uncalled bet ($1.55) returned to Rezzonner
Rezzonner collected $2.85 from pot
Rezzonner: doesn't show hand
*** SUMMARY ***
Total pot $3 | Rake $0.15
Board [Th 7h Kd Jc]
Seat 1: Straubje (small blind) folded on the Turn
Seat 2: ZonTTT (big blind) folded before Flop
Seat 3: vovvesvart folded before Flop (didn't bet)
Seat 4: Meskalita folded before Flop (didn't bet)
Seat 5: G.Andrei95 folded before Flop (didn't bet)
Seat 6: Rezzonner (button) collected ($2.85)


PokerStars Hand #208961239759:  Hold'em No Limit ($0.25/$0.50 USD) - 2020/02/07 21:48:10 ET
Table 'Bohmia IV' 6-max Seat #1 is the button
Seat 1: Straubje ($96.78 in chips)
Seat 2: ZonTTT ($50 in chips)
Seat 3: vovvesvart ($49.62 in chips)
Seat 4: Meskalita ($50.77 in chips)
Seat 5: G.Andrei95 ($114.22 in chips)
Seat 6: Rezzonner ($99.53 in chips)
ZonTTT: posts small blind $0.25
vovvesvart: posts big blind $0.50
*** HOLE CARDS ***
Meskalita: folds
G.Andrei95: folds
Rezzonner: folds
Straubje: folds
ZonTTT: calls $0.25
vovvesvart: checks
*** FLOP *** [3c 4c 8h]
ZonTTT: checks
vovvesvart: bets $0.50
ZonTTT: folds
Uncalled bet ($0.50) returned to vovvesvart
vovvesvart collected $0.95 from pot
vovvesvart: doesn't show hand
*** SUMMARY ***
Total pot $1 | Rake $0.05
Board [3c 4c 8h]
Seat 1: Straubje (button) folded before Flop (didn't bet)
Seat 2: ZonTTT (small blind) folded on the Flop
Seat 3: vovvesvart (big blind) collected ($0.95)
Seat 4: Meskalita folded before Flop (didn't bet)
Seat 5: G.Andrei95 folded before Flop (didn't bet)
Seat 6: Rezzonner folded before Flop (didn't bet)


PokerStars Hand #208961255414:  Hold'em No Limit ($0.25/$0.50 USD) - 2020/02/07 21:49:07 ET
Table 'Bohmia IV' 6-max Seat #3 is the button
Seat 1: Straubje ($96.78 in chips)
Seat 2: ZonTTT ($50 in chips)
Seat 3: vovvesvart ($46.32 in chips)
Seat 4: Meskalita ($54.14 in chips)
Seat 5: G.Andrei95 ($114.22 in chips)
Seat 6: Rezzonner ($99.53 in chips)
Meskalita: posts small blind $0.25
G.Andrei95: posts big blind $0.50
*** HOLE CARDS ***
Rezzonner: folds
Straubje has timed out
Straubje: folds
ZonTTT: raises $0.75 to $1.25
vovvesvart: calls $1.25
Meskalita: folds
G.Andrei95: folds
*** FLOP *** [2d 4c Jc]
ZonTTT: checks
vovvesvart: checks
*** TURN *** [2d 4c Jc] [Ts]
ZonTTT: checks
vovvesvart: checks
*** RIVER *** [2d 4c Jc Ts] [Qh]
ZonTTT: checks
vovvesvart: checks
*** SHOW DOWN ***
ZonTTT: shows [Ah 4h] (a pair of Fours)
vovvesvart: mucks hand
ZonTTT collected $3.09 from pot
*** SUMMARY ***
Total pot $3.25 | Rake $0.16
Board [2d 4c Jc Ts Qh]
Seat 1: Straubje folded before Flop (didn't bet)
Seat 2: ZonTTT showed [Ah 4h] and won ($3.09) with a pair of Fours
Seat 3: vovvesvart (button) mucked
Seat 4: Meskalita (small blind) folded before Flop
Seat 5: G.Andrei95 (big blind) folded before Flop
Seat 6: Rezzonner folded before Flop (didn't bet)


PokerStars Hand #208961245001:  Hold'em No Limit ($0.25/$0.50 USD) - 2020/02/07 21:48:29 ET
Table 'Bohmia IV' 6-max Seat #2 is the button
Seat 1: Straubje ($96.78 in chips)
Seat 2: ZonTTT ($50 in chips)
Seat 3: vovvesvart ($50.07 in chips)
Seat 4: Meskalita ($50.77 in chips)
Seat 5: G.Andrei95 ($114.22 in chips)
Seat 6: Rezzonner ($99.53 in chips)
vovvesvart: posts small blind $0.25
Meskalita: posts big blind $0.50
*** HOLE CARDS ***
G.Andrei95: folds
Rezzonner: folds
Straubje: folds
ZonTTT: folds
vovvesvart: raises $0.50 to $1
Meskalita: raises $2.75 to $3.75
vovvesvart: calls $2.75
*** FLOP *** [Js 3d Qc]
vovvesvart: checks
Meskalita: bets $2.35
vovvesvart: folds
Uncalled bet ($2.35) returned to Meskalita
Meskalita collected $7.12 from pot
Meskalita: doesn't show hand
*** SUMMARY ***
Total pot $7.50 | Rake $0.38
Board [Js 3d Qc]
Seat 1: Straubje folded before Flop (didn't bet)
Seat 2: ZonTTT (button) folded before Flop (didn't bet)
Seat 3: vovvesvart (small blind) folded on the Flop
Seat 4: Meskalita (big blind) collected ($7.12)
Seat 5: G.Andrei95 folded before Flop (didn't bet)
Seat 6: Rezzonner folded before Flop (didn't bet)


PokerStars Hand #208961273296:  Hold'em No Limit ($0.25/$0.50 USD) - 2020/02/07 21:49:55 ET
Table 'Bohmia IV' 6-max Seat #4 is the button
Seat 1: Straubje ($96.78 in chips)
Seat 2: ZonTTT ($51.84 in chips)
Seat 3: vovvesvart ($45.07 in chips)
Seat 4: Meskalita ($53.89 in chips)
Seat 5: G.Andrei95 ($113.72 in chips)
Seat 6: Rezzonner ($99.53 in chips)
G.Andrei95: posts small blind $0.25
Rezzonner: posts big blind $0.50
*** HOLE CARDS ***
Straubje: calls $0.50
ZonTTT: folds
vovvesvart: raises $0.50 to $1
Meskalita: folds
G.Andrei95: folds
Rezzonner: folds
Straubje: calls $0.50
*** FLOP *** [Qh 4s 7d]
Straubje: bets $1.50
vovvesvart: folds
Uncalled bet ($1.50) returned to Straubje
Straubje collected $2.61 from pot
Straubje: doesn't show hand
*** SUMMARY ***
Total pot $2.75 | Rake $0.14
Board [Qh 4s 7d]
Seat 1: Straubje collected ($2.61)
Seat 2: ZonTTT folded before Flop (didn't bet)
Seat 3: vovvesvart folded on the Flop
Seat 4: Meskalita (button) folded before Flop (didn't bet)
Seat 5: G.Andrei95 (small blind) folded before Flop
Seat 6: Rezzonner (big blind) folded before Flop


PokerStars Hand #208961281183:  Hold'em No Limit ($0.25/$0.50 USD) - 2020/02/07 21:50:23 ET
Table 'Bohmia IV' 6-max Seat #5 is the button
Seat 1: Straubje ($98.39 in chips)
Seat 2: ZonTTT ($51.84 in chips)
Seat 3: vovvesvart ($44.07 in chips)
Seat 4: Meskalita ($53.89 in chips)
Seat 5: G.Andrei95 ($113.47 in chips)
Seat 6: Rezzonner ($99.03 in chips)
Rezzonner: posts small blind $0.25
Straubje: posts big blind $0.50
*** HOLE CARDS ***
ZonTTT: folds
vovvesvart: folds
Meskalita: folds
G.Andrei95: raises $0.75 to $1.25
Rezzonner: folds
Straubje: calls $0.75
*** FLOP *** [8d 9s Tc]
Straubje: checks
G.Andrei95: bets $1.50
Straubje: folds
Uncalled bet ($1.50) returned to G.Andrei95
G.Andrei95 collected $2.61 from pot
G.Andrei95: doesn't show hand
*** SUMMARY ***
Total pot $2.75 | Rake $0.14
Board [8d 9s Tc]
Seat 1: Straubje (big blind) folded on the Flop
Seat 2: ZonTTT folded before Flop (didn't bet)
Seat 3: vovvesvart folded before Flop (didn't bet)
Seat 4: Meskalita folded before Flop (didn't bet)
Seat 5: G.Andrei95 (button) collected ($2.61)
Seat 6: Rezzonner (small blind) folded before Flop


PokerStars Hand #208961289579:  Hold'em No Limit ($0.25/$0.50 USD) - 2020/02/07 21:50:54 ET
Table 'Bohmia IV' 6-max Seat #6 is the button
Seat 1: Straubje ($97.14 in chips)
Seat 2: ZonTTT ($51.84 in chips)
Seat 3: vovvesvart ($44.07 in chips)
Seat 4: Meskalita ($53.89 in chips)
Seat 5: G.Andrei95 ($114.83 in chips)
Seat 6: Rezzonner ($98.78 in chips)
Straubje: posts small blind $0.25
ZonTTT: posts big blind $0.50
*** HOLE CARDS ***
vovvesvart: raises $0.50 to $1
Meskalita: folds
G.Andrei95: folds
Rezzonner: raises $3 to $4
Straubje: calls $3.75
ZonTTT: folds
vovvesvart: calls $3
*** FLOP *** [Tc Ts 5d]
Straubje: bets $5
vovvesvart: folds
Rezzonner: calls $5
*** TURN *** [Tc Ts 5d] [5s]
Straubje: checks
Rezzonner: bets $7.06
Straubje: calls $7.06
*** RIVER *** [Tc Ts 5d 5s] [8s]
Straubje: bets $17.50
Rezzonner: folds
Uncalled bet ($17.50) returned to Straubje
Straubje collected $34.79 from pot
Straubje: doesn't show hand
*** SUMMARY ***
Total pot $36.62 | Rake $1.83
Board [Tc Ts 5d 5s 8s]
Seat 1: Straubje (small blind) collected ($34.79)
Seat 2: ZonTTT (big blind) folded before Flop
Seat 3: vovvesvart folded on the Flop
Seat 4: Meskalita folded before Flop (didn't bet)
Seat 5: G.Andrei95 folded before Flop (didn't bet)
Seat 6: Rezzonner (button) folded on the River


PokerStars Hand #208961320223:  Hold'em No Limit ($0.25/$0.50 USD) - 2020/02/07 21:52:47 ET
Table 'Bohmia IV' 6-max Seat #1 is the button
Seat 1: Straubje ($115.87 in chips)
Seat 2: ZonTTT ($51.34 in chips)
Seat 3: vovvesvart ($40.07 in chips)
Seat 4: Meskalita ($53.89 in chips)
Seat 5: G.Andrei95 ($114.83 in chips)
Seat 6: Rezzonner ($82.72 in chips)
ZonTTT: posts small blind $0.25
vovvesvart: posts big blind $0.50
*** HOLE CARDS ***
Meskalita: folds
G.Andrei95: folds
Rezzonner: folds
Straubje: raises $2 to $2.50
ZonTTT: folds
vovvesvart: calls $2
*** FLOP *** [7d 6c 5s]
vovvesvart: checks
Straubje: bets $3.50
vovvesvart: calls $3.50
*** TURN *** [7d 6c 5s] [3h]
vovvesvart: checks
Straubje: bets $13
vovvesvart: calls $13
*** RIVER *** [7d 6c 5s 3h] [3c]
vovvesvart: checks
Straubje: bets $96.87 and is all-in
vovvesvart: folds
Uncalled bet ($96.87) returned to Straubje
Straubje collected $36.34 from pot
Straubje: doesn't show hand
*** SUMMARY ***
Total pot $38.25 | Rake $1.91
Board [7d 6c 5s 3h 3c]
Seat 1: Straubje (button) collected ($36.34)
Seat 2: ZonTTT (small blind) folded before Flop
Seat 3: vovvesvart (big blind) folded on the River
Seat 4: Meskalita folded before Flop (didn't bet)
Seat 5: G.Andrei95 folded before Flop (didn't bet)
Seat 6: Rezzonner folded before Flop (didn't bet)


PokerStars Hand #208961332295:  Hold'em No Limit ($0.25/$0.50 USD) - 2020/02/07 21:53:31 ET
Table 'Bohmia IV' 6-max Seat #2 is the button
Seat 1: Straubje ($133.21 in chips)
Seat 2: ZonTTT ($51.09 in chips)
Seat 3: vovvesvart ($21.07 in chips)
Seat 4: Meskalita ($53.89 in chips)
Seat 5: G.Andrei95 ($114.83 in chips)
Seat 6: Rezzonner ($82.72 in chips)
vovvesvart: posts small blind $0.25
Meskalita: posts big blind $0.50
*** HOLE CARDS ***
G.Andrei95: folds
Rezzonner: raises $0.75 to $1.25
Straubje: folds
ZonTTT: folds
vovvesvart: folds
Meskalita: raises $3.75 to $5
Rezzonner: folds
Uncalled bet ($3.75) returned to Meskalita
Meskalita collected $2.75 from pot
Meskalita: doesn't show hand
*** SUMMARY ***
Total pot $2.75 | Rake $0
Seat 1: Straubje folded before Flop (didn't bet)
Seat 2: ZonTTT (button) folded before Flop (didn't bet)
Seat 3: vovvesvart (small blind) folded before Flop
Seat 4: Meskalita (big blind) collected ($2.75)
Seat 5: G.Andrei95 folded before Flop (didn't bet)
Seat 6: Rezzonner folded before Flop


PokerStars Hand #208961345785:  Hold'em No Limit ($0.25/$0.50 USD) - 2020/02/07 21:54:21 ET
Table 'Bohmia IV' 6-max Seat #3 is the button
Seat 1: Straubje ($133.21 in chips)
Seat 2: ZonTTT ($51.09 in chips)
Seat 3: vovvesvart ($20.82 in chips)
Seat 4: Meskalita ($55.39 in chips)
Seat 5: G.Andrei95 ($114.83 in chips)
Seat 6: Rezzonner ($81.47 in chips)
Meskalita: posts small blind $0.25
G.Andrei95: posts big blind $0.50
*** HOLE CARDS ***
Rezzonner: folds
Straubje: folds
ZonTTT: folds
vovvesvart: raises $1.25 to $1.75
Rezzonner leaves the table
Meskalita: folds
G.Andrei95: calls $1.25
*** FLOP *** [Ad 5d 2c]
G.Andrei95: checks
vovvesvart: checks
*** TURN *** [Ad 5d 2c] [7d]
Straubje said, "faster please rezzonner:) where you from?"
G.Andrei95: checks
vovvesvart: checks
*** RIVER *** [Ad 5d 2c 7d] [3h]
G.Andrei95: checks
vovvesvart: checks
*** SHOW DOWN ***
G.Andrei95: shows [Qc 6c] (high card Ace)
vovvesvart: shows [Jc Qd] (high card Ace - Queen+Jack kicker)
vovvesvart collected $3.56 from pot
*** SUMMARY ***
Total pot $3.75 | Rake $0.19
Board [Ad 5d 2c 7d 3h]
Seat 1: Straubje folded before Flop (didn't bet)
Seat 2: ZonTTT folded before Flop (didn't bet)
Seat 3: vovvesvart (button) showed [Jc Qd] and won ($3.56) with high card Ace
Seat 4: Meskalita (small blind) folded before Flop
Seat 5: G.Andrei95 (big blind) showed [Qc 6c] and lost with high card Ace
Seat 6: Rezzonner folded before Flop (didn't bet)


PokerStars Hand #208961375965:  Hold'em No Limit ($0.25/$0.50 USD) - 2020/02/07 21:55:59 ET
Table 'Bohmia IV' 6-max Seat #5 is the button
Seat 1: Straubje ($132.71 in chips)
Seat 2: ZonTTT ($51.09 in chips)
Seat 3: vovvesvart ($22.01 in chips)
Seat 4: Meskalita ($54.51 in chips)
Seat 5: G.Andrei95 ($112.83 in chips)
Straubje: posts small blind $0.25
ZonTTT: posts big blind $0.50
*** HOLE CARDS ***
vovvesvart: folds
Meskalita: folds
G.Andrei95: folds
Straubje: raises $1.50 to $2
ZonTTT: folds
Uncalled bet ($1.50) returned to Straubje
Straubje collected $1 from pot
Straubje: doesn't show hand
*** SUMMARY ***
Total pot $1 | Rake $0
Seat 1: Straubje (small blind) collected ($1)
Seat 2: ZonTTT (big blind) folded before Flop
Seat 3: vovvesvart folded before Flop (didn't bet)
Seat 4: Meskalita folded before Flop (didn't bet)
Seat 5: G.Andrei95 (button) folded before Flop (didn't bet)


PokerStars Hand #208961379098:  Hold'em No Limit ($0.25/$0.50 USD) - 2020/02/07 21:56:13 ET
Table 'Bohmia IV' 6-max Seat #1 is the button
Seat 1: Straubje ($133.21 in chips)
Seat 2: ZonTTT ($50.59 in chips)
Seat 3: vovvesvart ($22.01 in chips)
Seat 4: Meskalita ($54.51 in chips)
Seat 5: G.Andrei95 ($112.83 in chips)
ZonTTT: posts small blind $0.25
vovvesvart: posts big blind $0.50
*** HOLE CARDS ***
Meskalita: raises $0.75 to $1.25
G.Andrei95: folds
Straubje: calls $1.25
ZonTTT: folds
vovvesvart: calls $0.75
*** FLOP *** [5d Kd Qs]
vovvesvart: checks
Meskalita: checks
Straubje: bets $2
G.Andrei95 said, "wtf? u had 150$ when u lost them?"
vovvesvart: folds
Meskalita: folds
Uncalled bet ($2) returned to Straubje
Straubje collected $3.80 from pot
Straubje: doesn't show hand
*** SUMMARY ***
Total pot $4 | Rake $0.20
Board [5d Kd Qs]
Seat 1: Straubje (button) collected ($3.80)
Seat 2: ZonTTT (small blind) folded before Flop
Seat 3: vovvesvart (big blind) folded on the Flop
Seat 4: Meskalita folded on the Flop
Seat 5: G.Andrei95 folded before Flop (didn't bet)


PokerStars Hand #208961365641:  Hold'em No Limit ($0.25/$0.50 USD) - 2020/02/07 21:55:13 ET
Table 'Bohmia IV' 6-max Seat #4 is the button
Seat 1: Straubje ($133.21 in chips)
Seat 2: ZonTTT ($51.09 in chips)
Seat 3: vovvesvart ($22.63 in chips)
Seat 4: Meskalita ($55.14 in chips)
Seat 5: G.Andrei95 ($113.08 in chips)
G.Andrei95: posts small blind $0.25
Straubje: posts big blind $0.50
*** HOLE CARDS ***
ZonTTT: folds
vovvesvart: raises $1 to $1.50
Meskalita: raises $2.50 to $4
G.Andrei95: folds
Straubje: folds
vovvesvart: raises $18.63 to $22.63 and is all-in
Meskalita: calls $18.63
*** FLOP *** [Ts 8s Jh]
*** TURN *** [Ts 8s Jh] [Kc]
*** RIVER *** [Ts 8s Jh Kc] [Qd]
*** SHOW DOWN ***
vovvesvart: shows [Td As] (a straight, Ten to Ace)
Meskalita: shows [Ah Qs] (a straight, Ten to Ace)
vovvesvart collected $22.01 from pot
Meskalita collected $22 from pot
*** SUMMARY ***
Total pot $46.01 | Rake $2
Board [Ts 8s Jh Kc Qd]
Seat 1: Straubje (big blind) folded before Flop
Seat 2: ZonTTT folded before Flop (didn't bet)
Seat 3: vovvesvart showed [Td As] and won ($22.01) with a straight, Ten to Ace
Seat 4: Meskalita (button) showed [Ah Qs] and won ($22) with a straight, Ten to Ace
Seat 5: G.Andrei95 (small blind) folded before Flop


PokerStars Hand #208961386019:  Hold'em No Limit ($0.25/$0.50 USD) - 2020/02/07 21:56:45 ET
Table 'Bohmia IV' 6-max Seat #2 is the button
Seat 1: Straubje ($135.76 in chips)
Seat 2: ZonTTT ($50.34 in chips)
Seat 3: vovvesvart ($20.76 in chips)
Seat 4: Meskalita ($53.26 in chips)
Seat 5: G.Andrei95 ($112.83 in chips)
vovvesvart: posts small blind $0.25
Meskalita: posts big blind $0.50
*** HOLE CARDS ***
G.Andrei95 said, "now u play short stak strategy?"
G.Andrei95: folds
Straubje: calls $0.50
ZonTTT: folds
vovvesvart: raises $1.50 to $2
Meskalita: folds
Straubje: calls $1.50
*** FLOP *** [9d 3s 4h]
liryka joins the table at seat #6
vovvesvart: bets $4.28
Straubje: calls $4.28
*** TURN *** [9d 3s 4h] [8s]
vovvesvart: bets $14.48 and is all-in
Straubje: calls $14.48
*** RIVER *** [9d 3s 4h 8s] [9h]
*** SHOW DOWN ***
vovvesvart: shows [Jc Ts] (a pair of Nines)
Straubje: shows [4c 5d] (two pair, Nines and Fours)
Straubje collected $40.02 from pot
*** SUMMARY ***
Total pot $42.02 | Rake $2
Board [9d 3s 4h 8s 9h]
Seat 1: Straubje showed [4c 5d] and won ($40.02) with two pair, Nines and Fours
Seat 2: ZonTTT (button) folded before Flop (didn't bet)
Seat 3: vovvesvart (small blind) showed [Jc Ts] and lost with a pair of Nines
Seat 4: Meskalita (big blind) folded before Flop
Seat 5: G.Andrei95 folded before Flop (didn't bet)


PokerStars Hand #208961392709:  Hold'em No Limit ($0.25/$0.50 USD) - 2020/02/07 21:57:15 ET
Table 'Bohmia IV' 6-max Seat #4 is the button
Seat 1: Straubje ($155.02 in chips)
Seat 2: ZonTTT ($50.34 in chips)
Seat 4: Meskalita ($52.76 in chips)
Seat 5: G.Andrei95 ($112.83 in chips)
G.Andrei95: posts small blind $0.25
Straubje: posts big blind $0.50
*** HOLE CARDS ***
ZonTTT: folds
Meskalita: raises $0.75 to $1.25
G.Andrei95: folds
liryka leaves the table
Straubje: calls $0.75
*** FLOP *** [7c 8s Kh]
vovvesvart leaves the table
Lexusloal joins the table at seat #3
Straubje: bets $2
Meskalita: calls $2
*** TURN *** [7c 8s Kh] [9s]
Straubje: bets $4
Meskalita: calls $4
*** RIVER *** [7c 8s Kh 9s] [Qc]
Lexusloal leaves the table
Straubje: bets $7
Meskalita: folds
Uncalled bet ($7) returned to Straubje
Straubje collected $14.01 from pot
Straubje: doesn't show hand
*** SUMMARY ***
Total pot $14.75 | Rake $0.74
Board [7c 8s Kh 9s Qc]
Seat 1: Straubje (big blind) collected ($14.01)
Seat 2: ZonTTT folded before Flop (didn't bet)
Seat 4: Meskalita (button) folded on the River
Seat 5: G.Andrei95 (small blind) folded before Flop


PokerStars Hand #208958171037:  Hold'em No Limit ($0.25/$0.50 USD) - 2020/02/07 19:18:04 ET
Table 'Aaltje III' 6-max Seat #4 is the button
Seat 1: SWING BOLOO ($50.86 in chips)
Seat 2: romixon36 ($50 in chips)
Seat 3: supersimple2018 ($50 in chips)
Seat 4: Flyyguyy403 ($48.77 in chips)
Seat 5: Clamfish0 ($51.50 in chips)
Seat 6: JuanAlmighty ($98.75 in chips)
Clamfish0: posts small blind $0.25
JuanAlmighty: posts big blind $0.50
*** HOLE CARDS ***
SWING BOLOO: calls $0.50
romixon36: folds
supersimple2018: raises $1.50 to $2
Flyyguyy403: folds
Clamfish0: folds
JuanAlmighty: folds
SWING BOLOO: calls $1.50
*** FLOP *** [Ts Td Th]
SWING BOLOO: bets $1
supersimple2018: raises $2.50 to $3.50
SWING BOLOO: calls $2.50
*** TURN *** [Ts Td Th] [9d]
SWING BOLOO: checks
supersimple2018: checks
*** RIVER *** [Ts Td Th 9d] [3s]
SWING BOLOO: checks
supersimple2018: bets $4.50
SWING BOLOO: folds
Uncalled bet ($4.50) returned to supersimple2018
supersimple2018 collected $11.16 from pot
supersimple2018: doesn't show hand
*** SUMMARY ***
Total pot $11.75 | Rake $0.59
Board [Ts Td Th 9d 3s]
Seat 1: SWING BOLOO folded on the River
Seat 2: romixon36 folded before Flop (didn't bet)
Seat 3: supersimple2018 collected ($11.16)
Seat 4: Flyyguyy403 (button) folded before Flop (didn't bet)
Seat 5: Clamfish0 (small blind) folded before Flop
Seat 6: JuanAlmighty (big blind) folded before Flop


PokerStars Hand #208958231767:  Hold'em No Limit ($0.25/$0.50 USD) - 2020/02/07 19:20:32 ET
Table 'Aaltje III' 6-max Seat #5 is the button
Seat 1: SWING BOLOO ($45.36 in chips)
Seat 2: romixon36 ($50 in chips)
Seat 3: supersimple2018 ($55.66 in chips)
Seat 4: Flyyguyy403 ($48.77 in chips)
Seat 5: Clamfish0 ($51.25 in chips)
Seat 6: JuanAlmighty ($98.25 in chips)
JuanAlmighty: posts small blind $0.25
SWING BOLOO: posts big blind $0.50
*** HOLE CARDS ***
romixon36: folds
supersimple2018: folds
Flyyguyy403: calls $0.50
Clamfish0: folds
JuanAlmighty: folds
SWING BOLOO: checks
*** FLOP *** [3s 8d 4c]
SWING BOLOO: checks
Flyyguyy403: bets $1
SWING BOLOO: folds
Uncalled bet ($1) returned to Flyyguyy403
Flyyguyy403 collected $1.19 from pot
Flyyguyy403: doesn't show hand
*** SUMMARY ***
Total pot $1.25 | Rake $0.06
Board [3s 8d 4c]
Seat 1: SWING BOLOO (big blind) folded on the Flop
Seat 2: romixon36 folded before Flop (didn't bet)
Seat 3: supersimple2018 folded before Flop (didn't bet)
Seat 4: Flyyguyy403 collected ($1.19)
Seat 5: Clamfish0 (button) folded before Flop (didn't bet)
Seat 6: JuanAlmighty (small blind) folded before Flop


PokerStars Hand #208958242124:  Hold'em No Limit ($0.25/$0.50 USD) - 2020/02/07 19:20:58 ET
Table 'Aaltje III' 6-max Seat #6 is the button
Seat 1: SWING BOLOO ($44.86 in chips)
Seat 2: romixon36 ($50 in chips)
Seat 3: supersimple2018 ($55.66 in chips)
Seat 4: Flyyguyy403 ($49.46 in chips)
Seat 5: Clamfish0 ($51.25 in chips)
Seat 6: JuanAlmighty ($98 in chips)
SWING BOLOO: posts small blind $0.25
romixon36: posts big blind $0.50
*** HOLE CARDS ***
supersimple2018: folds
Flyyguyy403: folds
Clamfish0: folds
JuanAlmighty: raises $0.65 to $1.15
SWING BOLOO: calls $0.90
romixon36: calls $0.65
*** FLOP *** [3d Ts As]
SWING BOLOO: bets $1
romixon36: folds
JuanAlmighty: calls $1
*** TURN *** [3d Ts As] [Td]
SWING BOLOO: bets $1
JuanAlmighty: raises $6.50 to $7.50
SWING BOLOO: folds
Uncalled bet ($6.50) returned to JuanAlmighty
JuanAlmighty collected $7.08 from pot
JuanAlmighty: doesn't show hand
*** SUMMARY ***
Total pot $7.45 | Rake $0.37
Board [3d Ts As Td]
Seat 1: SWING BOLOO (small blind) folded on the Turn
Seat 2: romixon36 (big blind) folded on the Flop
Seat 3: supersimple2018 folded before Flop (didn't bet)
Seat 4: Flyyguyy403 folded before Flop (didn't bet)
Seat 5: Clamfish0 folded before Flop (didn't bet)
Seat 6: JuanAlmighty (button) collected ($7.08)


PokerStars Hand #208958276429:  Hold'em No Limit ($0.25/$0.50 USD) - 2020/02/07 19:22:16 ET
Table 'Aaltje III' 6-max Seat #2 is the button
Seat 1: SWING BOLOO ($41.71 in chips)
Seat 2: romixon36 ($50 in chips)
Seat 3: supersimple2018 ($55.16 in chips)
Seat 4: Flyyguyy403 ($48.96 in chips)
Seat 5: Clamfish0 ($51.25 in chips)
Seat 6: JuanAlmighty ($103.18 in chips)
supersimple2018: posts small blind $0.25
Flyyguyy403: posts big blind $0.50
*** HOLE CARDS ***
Clamfish0: folds
JuanAlmighty: folds
SWING BOLOO: raises $0.50 to $1
romixon36: folds
supersimple2018: folds
Flyyguyy403: folds
Uncalled bet ($0.50) returned to SWING BOLOO
SWING BOLOO collected $1.25 from pot
*** SUMMARY ***
Total pot $1.25 | Rake $0
Seat 1: SWING BOLOO collected ($1.25)
Seat 2: romixon36 (button) folded before Flop (didn't bet)
Seat 3: supersimple2018 (small blind) folded before Flop
Seat 4: Flyyguyy403 (big blind) folded before Flop
Seat 5: Clamfish0 folded before Flop (didn't bet)
Seat 6: JuanAlmighty folded before Flop (didn't bet)


PokerStars Hand #208958268858:  Hold'em No Limit ($0.25/$0.50 USD) - 2020/02/07 19:21:56 ET
Table 'Aaltje III' 6-max Seat #1 is the button
Seat 1: SWING BOLOO ($41.71 in chips)
Seat 2: romixon36 ($50 in chips)
Seat 3: supersimple2018 ($55.66 in chips)
Seat 4: Flyyguyy403 ($49.46 in chips)
Seat 5: Clamfish0 ($51.25 in chips)
Seat 6: JuanAlmighty ($101.93 in chips)
romixon36: posts small blind $0.25
supersimple2018: posts big blind $0.50
*** HOLE CARDS ***
Flyyguyy403: calls $0.50
Clamfish0: folds
JuanAlmighty: raises $1.75 to $2.25
SWING BOLOO: folds
romixon36: folds
supersimple2018: folds
Flyyguyy403: folds
Uncalled bet ($1.75) returned to JuanAlmighty
JuanAlmighty collected $1.75 from pot
*** SUMMARY ***
Total pot $1.75 | Rake $0
Seat 1: SWING BOLOO (button) folded before Flop (didn't bet)
Seat 2: romixon36 (small blind) folded before Flop
Seat 3: supersimple2018 (big blind) folded before Flop
Seat 4: Flyyguyy403 folded before Flop
Seat 5: Clamfish0 folded before Flop (didn't bet)
Seat 6: JuanAlmighty collected ($1.75)


PokerStars Hand #208958287041:  Hold'em No Limit ($0.25/$0.50 USD) - 2020/02/07 19:22:41 ET
Table 'Aaltje III' 6-max Seat #3 is the button
Seat 1: SWING BOLOO ($42.46 in chips)
Seat 2: romixon36 ($50 in chips)
Seat 3: supersimple2018 ($54.91 in chips)
Seat 5: Clamfish0 ($51.25 in chips)
Flyyguyy403 has timed out
Flyyguyy403: is sitting out
Clamfish0: posts small blind $0.25
JuanAlmighty: is sitting out
SWING BOLOO: posts big blind $0.50
*** HOLE CARDS ***
JuanAlmighty leaves the table
romixon36: folds
é=mc² joins the table at seat #6
é=mc² leaves the table
supersimple2018: raises $1 to $1.50
Clamfish0: folds
SWING BOLOO: calls $1
*** FLOP *** [3c 5s 2s]
Flyyguyy403 is disconnected
SWING BOLOO: bets $1.50
supersimple2018: calls $1.50
*** TURN *** [3c 5s 2s] [Qc]
SWING BOLOO: bets $4.50
supersimple2018: calls $4.50
*** RIVER *** [3c 5s 2s Qc] [Th]
SWING BOLOO: bets $25
doselka joins the table at seat #6
supersimple2018: folds
Uncalled bet ($25) returned to SWING BOLOO
SWING BOLOO collected $14.50 from pot
*** SUMMARY ***
Total pot $15.25 | Rake $0.75
Board [3c 5s 2s Qc Th]
Seat 1: SWING BOLOO (big blind) collected ($14.50)
Seat 2: romixon36 folded before Flop (didn't bet)
Seat 3: supersimple2018 (button) folded on the River
Seat 5: Clamfish0 (small blind) folded before Flop


PokerStars Hand #208958329545:  Hold'em No Limit ($0.25/$0.50 USD) - 2020/02/07 19:24:19 ET
Table 'Aaltje III' 6-max Seat #5 is the button
Seat 1: SWING BOLOO ($49.46 in chips)
Seat 2: romixon36 ($50 in chips)
Seat 3: supersimple2018 ($50 in chips)
Seat 5: Clamfish0 ($51 in chips)
SWING BOLOO: posts small blind $0.25
romixon36: posts big blind $0.50
Flyyguyy403: sits out
*** HOLE CARDS ***
supersimple2018: folds
Clamfish0: folds
SWING BOLOO: raises $1 to $1.50
romixon36: raises $3 to $4.50
SWING BOLOO: calls $3
*** FLOP *** [8s Ac 5c]
SWING BOLOO: checks
romixon36: bets $2.48
SWING BOLOO: folds
Uncalled bet ($2.48) returned to romixon36
romixon36 collected $8.55 from pot
romixon36: doesn't show hand
*** SUMMARY ***
Total pot $9 | Rake $0.45
Board [8s Ac 5c]
Seat 1: SWING BOLOO (small blind) folded on the Flop
Seat 2: romixon36 (big blind) collected ($8.55)
Seat 3: supersimple2018 folded before Flop (didn't bet)
Seat 5: Clamfish0 (button) folded before Flop (didn't bet)


PokerStars Hand #208958376315:  Hold'em No Limit ($0.25/$0.50 USD) - 2020/02/07 19:26:17 ET
Table 'Aaltje III' 6-max Seat #2 is the button
Seat 1: SWING BOLOO ($44.96 in chips)
Seat 2: romixon36 ($53.80 in chips)
Seat 3: supersimple2018 ($52.85 in chips)
Seat 4: Flyyguyy403 ($48.46 in chips)
Seat 5: Clamfish0 ($50 in chips)
supersimple2018: posts small blind $0.25
Flyyguyy403: posts big blind $0.50
doselka: sits out
*** HOLE CARDS ***
Clamfish0: folds
SWING BOLOO: folds
romixon36: raises $0.75 to $1.25
supersimple2018: folds
Flyyguyy403: calls $0.75
*** FLOP *** [2c Ad 3d]
Flyyguyy403: checks
romixon36: bets $0.76
Flyyguyy403: folds
Uncalled bet ($0.76) returned to romixon36
romixon36 collected $2.61 from pot
romixon36: doesn't show hand
*** SUMMARY ***
Total pot $2.75 | Rake $0.14
Board [2c Ad 3d]
Seat 1: SWING BOLOO folded before Flop (didn't bet)
Seat 2: romixon36 (button) collected ($2.61)
Seat 3: supersimple2018 (small blind) folded before Flop
Seat 4: Flyyguyy403 (big blind) folded on the Flop
Seat 5: Clamfish0 folded before Flop (didn't bet)


PokerStars Hand #208958343789:  Hold'em No Limit ($0.25/$0.50 USD) - 2020/02/07 19:24:55 ET
Table 'Aaltje III' 6-max Seat #1 is the button
Seat 1: SWING BOLOO ($44.96 in chips)
Seat 2: romixon36 ($54.05 in chips)
Seat 3: supersimple2018 ($50 in chips)
Seat 5: Clamfish0 ($51 in chips)
romixon36: posts small blind $0.25
supersimple2018: posts big blind $0.50
Flyyguyy403: sits out
doselka: sits out
*** HOLE CARDS ***
Clamfish0: raises $0.83 to $1.33
SWING BOLOO: folds
romixon36: folds
supersimple2018: calls $0.83
*** FLOP *** [6d 8h Ts]
supersimple2018: checks
Clamfish0: bets $1.57
supersimple2018: calls $1.57
*** TURN *** [6d 8h Ts] [9d]
supersimple2018: checks
Clamfish0: checks
*** RIVER *** [6d 8h Ts 9d] [5d]
supersimple2018: bets $4.03
Clamfish0: folds
Uncalled bet ($4.03) returned to supersimple2018
supersimple2018 collected $5.75 from pot
supersimple2018: doesn't show hand
*** SUMMARY ***
Total pot $6.05 | Rake $0.30
Board [6d 8h Ts 9d 5d]
Seat 1: SWING BOLOO (button) folded before Flop (didn't bet)
Seat 2: romixon36 (small blind) folded before Flop
Seat 3: supersimple2018 (big blind) collected ($5.75)
Seat 5: Clamfish0 folded on the River


PokerStars Hand #208958389981:  Hold'em No Limit ($0.25/$0.50 USD) - 2020/02/07 19:26:51 ET
Table 'Aaltje III' 6-max Seat #3 is the button
Seat 1: SWING BOLOO ($44.96 in chips)
Seat 2: romixon36 ($55.16 in chips)
Seat 3: supersimple2018 ($52.60 in chips)
Seat 4: Flyyguyy403 ($47.21 in chips)
Seat 5: Clamfish0 ($50 in chips)
Flyyguyy403: posts small blind $0.25
Clamfish0: posts big blind $0.50
doselka: sits out
*** HOLE CARDS ***
SWING BOLOO: folds
romixon36: raises $0.60 to $1.10
supersimple2018: folds
Flyyguyy403: folds
Clamfish0: calls $0.60
*** FLOP *** [6h Qc 7h]
Clamfish0: checks
romixon36: checks
*** TURN *** [6h Qc 7h] [Kd]
Clamfish0: checks
romixon36: bets $1.19
Clamfish0: folds
Uncalled bet ($1.19) returned to romixon36
romixon36 collected $2.33 from pot
romixon36: doesn't show hand
*** SUMMARY ***
Total pot $2.45 | Rake $0.12
Board [6h Qc 7h Kd]
Seat 1: SWING BOLOO folded before Flop (didn't bet)
Seat 2: romixon36 collected ($2.33)
Seat 3: supersimple2018 (button) folded before Flop (didn't bet)
Seat 4: Flyyguyy403 (small blind) folded before Flop
Seat 5: Clamfish0 (big blind) folded on the Turn


PokerStars Hand #208958404992:  Hold'em No Limit ($0.25/$0.50 USD) - 2020/02/07 19:27:29 ET
Table 'Aaltje III' 6-max Seat #4 is the button
Seat 1: SWING BOLOO ($44.96 in chips)
Seat 2: romixon36 ($56.39 in chips)
Seat 3: supersimple2018 ($52.60 in chips)
Seat 4: Flyyguyy403 ($46.96 in chips)
Seat 5: Clamfish0 ($50 in chips)
Seat 6: doselka ($50 in chips)
Clamfish0: posts small blind $0.25
doselka: posts big blind $0.50
*** HOLE CARDS ***
SWING BOLOO: folds
romixon36: folds
supersimple2018: folds
Flyyguyy403: calls $0.50
Clamfish0: raises $2.04 to $2.54
doselka: folds
Flyyguyy403: calls $2.04
*** FLOP *** [Qh 2c 8s]
Clamfish0: bets $1.70
Flyyguyy403: calls $1.70
*** TURN *** [Qh 2c 8s] [Ts]
Clamfish0: checks
Flyyguyy403: bets $4.50
Clamfish0: folds
Uncalled bet ($4.50) returned to Flyyguyy403
Flyyguyy403 collected $8.53 from pot
Flyyguyy403: doesn't show hand
*** SUMMARY ***
Total pot $8.98 | Rake $0.45
Board [Qh 2c 8s Ts]
Seat 1: SWING BOLOO folded before Flop (didn't bet)
Seat 2: romixon36 folded before Flop (didn't bet)
Seat 3: supersimple2018 folded before Flop (didn't bet)
Seat 4: Flyyguyy403 (button) collected ($8.53)
Seat 5: Clamfish0 (small blind) folded on the Turn
Seat 6: doselka (big blind) folded before Flop


PokerStars Hand #208958433156:  Hold'em No Limit ($0.25/$0.50 USD) - 2020/02/07 19:28:40 ET
Table 'Aaltje III' 6-max Seat #5 is the button
Seat 1: SWING BOLOO ($44.96 in chips)
Seat 2: romixon36 ($56.39 in chips)
Seat 3: supersimple2018 ($52.60 in chips)
Seat 4: Flyyguyy403 ($51.25 in chips)
Seat 5: Clamfish0 ($50 in chips)
Seat 6: doselka ($50 in chips)
doselka: posts small blind $0.25
SWING BOLOO: posts big blind $0.50
*** HOLE CARDS ***
romixon36: folds
supersimple2018: folds
Flyyguyy403: calls $0.50
Clamfish0: folds
doselka: raises $2 to $2.50
SWING BOLOO: folds
Flyyguyy403: calls $2
*** FLOP *** [7h 2d 2c]
doselka has timed out
doselka: checks
Flyyguyy403: bets $1.50
doselka: folds
Uncalled bet ($1.50) returned to Flyyguyy403
Flyyguyy403 collected $5.22 from pot
Flyyguyy403: doesn't show hand
*** SUMMARY ***
Total pot $5.50 | Rake $0.28
Board [7h 2d 2c]
Seat 1: SWING BOLOO (big blind) folded before Flop
Seat 2: romixon36 folded before Flop (didn't bet)
Seat 3: supersimple2018 folded before Flop (didn't bet)
Seat 4: Flyyguyy403 collected ($5.22)
Seat 5: Clamfish0 (button) folded before Flop (didn't bet)
Seat 6: doselka (small blind) folded on the Flop


PokerStars Hand #208958463857:  Hold'em No Limit ($0.25/$0.50 USD) - 2020/02/07 19:29:42 ET
Table 'Aaltje III' 6-max Seat #6 is the button
Seat 1: SWING BOLOO ($44.46 in chips)
Seat 2: romixon36 ($56.39 in chips)
Seat 3: supersimple2018 ($52.60 in chips)
Seat 4: Flyyguyy403 ($53.97 in chips)
Seat 5: Clamfish0 ($50 in chips)
Seat 6: doselka ($50 in chips)
SWING BOLOO: posts small blind $0.25
romixon36: posts big blind $0.50
*** HOLE CARDS ***
supersimple2018: folds
Flyyguyy403: folds
supersimple2018 leaves the table
Clamfish0: raises $0.83 to $1.33
doselka: raises $2.42 to $3.75
SWING BOLOO: folds
romixon36: folds
Clamfish0: calls $2.42
*** FLOP *** [5d Ac Tc]
Flyyguyy403 is disconnected
Clamfish0: checks
doselka: bets $2.67
Clamfish0: calls $2.67
*** TURN *** [5d Ac Tc] [Js]
Clamfish0: checks
doselka: checks
*** RIVER *** [5d Ac Tc Js] [Ts]
Clamfish0: checks
doselka: checks
*** SHOW DOWN ***
Clamfish0: shows [Ad 8d] (two pair, Aces and Tens)
doselka: mucks hand
Clamfish0 collected $12.91 from pot
*** SUMMARY ***
Total pot $13.59 | Rake $0.68
Board [5d Ac Tc Js Ts]
Seat 1: SWING BOLOO (small blind) folded before Flop
Seat 2: romixon36 (big blind) folded before Flop
Seat 3: supersimple2018 folded before Flop (didn't bet)
Seat 4: Flyyguyy403 folded before Flop (didn't bet)
Seat 5: Clamfish0 showed [Ad 8d] and won ($12.91) with two pair, Aces and Tens
Seat 6: doselka (button) mucked


PokerStars Hand #208958507089:  Hold'em No Limit ($0.25/$0.50 USD) - 2020/02/07 19:31:32 ET
Table 'Aaltje III' 6-max Seat #2 is the button
Seat 1: SWING BOLOO ($44.21 in chips)
Seat 2: romixon36 ($55.64 in chips)
Seat 5: Clamfish0 ($57.24 in chips)
Seat 6: doselka ($50 in chips)
Clamfish0: posts small blind $0.25
doselka: posts big blind $0.50
*** HOLE CARDS ***
SWING BOLOO: folds
romixon36: raises $0.75 to $1.25
Clamfish0: raises $4.08 to $5.33
doselka: folds
romixon36: raises $6.17 to $11.50
Clamfish0: folds
Uncalled bet ($6.17) returned to romixon36
romixon36 collected $11.16 from pot
romixon36: doesn't show hand
*** SUMMARY ***
Total pot $11.16 | Rake $0
Seat 1: SWING BOLOO folded before Flop (didn't bet)
Seat 2: romixon36 (button) collected ($11.16)
Seat 5: Clamfish0 (small blind) folded before Flop
Seat 6: doselka (big blind) folded before Flop


PokerStars Hand #208958489906:  Hold'em No Limit ($0.25/$0.50 USD) - 2020/02/07 19:30:49 ET
Table 'Aaltje III' 6-max Seat #1 is the button
Seat 1: SWING BOLOO ($44.21 in chips)
Seat 2: romixon36 ($55.89 in chips)
Seat 4: Flyyguyy403 ($53.97 in chips)
Seat 5: Clamfish0 ($56.49 in chips)
Seat 6: doselka ($50 in chips)
romixon36: posts small blind $0.25
Flyyguyy403: posts big blind $0.50
*** HOLE CARDS ***
Clamfish0: raises $0.83 to $1.33
doselka: folds
SWING BOLOO: folds
romixon36: folds
ishuha joins the table at seat #3
Flyyguyy403 has timed out
Flyyguyy403: folds
Uncalled bet ($0.83) returned to Clamfish0
Clamfish0 collected $1.25 from pot
Clamfish0: doesn't show hand
*** SUMMARY ***
Total pot $1.25 | Rake $0
Seat 1: SWING BOLOO (button) folded before Flop (didn't bet)
Seat 2: romixon36 (small blind) folded before Flop
Seat 4: Flyyguyy403 (big blind) folded before Flop
Seat 5: Clamfish0 collected ($1.25)
Seat 6: doselka folded before Flop (didn't bet)


PokerStars Hand #208958523479:  Hold'em No Limit ($0.25/$0.50 USD) - 2020/02/07 19:32:15 ET
Table 'Aaltje III' 6-max Seat #5 is the button
Seat 1: SWING BOLOO ($44.21 in chips)
Seat 2: romixon36 ($61.47 in chips)
Seat 5: Clamfish0 ($51.91 in chips)
Seat 6: doselka ($50 in chips)
doselka: posts small blind $0.25
SWING BOLOO: posts big blind $0.50
ishuha: sits out
*** HOLE CARDS ***
romixon36: folds
Clamfish0: raises $0.83 to $1.33
doselka: folds
SWING BOLOO: folds
Uncalled bet ($0.83) returned to Clamfish0
Clamfish0 collected $1.25 from pot
*** SUMMARY ***
Total pot $1.25 | Rake $0
Seat 1: SWING BOLOO (big blind) folded before Flop
Seat 2: romixon36 folded before Flop (didn't bet)
Seat 5: Clamfish0 (button) collected ($1.25)
Seat 6: doselka (small blind) folded before Flop


PokerStars Hand #208958528225:  Hold'em No Limit ($0.25/$0.50 USD) - 2020/02/07 19:32:27 ET
Table 'Aaltje III' 6-max Seat #6 is the button
Seat 1: SWING BOLOO ($43.71 in chips)
Seat 2: romixon36 ($61.47 in chips)
Seat 5: Clamfish0 ($52.66 in chips)
Seat 6: doselka ($50 in chips)
SWING BOLOO: posts small blind $0.25
romixon36: posts big blind $0.50
ishuha: sits out
*** HOLE CARDS ***
Clamfish0: raises $0.83 to $1.33
doselka: folds
SWING BOLOO: calls $1.08
romixon36: folds
*** FLOP *** [9h Ah Js]
SWING BOLOO: checks
Clamfish0: checks
*** TURN *** [9h Ah Js] [8s]
SWING BOLOO: bets $2
Clamfish0: folds
Uncalled bet ($2) returned to SWING BOLOO
SWING BOLOO collected $3 from pot
*** SUMMARY ***
Total pot $3.16 | Rake $0.16
Board [9h Ah Js 8s]
Seat 1: SWING BOLOO (small blind) collected ($3)
Seat 2: romixon36 (big blind) folded before Flop
Seat 5: Clamfish0 folded on the Turn
Seat 6: doselka (button) folded before Flop (didn't bet)


PokerStars Hand #208958539198:  Hold'em No Limit ($0.25/$0.50 USD) - 2020/02/07 19:32:55 ET
Table 'Aaltje III' 6-max Seat #1 is the button
Seat 1: SWING BOLOO ($45.38 in chips)
Seat 2: romixon36 ($60.97 in chips)
Seat 3: ishuha ($50 in chips)
Seat 5: Clamfish0 ($51.33 in chips)
Seat 6: doselka ($50 in chips)
romixon36: posts small blind $0.25
ishuha: posts big blind $0.50
*** HOLE CARDS ***
Clamfish0: folds
doselka: folds
SWING BOLOO: folds
romixon36: folds
Uncalled bet ($0.25) returned to ishuha
ishuha collected $0.50 from pot
ishuha: doesn't show hand
*** SUMMARY ***
Total pot $0.50 | Rake $0
Seat 1: SWING BOLOO (button) folded before Flop (didn't bet)
Seat 2: romixon36 (small blind) folded before Flop
Seat 3: ishuha (big blind) collected ($0.50)
Seat 5: Clamfish0 folded before Flop (didn't bet)
Seat 6: doselka folded before Flop (didn't bet)


PokerStars Hand #208958542823:  Hold'em No Limit ($0.25/$0.50 USD) - 2020/02/07 19:33:05 ET
Table 'Aaltje III' 6-max Seat #2 is the button
Seat 1: SWING BOLOO ($45.38 in chips)
Seat 2: romixon36 ($60.72 in chips)
Seat 3: ishuha ($50.25 in chips)
Seat 5: Clamfish0 ($51.33 in chips)
Seat 6: doselka ($50 in chips)
ishuha: posts small blind $0.25
Clamfish0: posts big blind $0.50
*** HOLE CARDS ***
doselka: folds
SWING BOLOO: folds
romixon36: raises $0.75 to $1.25
ishuha: folds
Clamfish0: folds
Uncalled bet ($0.75) returned to romixon36
romixon36 collected $1.25 from pot
romixon36: doesn't show hand
*** SUMMARY ***
Total pot $1.25 | Rake $0
Seat 1: SWING BOLOO folded before Flop (didn't bet)
Seat 2: romixon36 (button) collected ($1.25)
Seat 3: ishuha (small blind) folded before Flop
Seat 5: Clamfish0 (big blind) folded before Flop
Seat 6: doselka folded before Flop (didn't bet)


PokerStars Hand #208958552432:  Hold'em No Limit ($0.25/$0.50 USD) - 2020/02/07 19:33:30 ET
Table 'Aaltje III' 6-max Seat #3 is the button
Seat 1: SWING BOLOO ($45.38 in chips)
Seat 2: romixon36 ($61.47 in chips)
Seat 3: ishuha ($50 in chips)
Seat 5: Clamfish0 ($50.83 in chips)
Seat 6: doselka ($50 in chips)
Clamfish0: posts small blind $0.25
doselka: posts big blind $0.50
*** HOLE CARDS ***
SWING BOLOO: folds
romixon36: folds
ishuha: raises $0.75 to $1.25
Clamfish0: folds
doselka: calls $0.75
*** FLOP *** [2d Js 6c]
doselka: checks
ishuha: checks
*** TURN *** [2d Js 6c] [As]
doselka: checks
ishuha: checks
*** RIVER *** [2d Js 6c As] [Qh]
doselka: bets $1.96
ishuha has timed out
ishuha: folds
Uncalled bet ($1.96) returned to doselka
doselka collected $2.61 from pot
doselka: doesn't show hand
*** SUMMARY ***
Total pot $2.75 | Rake $0.14
Board [2d Js 6c As Qh]
Seat 1: SWING BOLOO folded before Flop (didn't bet)
Seat 2: romixon36 folded before Flop (didn't bet)
Seat 3: ishuha (button) folded on the River
Seat 5: Clamfish0 (small blind) folded before Flop
Seat 6: doselka (big blind) collected ($2.61)


PokerStars Hand #208958577472:  Hold'em No Limit ($0.25/$0.50 USD) - 2020/02/07 19:34:35 ET
Table 'Aaltje III' 6-max Seat #5 is the button
Seat 1: SWING BOLOO ($45.38 in chips)
Seat 2: romixon36 ($61.47 in chips)
Seat 3: ishuha ($50 in chips)
Seat 5: Clamfish0 ($50.58 in chips)
Seat 6: doselka ($51.36 in chips)
doselka: posts small blind $0.25
SWING BOLOO: posts big blind $0.50
*** HOLE CARDS ***
romixon36: folds
ishuha: folds
Clamfish0: folds
doselka: folds
Uncalled bet ($0.25) returned to SWING BOLOO
SWING BOLOO collected $0.50 from pot
*** SUMMARY ***
Total pot $0.50 | Rake $0
Seat 1: SWING BOLOO (big blind) collected ($0.50)
Seat 2: romixon36 folded before Flop (didn't bet)
Seat 3: ishuha folded before Flop (didn't bet)
Seat 5: Clamfish0 (button) folded before Flop (didn't bet)
Seat 6: doselka (small blind) folded before Flop


PokerStars Hand #208958599083:  Hold'em No Limit ($0.25/$0.50 USD) - 2020/02/07 19:35:31 ET
Table 'Aaltje III' 6-max Seat #1 is the button
Seat 1: SWING BOLOO ($47.94 in chips)
Seat 2: romixon36 ($60.22 in chips)
Seat 5: Clamfish0 ($50.58 in chips)
Seat 6: doselka ($50 in chips)
romixon36: posts small blind $0.25
Clamfish0: posts big blind $0.50
*** HOLE CARDS ***
doselka: folds
SWING BOLOO: calls $0.50
romixon36: folds
Clamfish0: checks
*** FLOP *** [Qc Qd Qs]
Clamfish0: checks
SWING BOLOO: bets $1.50
Glushchenko joins the table at seat #3
Clamfish0: folds
Uncalled bet ($1.50) returned to SWING BOLOO
SWING BOLOO collected $1.19 from pot
*** SUMMARY ***
Total pot $1.25 | Rake $0.06
Board [Qc Qd Qs]
Seat 1: SWING BOLOO (button) collected ($1.19)
Seat 2: romixon36 (small blind) folded before Flop
Seat 5: Clamfish0 (big blind) folded on the Flop
Seat 6: doselka folded before Flop (didn't bet)


PokerStars Hand #208958584122:  Hold'em No Limit ($0.25/$0.50 USD) - 2020/02/07 19:34:52 ET
Table 'Aaltje III' 6-max Seat #6 is the button
Seat 1: SWING BOLOO ($45.63 in chips)
Seat 2: romixon36 ($61.47 in chips)
Seat 3: ishuha ($50 in chips)
Seat 5: Clamfish0 ($50.58 in chips)
Seat 6: doselka ($51.11 in chips)
SWING BOLOO: posts small blind $0.25
romixon36: posts big blind $0.50
*** HOLE CARDS ***
ishuha: folds
Clamfish0: folds
doselka: raises $0.75 to $1.25
SWING BOLOO: calls $1
romixon36: calls $0.75
*** FLOP *** [Jc 9h Ad]
SWING BOLOO: bets $3
romixon36: folds
ishuha leaves the table
doselka: folds
Uncalled bet ($3) returned to SWING BOLOO
SWING BOLOO collected $3.56 from pot
*** SUMMARY ***
Total pot $3.75 | Rake $0.19
Board [Jc 9h Ad]
Seat 1: SWING BOLOO (small blind) collected ($3.56)
Seat 2: romixon36 (big blind) folded on the Flop
Seat 3: ishuha folded before Flop (didn't bet)
Seat 5: Clamfish0 folded before Flop (didn't bet)
Seat 6: doselka (button) folded on the Flop


PokerStars Hand #208958643217:  Hold'em No Limit ($0.25/$0.50 USD) - 2020/02/07 19:37:10 ET
Table 'Aaltje III' 6-max Seat #6 is the button
Seat 1: SWING BOLOO ($54.26 in chips)
Seat 2: romixon36 ($59.97 in chips)
Seat 5: Clamfish0 ($50 in chips)
Seat 6: doselka ($50 in chips)
SWING BOLOO: posts small blind $0.25
romixon36: posts big blind $0.50
*** HOLE CARDS ***
Clamfish0: folds
doselka: folds
SWING BOLOO: calls $0.25
romixon36: raises $1.50 to $2
SWING BOLOO: folds
Uncalled bet ($1.50) returned to romixon36
romixon36 collected $1 from pot
romixon36: doesn't show hand
*** SUMMARY ***
Total pot $1 | Rake $0
Seat 1: SWING BOLOO (small blind) folded before Flop
Seat 2: romixon36 (big blind) collected ($1)
Seat 5: Clamfish0 folded before Flop (didn't bet)
Seat 6: doselka (button) folded before Flop (didn't bet)


PokerStars Hand #208958607638:  Hold'em No Limit ($0.25/$0.50 USD) - 2020/02/07 19:35:53 ET
Table 'Aaltje III' 6-max Seat #2 is the button
Seat 1: SWING BOLOO ($48.63 in chips)
Seat 2: romixon36 ($59.97 in chips)
Seat 5: Clamfish0 ($50.08 in chips)
Seat 6: doselka ($50 in chips)
Clamfish0: posts small blind $0.25
doselka: posts big blind $0.50
*** HOLE CARDS ***
SWING BOLOO: raises $2 to $2.50
romixon36: folds
Clamfish0: folds
doselka: folds
Uncalled bet ($2) returned to SWING BOLOO
SWING BOLOO collected $1.25 from pot
*** SUMMARY ***
Total pot $1.25 | Rake $0
Seat 1: SWING BOLOO collected ($1.25)
Seat 2: romixon36 (button) folded before Flop (didn't bet)
Seat 5: Clamfish0 (small blind) folded before Flop
Seat 6: doselka (big blind) folded before Flop


PokerStars Hand #208958667794:  Hold'em No Limit ($0.25/$0.50 USD) - 2020/02/07 19:38:15 ET
Table 'Aaltje III' 6-max Seat #2 is the button
Seat 1: SWING BOLOO ($54.15 in chips)
Seat 2: romixon36 ($60.22 in chips)
Seat 5: Clamfish0 ($50 in chips)
Clamfish0: posts small blind $0.25
SWING BOLOO: posts big blind $0.50
*** HOLE CARDS ***
romixon36: folds
Clamfish0: raises $1.36 to $1.86
SWING BOLOO: folds
Uncalled bet ($1.36) returned to Clamfish0
Clamfish0 collected $1 from pot
Clamfish0: doesn't show hand
*** SUMMARY ***
Total pot $1 | Rake $0
Seat 1: SWING BOLOO (big blind) folded before Flop
Seat 2: romixon36 (button) folded before Flop (didn't bet)
Seat 5: Clamfish0 (small blind) collected ($1)


PokerStars Hand #208958660460:  Hold'em No Limit ($0.25/$0.50 USD) - 2020/02/07 19:37:55 ET
Table 'Aaltje III' 6-max Seat #1 is the button
Seat 1: SWING BOLOO ($53.01 in chips)
Seat 2: romixon36 ($60.47 in chips)
Seat 5: Clamfish0 ($50.75 in chips)
romixon36: posts small blind $0.25
Clamfish0: posts big blind $0.50
*** HOLE CARDS ***
SWING BOLOO: raises $0.50 to $1
romixon36: folds
Clamfish0: calls $0.50
*** FLOP *** [Js 4s Kh]
Clamfish0: checks
SWING BOLOO: bets $2
Clamfish0: folds
Uncalled bet ($2) returned to SWING BOLOO
SWING BOLOO collected $2.14 from pot
*** SUMMARY ***
Total pot $2.25 | Rake $0.11
Board [Js 4s Kh]
Seat 1: SWING BOLOO (button) collected ($2.14)
Seat 2: romixon36 (small blind) folded before Flop
Seat 5: Clamfish0 (big blind) folded on the Flop


PokerStars Hand #208958653655:  Hold'em No Limit ($0.25/$0.50 USD) - 2020/02/07 19:37:38 ET
Table 'Aaltje III' 6-max Seat #2 is the button
Seat 1: SWING BOLOO ($53.76 in chips)
Seat 2: romixon36 ($60.22 in chips)
Seat 5: Clamfish0 ($50 in chips)
Clamfish0: posts small blind $0.25
doselka: is sitting out
SWING BOLOO: posts big blind $0.50
*** HOLE CARDS ***
romixon36: raises $0.75 to $1.25
Clamfish0: folds
doselka leaves the table
SWING BOLOO: folds
Uncalled bet ($0.75) returned to romixon36
romixon36 collected $1.25 from pot
romixon36: doesn't show hand
*** SUMMARY ***
Total pot $1.25 | Rake $0
Seat 1: SWING BOLOO (big blind) folded before Flop
Seat 2: romixon36 (button) collected ($1.25)
Seat 5: Clamfish0 (small blind) folded before Flop


PokerStars Hand #208958650292:  Hold'em No Limit ($0.25/$0.50 USD) - 2020/02/07 19:37:29 ET
Table 'Aaltje III' 6-max Seat #1 is the button
Seat 1: SWING BOLOO ($53.76 in chips)
Seat 2: romixon36 ($60.47 in chips)
Seat 5: Clamfish0 ($50 in chips)
Seat 6: doselka ($50 in chips)
romixon36: posts small blind $0.25
Clamfish0: posts big blind $0.50
*** HOLE CARDS ***
doselka: raises $0.75 to $1.25
é=mc² joins the table at seat #3
SWING BOLOO: folds
é=mc² leaves the table
romixon36: folds
Clamfish0: folds
Uncalled bet ($0.75) returned to doselka
doselka collected $1.25 from pot
Flyyguyy403 was removed from the table for failing to post
Flyyguyy403 leaves the table
doselka: doesn't show hand
*** SUMMARY ***
Total pot $1.25 | Rake $0
Seat 1: SWING BOLOO (button) folded before Flop (didn't bet)
Seat 2: romixon36 (small blind) folded before Flop
Seat 5: Clamfish0 (big blind) folded before Flop
Seat 6: doselka collected ($1.25)


PokerStars Hand #208958619764:  Hold'em No Limit ($0.25/$0.50 USD) - 2020/02/07 19:36:24 ET
Table 'Aaltje III' 6-max Seat #5 is the button
Seat 1: SWING BOLOO ($49.38 in chips)
Seat 2: romixon36 ($59.97 in chips)
Seat 5: Clamfish0 ($50 in chips)
Seat 6: doselka ($50 in chips)
doselka: posts small blind $0.25
SWING BOLOO: posts big blind $0.50
Glushchenko: sits out
*** HOLE CARDS ***
romixon36: folds
Glushchenko leaves the table
Clamfish0: raises $0.83 to $1.33
doselka: folds
SWING BOLOO: raises $0.83 to $2.16
Clamfish0: calls $0.83
*** FLOP *** [Ad 4c 7d]
SWING BOLOO: bets $3
Clamfish0: calls $3
*** TURN *** [Ad 4c 7d] [4h]
SWING BOLOO: bets $5
Clamfish0: folds
Uncalled bet ($5) returned to SWING BOLOO
SWING BOLOO collected $10.04 from pot
*** SUMMARY ***
Total pot $10.57 | Rake $0.53
Board [Ad 4c 7d 4h]
Seat 1: SWING BOLOO (big blind) collected ($10.04)
Seat 2: romixon36 folded before Flop (didn't bet)
Seat 5: Clamfish0 (button) folded on the Turn
Seat 6: doselka (small blind) folded before Flop


PokerStars Hand #208958656638:  Hold'em No Limit ($0.25/$0.50 USD) - 2020/02/07 19:37:45 ET
Table 'Aaltje III' 6-max Seat #5 is the button
Seat 1: SWING BOLOO ($53.26 in chips)
Seat 2: romixon36 ($60.97 in chips)
Seat 5: Clamfish0 ($50 in chips)
SWING BOLOO: posts small blind $0.25
romixon36: posts big blind $0.50
*** HOLE CARDS ***
Clamfish0: raises $0.83 to $1.33
SWING BOLOO: folds
romixon36: folds
Uncalled bet ($0.83) returned to Clamfish0
Clamfish0 collected $1.25 from pot
*** SUMMARY ***
Total pot $1.25 | Rake $0
Seat 1: SWING BOLOO (small blind) folded before Flop
Seat 2: romixon36 (big blind) folded before Flop
Seat 5: Clamfish0 (button) collected ($1.25)


PokerStars Hand #208958677432:  Hold'em No Limit ($0.25/$0.50 USD) - 2020/02/07 19:38:40 ET
Table 'Aaltje III' 6-max Seat #1 is the button
Seat 1: SWING BOLOO ($53.40 in chips)
Seat 2: romixon36 ($60.47 in chips)
Seat 5: Clamfish0 ($50.50 in chips)
romixon36: posts small blind $0.25
allObar joins the table at seat #3
Clamfish0: posts big blind $0.50
*** HOLE CARDS ***
SWING BOLOO: raises $1 to $1.50
romixon36: folds
Clamfish0: calls $1
*** FLOP *** [2h 9s 9d]
Clamfish0: checks
SWING BOLOO: bets $1.50
Clamfish0: raises $2.56 to $4.06
tomvolgas85 joins the table at seat #4
SWING BOLOO: folds
Uncalled bet ($2.56) returned to Clamfish0
Clamfish0 collected $5.94 from pot
Clamfish0: doesn't show hand
*** SUMMARY ***
Total pot $6.25 | Rake $0.31
Board [2h 9s 9d]
Seat 1: SWING BOLOO (button) folded on the Flop
Seat 2: romixon36 (small blind) folded before Flop
Seat 5: Clamfish0 (big blind) collected ($5.94)


PokerStars Hand #208958674201:  Hold'em No Limit ($0.25/$0.50 USD) - 2020/02/07 19:38:31 ET
Table 'Aaltje III' 6-max Seat #5 is the button
Seat 1: SWING BOLOO ($53.65 in chips)
Seat 2: romixon36 ($60.22 in chips)
Seat 5: Clamfish0 ($50.50 in chips)
SWING BOLOO: posts small blind $0.25
romixon36: posts big blind $0.50
*** HOLE CARDS ***
Clamfish0: folds
SWING BOLOO: folds
Uncalled bet ($0.25) returned to romixon36
romixon36 collected $0.50 from pot
romixon36: doesn't show hand
*** SUMMARY ***
Total pot $0.50 | Rake $0
Seat 1: SWING BOLOO (small blind) folded before Flop
Seat 2: romixon36 (big blind) collected ($0.50)
Seat 5: Clamfish0 (button) folded before Flop (didn't bet)


PokerStars Hand #208958691335:  Hold'em No Limit ($0.25/$0.50 USD) - 2020/02/07 19:39:17 ET
Table 'Aaltje III' 6-max Seat #2 is the button
Seat 1: SWING BOLOO ($50.40 in chips)
Seat 2: romixon36 ($60.22 in chips)
Seat 5: Clamfish0 ($53.44 in chips)
Clamfish0: posts small blind $0.25
SWING BOLOO: posts big blind $0.50
*** HOLE CARDS ***
romixon36: raises $0.75 to $1.25
Glushchenko joins the table at seat #6
Clamfish0: raises $4.08 to $5.33
SWING BOLOO: folds
romixon36: calls $4.08
*** FLOP *** [Qc 7s Qd]
tomvolgas85 is disconnected
Clamfish0: checks
romixon36: checks
*** TURN *** [Qc 7s Qd] [4h]
Clamfish0: checks
romixon36: checks
*** RIVER *** [Qc 7s Qd 4h] [6s]
Clamfish0: checks
romixon36: checks
*** SHOW DOWN ***
Clamfish0: shows [Kc 5c] (a pair of Queens)
romixon36: mucks hand
Clamfish0 collected $10.60 from pot
*** SUMMARY ***
Total pot $11.16 | Rake $0.56
Board [Qc 7s Qd 4h 6s]
Seat 1: SWING BOLOO (big blind) folded before Flop
Seat 2: romixon36 (button) mucked
Seat 5: Clamfish0 (small blind) showed [Kc 5c] and won ($10.60) with a pair of Queens


PokerStars Hand #208958734909:  Hold'em No Limit ($0.25/$0.50 USD) - 2020/02/07 19:41:11 ET
Table 'Aaltje III' 6-max Seat #3 is the button
Seat 1: SWING BOLOO ($51.15 in chips)
Seat 2: romixon36 ($54.14 in chips)
Seat 3: allObar ($50 in chips)
Seat 5: Clamfish0 ($58.71 in chips)
Clamfish0: posts small blind $0.25
SWING BOLOO: posts big blind $0.50
*** HOLE CARDS ***
romixon36: folds
Galileomax joins the table at seat #6
allObar: folds
Clamfish0: folds
Uncalled bet ($0.25) returned to SWING BOLOO
SWING BOLOO collected $0.50 from pot
*** SUMMARY ***
Total pot $0.50 | Rake $0
Seat 1: SWING BOLOO (big blind) collected ($0.50)
Seat 2: romixon36 folded before Flop (didn't bet)
Seat 3: allObar (button) folded before Flop (didn't bet)
Seat 5: Clamfish0 (small blind) folded before Flop


PokerStars Hand #208958718162:  Hold'em No Limit ($0.25/$0.50 USD) - 2020/02/07 19:40:27 ET
Table 'Aaltje III' 6-max Seat #2 is the button
Seat 1: SWING BOLOO ($50.40 in chips)
Seat 2: romixon36 ($54.14 in chips)
Seat 3: allObar ($50.25 in chips)
Seat 4: tomvolgas85 ($40 in chips)
Seat 5: Clamfish0 ($58.71 in chips)
allObar: posts small blind $0.25
tomvolgas85: posts big blind $0.50
Glushchenko: sits out
*** HOLE CARDS ***
Clamfish0: folds
SWING BOLOO: raises $2 to $2.50
romixon36: folds
allObar: folds
Glushchenko leaves the table
tomvolgas85 has timed out
tomvolgas85: folds
Uncalled bet ($2) returned to SWING BOLOO
SWING BOLOO collected $1.25 from pot
*** SUMMARY ***
Total pot $1.25 | Rake $0
Seat 1: SWING BOLOO collected ($1.25)
Seat 2: romixon36 (button) folded before Flop (didn't bet)
Seat 3: allObar (small blind) folded before Flop
Seat 4: tomvolgas85 (big blind) folded before Flop
Seat 5: Clamfish0 folded before Flop (didn't bet)


PokerStars Hand #208958715331:  Hold'em No Limit ($0.25/$0.50 USD) - 2020/02/07 19:40:20 ET
Table 'Aaltje III' 6-max Seat #1 is the button
Seat 1: SWING BOLOO ($50.40 in chips)
Seat 2: romixon36 ($54.39 in chips)
Seat 3: allObar ($50 in chips)
Seat 5: Clamfish0 ($58.71 in chips)
romixon36: posts small blind $0.25
allObar: posts big blind $0.50
tomvolgas85: sits out
Glushchenko: sits out
*** HOLE CARDS ***
Clamfish0: folds
SWING BOLOO: folds
romixon36: folds
Uncalled bet ($0.25) returned to allObar
allObar collected $0.50 from pot
allObar: doesn't show hand
*** SUMMARY ***
Total pot $0.50 | Rake $0
Seat 1: SWING BOLOO (button) folded before Flop (didn't bet)
Seat 2: romixon36 (small blind) folded before Flop
Seat 3: allObar (big blind) collected ($0.50)
Seat 5: Clamfish0 folded before Flop (didn't bet)


PokerStars Hand #208958711344:  Hold'em No Limit ($0.25/$0.50 USD) - 2020/02/07 19:40:09 ET
Table 'Aaltje III' 6-max Seat #5 is the button
Seat 1: SWING BOLOO ($49.90 in chips)
Seat 2: romixon36 ($54.89 in chips)
Seat 5: Clamfish0 ($58.71 in chips)
SWING BOLOO: posts small blind $0.25
romixon36: posts big blind $0.50
allObar: sits out
tomvolgas85: sits out
*** HOLE CARDS ***
Clamfish0: folds
SWING BOLOO: raises $2 to $2.50
romixon36: folds
Uncalled bet ($2) returned to SWING BOLOO
SWING BOLOO collected $1 from pot
*** SUMMARY ***
Total pot $1 | Rake $0
Seat 1: SWING BOLOO (small blind) collected ($1)
Seat 2: romixon36 (big blind) folded before Flop
Seat 5: Clamfish0 (button) folded before Flop (didn't bet)


PokerStars Hand #208958738173:  Hold'em No Limit ($0.25/$0.50 USD) - 2020/02/07 19:41:20 ET
Table 'Aaltje III' 6-max Seat #5 is the button
Seat 1: SWING BOLOO ($51.40 in chips)
Seat 2: romixon36 ($54.14 in chips)
Seat 3: allObar ($50 in chips)
Seat 5: Clamfish0 ($58.46 in chips)
SWING BOLOO: posts small blind $0.25
romixon36: posts big blind $0.50
*** HOLE CARDS ***
allObar: folds
Clamfish0: raises $0.83 to $1.33
SWING BOLOO: calls $1.08
romixon36: calls $0.83
*** FLOP *** [5d 8c Qh]
SWING BOLOO: checks
romixon36: checks
Clamfish0: checks
*** TURN *** [5d 8c Qh] [Kc]
SWING BOLOO: checks
romixon36: checks
Clamfish0: checks
*** RIVER *** [5d 8c Qh Kc] [9h]
SWING BOLOO: bets $2.50
romixon36: folds
Clamfish0: folds
Uncalled bet ($2.50) returned to SWING BOLOO
SWING BOLOO collected $3.79 from pot
*** SUMMARY ***
Total pot $3.99 | Rake $0.20
Board [5d 8c Qh Kc 9h]
Seat 1: SWING BOLOO (small blind) collected ($3.79)
Seat 2: romixon36 (big blind) folded on the River
Seat 3: allObar folded before Flop (didn't bet)
Seat 5: Clamfish0 (button) folded on the River


PokerStars Hand #208958760804:  Hold'em No Limit ($0.25/$0.50 USD) - 2020/02/07 19:42:21 ET
Table 'Aaltje III' 6-max Seat #1 is the button
Seat 1: SWING BOLOO ($53.86 in chips)
Seat 2: romixon36 ($52.81 in chips)
Seat 3: allObar ($50 in chips)
Seat 4: tomvolgas85 ($39.50 in chips)
Seat 5: Clamfish0 ($57.13 in chips)
romixon36: posts small blind $0.25
allObar: posts big blind $0.50
tomvolgas85: posts small blind $0.25
Galileomax: sits out
*** HOLE CARDS ***
tomvolgas85: folds
Clamfish0: folds
SWING BOLOO: folds
romixon36: folds
Uncalled bet ($0.25) returned to allObar
allObar collected $0.75 from pot
allObar: doesn't show hand
*** SUMMARY ***
Total pot $0.75 | Rake $0
Seat 1: SWING BOLOO (button) folded before Flop (didn't bet)
Seat 2: romixon36 (small blind) folded before Flop
Seat 3: allObar (big blind) collected ($0.75)
Seat 4: tomvolgas85 folded before Flop (didn't bet)
Seat 5: Clamfish0 folded before Flop (didn't bet)


PokerStars Hand #208958765404:  Hold'em No Limit ($0.25/$0.50 USD) - 2020/02/07 19:42:33 ET
Table 'Aaltje III' 6-max Seat #2 is the button
Seat 1: SWING BOLOO ($53.86 in chips)
Seat 2: romixon36 ($52.56 in chips)
Seat 3: allObar ($50.50 in chips)
Seat 4: tomvolgas85 ($39.25 in chips)
Seat 5: Clamfish0 ($57.13 in chips)
allObar: posts small blind $0.25
tomvolgas85: posts big blind $0.50
Galileomax: sits out
*** HOLE CARDS ***
Clamfish0: folds
SWING BOLOO: folds
romixon36: raises $0.75 to $1.25
allObar: folds
tomvolgas85: calls $0.75
*** FLOP *** [4c Jh Ad]
tomvolgas85 has timed out
tomvolgas85: checks
romixon36: bets $0.76
tomvolgas85: calls $0.76
*** TURN *** [4c Jh Ad] [9d]
tomvolgas85 has timed out
tomvolgas85: checks
romixon36: checks
*** RIVER *** [4c Jh Ad 9d] [7c]
tomvolgas85: bets $0.50
romixon36: folds
Uncalled bet ($0.50) returned to tomvolgas85
tomvolgas85 collected $4.06 from pot
tomvolgas85: doesn't show hand
*** SUMMARY ***
Total pot $4.27 | Rake $0.21
Board [4c Jh Ad 9d 7c]
Seat 1: SWING BOLOO folded before Flop (didn't bet)
Seat 2: romixon36 (button) folded on the River
Seat 3: allObar (small blind) folded before Flop
Seat 4: tomvolgas85 (big blind) collected ($4.06)
Seat 5: Clamfish0 folded before Flop (didn't bet)


PokerStars Hand #208958821725:  Hold'em No Limit ($0.25/$0.50 USD) - 2020/02/07 19:44:58 ET
Table 'Aaltje III' 6-max Seat #5 is the button
Seat 1: SWING BOLOO ($55.26 in chips)
Seat 3: allObar ($50.25 in chips)
Seat 5: Clamfish0 ($55.84 in chips)
SWING BOLOO: posts small blind $0.25
allObar: posts big blind $0.50
drakula110: sits out
*** HOLE CARDS ***
drakula110 leaves the table
Clamfish0: folds
SWING BOLOO: folds
Uncalled bet ($0.25) returned to allObar
allObar collected $0.50 from pot
allObar: doesn't show hand
*** SUMMARY ***
Total pot $0.50 | Rake $0
Seat 1: SWING BOLOO (small blind) folded before Flop
Seat 3: allObar (big blind) collected ($0.50)
Seat 5: Clamfish0 (button) folded before Flop (didn't bet)


PokerStars Hand #208958800351:  Hold'em No Limit ($0.25/$0.50 USD) - 2020/02/07 19:44:00 ET
Table 'Aaltje III' 6-max Seat #3 is the button
Seat 1: SWING BOLOO ($53.86 in chips)
Seat 3: allObar ($50.25 in chips)
Seat 4: tomvolgas85 ($41.30 in chips)
Seat 5: Clamfish0 ($57.13 in chips)
tomvolgas85: posts small blind $0.25
Clamfish0: posts big blind $0.50
Galileomax: sits out
*** HOLE CARDS ***
SWING BOLOO: calls $0.50
allObar: folds
tomvolgas85: folds
Clamfish0: checks
*** FLOP *** [Tc 8d Ts]
Clamfish0: checks
SWING BOLOO: checks
*** TURN *** [Tc 8d Ts] [4s]
Clamfish0: bets $0.79
SWING BOLOO: raises $3.71 to $4.50
tomvolgas85 leaves the table
drakula110 joins the table at seat #4
Clamfish0: folds
Uncalled bet ($3.71) returned to SWING BOLOO
SWING BOLOO collected $2.69 from pot
*** SUMMARY ***
Total pot $2.83 | Rake $0.14
Board [Tc 8d Ts 4s]
Seat 1: SWING BOLOO collected ($2.69)
Seat 3: allObar (button) folded before Flop (didn't bet)
Seat 4: tomvolgas85 (small blind) folded before Flop
Seat 5: Clamfish0 (big blind) folded on the Turn


PokerStars Hand #208958824441:  Hold'em No Limit ($0.25/$0.50 USD) - 2020/02/07 19:45:05 ET
Table 'Aaltje III' 6-max Seat #1 is the button
Seat 1: SWING BOLOO ($55.01 in chips)
Seat 3: allObar ($50.50 in chips)
Seat 5: Clamfish0 ($55.84 in chips)
allObar: posts small blind $0.25
Clamfish0: posts big blind $0.50
Galileomax: sits out
*** HOLE CARDS ***
SWING BOLOO: raises $1 to $1.50
allObar: calls $1.25
Clamfish0: calls $1
*** FLOP *** [Td 5s 6h]
allObar: checks
Clamfish0: checks
DanaEaston77 joins the table at seat #4
SWING BOLOO: bets $2.50
allObar: folds
Clamfish0: raises $4.83 to $7.33
SWING BOLOO: calls $4.83
*** TURN *** [Td 5s 6h] [2d]
Clamfish0: checks
SWING BOLOO: checks
*** RIVER *** [Td 5s 6h 2d] [7d]
Clamfish0: checks
SWING BOLOO: bets $5
Clamfish0: folds
Uncalled bet ($5) returned to SWING BOLOO
SWING BOLOO collected $18.41 from pot
*** SUMMARY ***
Total pot $19.16 | Rake $0.75
Board [Td 5s 6h 2d 7d]
Seat 1: SWING BOLOO (button) collected ($18.41)
Seat 3: allObar (small blind) folded on the Flop
Seat 5: Clamfish0 (big blind) folded on the River


PokerStars Hand #208958894454:  Hold'em No Limit ($0.25/$0.50 USD) - 2020/02/07 19:47:32 ET
Table 'Aaltje III' 6-max Seat #5 is the button
Seat 1: SWING BOLOO ($64.59 in chips)
Seat 3: allObar ($50 in chips)
Seat 4: DanaEaston77 ($50 in chips)
Seat 5: Clamfish0 ($50 in chips)
Seat 6: Galileomax ($21.36 in chips)
Galileomax: posts small blind $0.25
SWING BOLOO: posts big blind $0.50
DanaEaston77: posts big blind $0.50
*** HOLE CARDS ***
allObar: folds
DanaEaston77: raises $1.25 to $1.75
Clamfish0: folds
Galileomax: folds
SWING BOLOO: folds
Uncalled bet ($1.25) returned to DanaEaston77
DanaEaston77 collected $1.25 from pot
DanaEaston77: doesn't show hand
*** SUMMARY ***
Total pot $1.25 | Rake $0
Seat 1: SWING BOLOO (big blind) folded before Flop
Seat 3: allObar folded before Flop (didn't bet)
Seat 4: DanaEaston77 collected ($1.25)
Seat 5: Clamfish0 (button) folded before Flop (didn't bet)
Seat 6: Galileomax (small blind) folded before Flop


PokerStars Hand #208958865715:  Hold'em No Limit ($0.25/$0.50 USD) - 2020/02/07 19:46:36 ET
Table 'Aaltje III' 6-max Seat #3 is the button
Seat 1: SWING BOLOO ($64.59 in chips)
Seat 3: allObar ($50 in chips)
Seat 5: Clamfish0 ($50 in chips)
Seat 6: Galileomax ($20 in chips)
Clamfish0: posts small blind $0.25
Galileomax: posts big blind $0.50
*** HOLE CARDS ***
SWING BOLOO: folds
allObar: raises $0.75 to $1.25
Clamfish0: folds
Galileomax: calls $0.75
*** FLOP *** [9s 4h 8d]
Galileomax: checks
allObar: checks
*** TURN *** [9s 4h 8d] [Qs]
Galileomax: checks
allObar: checks
*** RIVER *** [9s 4h 8d Qs] [5h]
Galileomax: bets $2.22
allObar: folds
Uncalled bet ($2.22) returned to Galileomax
Galileomax collected $2.61 from pot
Galileomax: doesn't show hand
*** SUMMARY ***
Total pot $2.75 | Rake $0.14
Board [9s 4h 8d Qs 5h]
Seat 1: SWING BOLOO folded before Flop (didn't bet)
Seat 3: allObar (button) folded on the River
Seat 5: Clamfish0 (small blind) folded before Flop
Seat 6: Galileomax (big blind) collected ($2.61)


PokerStars Hand #208959272161:  Hold'em No Limit ($0.25/$0.50 USD) - 2020/02/07 20:05:27 ET
Table 'Aaltje III' 6-max Seat #4 is the button
Seat 2: romixon36 ($88.95 in chips)
Seat 3: allObar ($57.07 in chips)
Seat 4: DanaEaston77 ($35.64 in chips)
Seat 5: Clamfish0 ($63.66 in chips)
Seat 6: Galileomax ($51.75 in chips)
Clamfish0: posts small blind $0.25
Galileomax: posts big blind $0.50
*** HOLE CARDS ***
romixon36: folds
allObar: folds
DanaEaston77: folds
Clamfish0: calls $0.25
Galileomax: checks
*** FLOP *** [Tc Th 8c]
Clamfish0: checks
Galileomax: checks
*** TURN *** [Tc Th 8c] [Qh]
Clamfish0: bets $0.67
Galileomax: folds
Uncalled bet ($0.67) returned to Clamfish0
Clamfish0 collected $0.95 from pot
Clamfish0: doesn't show hand
*** SUMMARY ***
Total pot $1 | Rake $0.05
Board [Tc Th 8c Qh]
Seat 2: romixon36 folded before Flop (didn't bet)
Seat 3: allObar folded before Flop (didn't bet)
Seat 4: DanaEaston77 (button) folded before Flop (didn't bet)
Seat 5: Clamfish0 (small blind) collected ($0.95)
Seat 6: Galileomax (big blind) folded on the Turn


PokerStars Hand #208959284314:  Hold'em No Limit ($0.25/$0.50 USD) - 2020/02/07 20:06:02 ET
Table 'Aaltje III' 6-max Seat #5 is the button
Seat 2: romixon36 ($88.95 in chips)
Seat 3: allObar ($57.07 in chips)
Seat 4: DanaEaston77 ($35.64 in chips)
Seat 5: Clamfish0 ($64.11 in chips)
Seat 6: Galileomax ($51.25 in chips)
Galileomax: posts small blind $0.25
romixon36: posts big blind $0.50
*** HOLE CARDS ***
allObar: folds
DanaEaston77: raises $0.50 to $1
Clamfish0: raises $1.93 to $2.93
Lexusloal joins the table at seat #1
Lexusloal leaves the table
Galileomax: folds
romixon36: folds
DanaEaston77: calls $1.93
*** FLOP *** [6d 3d Tc]
DanaEaston77: bets $32.71 and is all-in
Clamfish0: folds
Uncalled bet ($32.71) returned to DanaEaston77
DanaEaston77 collected $6.28 from pot
DanaEaston77: doesn't show hand
*** SUMMARY ***
Total pot $6.61 | Rake $0.33
Board [6d 3d Tc]
Seat 2: romixon36 (big blind) folded before Flop
Seat 3: allObar folded before Flop (didn't bet)
Seat 4: DanaEaston77 collected ($6.28)
Seat 5: Clamfish0 (button) folded on the Flop
Seat 6: Galileomax (small blind) folded before Flop


PokerStars Hand #208959296258:  Hold'em No Limit ($0.25/$0.50 USD) - 2020/02/07 20:06:36 ET
Table 'Aaltje III' 6-max Seat #6 is the button
Seat 2: romixon36 ($88.45 in chips)
Seat 3: allObar ($57.07 in chips)
Seat 4: DanaEaston77 ($38.99 in chips)
Seat 5: Clamfish0 ($61.18 in chips)
Seat 6: Galileomax ($51 in chips)
romixon36: posts small blind $0.25
allObar: posts big blind $0.50
*** HOLE CARDS ***
DanaEaston77: folds
Clamfish0: folds
Galileomax: folds
romixon36: folds
Uncalled bet ($0.25) returned to allObar
allObar collected $0.50 from pot
allObar: doesn't show hand
*** SUMMARY ***
Total pot $0.50 | Rake $0
Seat 2: romixon36 (small blind) folded before Flop
Seat 3: allObar (big blind) collected ($0.50)
Seat 4: DanaEaston77 folded before Flop (didn't bet)
Seat 5: Clamfish0 folded before Flop (didn't bet)
Seat 6: Galileomax (button) folded before Flop (didn't bet)


PokerStars Hand #208959300168:  Hold'em No Limit ($0.25/$0.50 USD) - 2020/02/07 20:06:47 ET
Table 'Aaltje III' 6-max Seat #2 is the button
Seat 2: romixon36 ($88.20 in chips)
Seat 3: allObar ($57.32 in chips)
Seat 4: DanaEaston77 ($38.99 in chips)
Seat 5: Clamfish0 ($61.18 in chips)
Seat 6: Galileomax ($51 in chips)
allObar: posts small blind $0.25
DanaEaston77: posts big blind $0.50
*** HOLE CARDS ***
Clamfish0: folds
Galileomax: folds
romixon36: raises $0.75 to $1.25
allObar: folds
DanaEaston77: calls $0.75
*** FLOP *** [Ks 3s Tc]
DanaEaston77: checks
romixon36: checks
*** TURN *** [Ks 3s Tc] [9s]
DanaEaston77: checks
romixon36: checks
*** RIVER *** [Ks 3s Tc 9s] [9d]
DanaEaston77: checks
romixon36: checks
*** SHOW DOWN ***
DanaEaston77: shows [2h As] (a pair of Nines)
romixon36: shows [8c 8s] (two pair, Nines and Eights)
romixon36 collected $2.61 from pot
*** SUMMARY ***
Total pot $2.75 | Rake $0.14
Board [Ks 3s Tc 9s 9d]
Seat 2: romixon36 (button) showed [8c 8s] and won ($2.61) with two pair, Nines and Eights
Seat 3: allObar (small blind) folded before Flop
Seat 4: DanaEaston77 (big blind) showed [2h As] and lost with a pair of Nines
Seat 5: Clamfish0 folded before Flop (didn't bet)
Seat 6: Galileomax folded before Flop (didn't bet)


PokerStars Hand #208959312715:  Hold'em No Limit ($0.25/$0.50 USD) - 2020/02/07 20:07:23 ET
Table 'Aaltje III' 6-max Seat #3 is the button
Seat 2: romixon36 ($89.56 in chips)
Seat 3: allObar ($57.07 in chips)
Seat 5: Clamfish0 ($61.18 in chips)
Seat 6: Galileomax ($51 in chips)
DanaEaston77 has timed out
DanaEaston77: is sitting out
Clamfish0: posts small blind $0.25
Galileomax: posts big blind $0.50
*** HOLE CARDS ***
romixon36: raises $0.60 to $1.10
allObar: folds
canejo10 joins the table at seat #1
Clamfish0: raises $4.25 to $5.35
Galileomax: folds
romixon36: calls $4.25
*** FLOP *** [3h 4h Jc]
Clamfish0: bets $6.06
romixon36: calls $6.06
*** TURN *** [3h 4h Jc] [7h]
Clamfish0: bets $11.45
romixon36: calls $11.45
*** RIVER *** [3h 4h Jc 7h] [2c]
Clamfish0: checks
romixon36: checks
*** SHOW DOWN ***
Clamfish0: shows [Kd Ks] (a pair of Kings)
romixon36: mucks hand
Clamfish0 collected $45.47 from pot
*** SUMMARY ***
Total pot $46.22 | Rake $0.75
Board [3h 4h Jc 7h 2c]
Seat 2: romixon36 mucked
Seat 3: allObar (button) folded before Flop (didn't bet)
Seat 5: Clamfish0 (small blind) showed [Kd Ks] and won ($45.47) with a pair of Kings
Seat 6: Galileomax (big blind) folded before Flop


PokerStars Hand #208959356164:  Hold'em No Limit ($0.25/$0.50 USD) - 2020/02/07 20:09:29 ET
Table 'Aaltje III' 6-max Seat #5 is the button
Seat 1: canejo10 ($40 in chips)
Seat 2: romixon36 ($66.70 in chips)
Seat 3: allObar ($57.07 in chips)
Seat 5: Clamfish0 ($83.79 in chips)
Seat 6: Galileomax ($50.50 in chips)
Galileomax: posts small blind $0.25
canejo10: posts big blind $0.50
DanaEaston77: sits out
*** HOLE CARDS ***
romixon36: folds
allObar: folds
Clamfish0: raises $0.83 to $1.33
Galileomax: calls $1.08
canejo10: calls $0.83
*** FLOP *** [9h 5c Ks]
Galileomax: checks
canejo10: bets $0.50
Clamfish0: calls $0.50
Galileomax: calls $0.50
*** TURN *** [9h 5c Ks] [5d]
Galileomax: checks
canejo10: bets $0.50
Clamfish0: folds
Galileomax: calls $0.50
*** RIVER *** [9h 5c Ks 5d] [9d]
Galileomax: checks
canejo10: checks
*** SHOW DOWN ***
Galileomax: shows [Ah Jc] (two pair, Nines and Fives)
canejo10: shows [7h Kh] (two pair, Kings and Nines)
canejo10 collected $6.17 from pot
*** SUMMARY ***
Total pot $6.49 | Rake $0.32
Board [9h 5c Ks 5d 9d]
Seat 1: canejo10 (big blind) showed [7h Kh] and won ($6.17) with two pair, Kings and Nines
Seat 2: romixon36 folded before Flop (didn't bet)
Seat 3: allObar folded before Flop (didn't bet)
Seat 5: Clamfish0 (button) folded on the Turn
Seat 6: Galileomax (small blind) showed [Ah Jc] and lost with two pair, Nines and Fives


PokerStars Hand #208959421112:  Hold'em No Limit ($0.25/$0.50 USD) - 2020/02/07 20:12:21 ET
Table 'Aaltje III' 6-max Seat #2 is the button
Seat 2: romixon36 ($59.20 in chips)
Seat 3: allObar ($106.66 in chips)
Seat 4: DanaEaston77 ($37.49 in chips)
Seat 5: Clamfish0 ($81.96 in chips)
Seat 6: Galileomax ($48.17 in chips)
allObar: posts small blind $0.25
DanaEaston77: posts big blind $0.50
*** HOLE CARDS ***
Clamfish0: folds
Galileomax: folds
romixon36: raises $0.75 to $1.25
allObar: folds
DanaEaston77: calls $0.75
*** FLOP *** [Ah Jc Ac]
DanaEaston77: checks
romixon36: bets $0.76
DanaEaston77: folds
Uncalled bet ($0.76) returned to romixon36
romixon36 collected $2.61 from pot
romixon36: doesn't show hand
*** SUMMARY ***
Total pot $2.75 | Rake $0.14
Board [Ah Jc Ac]
Seat 2: romixon36 (button) collected ($2.61)
Seat 3: allObar (small blind) folded before Flop
Seat 4: DanaEaston77 (big blind) folded on the Flop
Seat 5: Clamfish0 folded before Flop (didn't bet)
Seat 6: Galileomax folded before Flop (didn't bet)


PokerStars Hand #208959385061:  Hold'em No Limit ($0.25/$0.50 USD) - 2020/02/07 20:10:52 ET
Table 'Aaltje III' 6-max Seat #6 is the button
Seat 1: canejo10 ($43.84 in chips)
Seat 2: romixon36 ($66.70 in chips)
Seat 3: allObar ($57.07 in chips)
Seat 4: DanaEaston77 ($37.74 in chips)
Seat 5: Clamfish0 ($81.96 in chips)
Seat 6: Galileomax ($48.17 in chips)
canejo10: posts small blind $0.25
romixon36: posts big blind $0.50
DanaEaston77: posts small blind $0.25
*** HOLE CARDS ***
allObar: raises $1.50 to $2
DanaEaston77: folds
Clamfish0: folds
Galileomax: folds
canejo10: calls $1.75
romixon36: raises $5.50 to $7.50
allObar: calls $5.50
canejo10: calls $5.50
*** FLOP *** [5d 9c Jh]
canejo10: checks
romixon36: checks
allObar: checks
*** TURN *** [5d 9c Jh] [8d]
canejo10: bets $6
romixon36: folds
allObar: raises $6 to $12
canejo10: raises $6 to $18
allObar: raises $31.57 to $49.57 and is all-in
canejo10: calls $18.34 and is all-in
Uncalled bet ($13.23) returned to allObar
*** RIVER *** [5d 9c Jh 8d] [9d]
*** SHOW DOWN ***
canejo10: shows [Jd Ac] (two pair, Jacks and Nines)
allObar: shows [Qd Td] (a flush, Queen high)
allObar collected $93.43 from pot
*** SUMMARY ***
Total pot $95.43 | Rake $2
Board [5d 9c Jh 8d 9d]
Seat 1: canejo10 (small blind) showed [Jd Ac] and lost with two pair, Jacks and Nines
Seat 2: romixon36 (big blind) folded on the Turn
Seat 3: allObar showed [Qd Td] and won ($93.43) with a flush, Queen high
Seat 4: DanaEaston77 folded before Flop (didn't bet)
Seat 5: Clamfish0 folded before Flop (didn't bet)
Seat 6: Galileomax (button) folded before Flop (didn't bet)


PokerStars Hand #208959429587:  Hold'em No Limit ($0.25/$0.50 USD) - 2020/02/07 20:12:46 ET
Table 'Aaltje III' 6-max Seat #3 is the button
Seat 1: canejo10 ($50 in chips)
Seat 2: romixon36 ($60.56 in chips)
Seat 3: allObar ($106.41 in chips)
Seat 4: DanaEaston77 ($36.24 in chips)
Seat 5: Clamfish0 ($81.96 in chips)
Seat 6: Galileomax ($48.17 in chips)
DanaEaston77: posts small blind $0.25
Clamfish0: posts big blind $0.50
*** HOLE CARDS ***
Galileomax: folds
canejo10: calls $0.50
romixon36: folds
allObar: folds
DanaEaston77: calls $0.25
Clamfish0: checks
*** FLOP *** [Qd Ts Tc]
DanaEaston77: checks
Clamfish0: checks
canejo10: checks
*** TURN *** [Qd Ts Tc] [4d]
DanaEaston77: bets $1.50
Clamfish0: folds
canejo10: calls $1.50
*** RIVER *** [Qd Ts Tc 4d] [Qc]
DanaEaston77: checks
canejo10: checks
*** SHOW DOWN ***
DanaEaston77: shows [9d 6d] (two pair, Queens and Tens)
canejo10: mucks hand
DanaEaston77 collected $4.28 from pot
*** SUMMARY ***
Total pot $4.50 | Rake $0.22
Board [Qd Ts Tc 4d Qc]
Seat 1: canejo10 mucked
Seat 2: romixon36 folded before Flop (didn't bet)
Seat 3: allObar (button) folded before Flop (didn't bet)
Seat 4: DanaEaston77 (small blind) showed [9d 6d] and won ($4.28) with two pair, Queens and Tens
Seat 5: Clamfish0 (big blind) folded on the Turn
Seat 6: Galileomax folded before Flop (didn't bet)


PokerStars Hand #208959450579:  Hold'em No Limit ($0.25/$0.50 USD) - 2020/02/07 20:13:48 ET
Table 'Aaltje III' 6-max Seat #4 is the button
Seat 1: canejo10 ($48 in chips)
Seat 2: romixon36 ($60.56 in chips)
Seat 3: allObar ($106.41 in chips)
Seat 4: DanaEaston77 ($38.52 in chips)
Seat 5: Clamfish0 ($81.46 in chips)
Seat 6: Galileomax ($48.17 in chips)
Clamfish0: posts small blind $0.25
Galileomax: posts big blind $0.50
*** HOLE CARDS ***
canejo10: calls $0.50
romixon36: folds
allObar: folds
DanaEaston77: folds
Clamfish0: folds
Galileomax: checks
*** FLOP *** [3h Qc As]
Galileomax: checks
canejo10: bets $1.50
Galileomax: calls $1.50
*** TURN *** [3h Qc As] [Kh]
Galileomax: checks
canejo10: bets $2.50
Galileomax: calls $2.50
*** RIVER *** [3h Qc As Kh] [Js]
Galileomax: checks
canejo10: checks
*** SHOW DOWN ***
Galileomax: shows [6h Qh] (a pair of Queens)
canejo10: shows [Ac Jc] (two pair, Aces and Jacks)
canejo10 collected $8.79 from pot
*** SUMMARY ***
Total pot $9.25 | Rake $0.46
Board [3h Qc As Kh Js]
Seat 1: canejo10 showed [Ac Jc] and won ($8.79) with two pair, Aces and Jacks
Seat 2: romixon36 folded before Flop (didn't bet)
Seat 3: allObar folded before Flop (didn't bet)
Seat 4: DanaEaston77 (button) folded before Flop (didn't bet)
Seat 5: Clamfish0 (small blind) folded before Flop
Seat 6: Galileomax (big blind) showed [6h Qh] and lost with a pair of Queens


PokerStars Hand #208959482046:  Hold'em No Limit ($0.25/$0.50 USD) - 2020/02/07 20:15:20 ET
Table 'Aaltje III' 6-max Seat #5 is the button
Seat 1: canejo10 ($52.29 in chips)
Seat 2: romixon36 ($60.56 in chips)
Seat 3: allObar ($106.41 in chips)
Seat 4: DanaEaston77 ($38.52 in chips)
Seat 5: Clamfish0 ($81.21 in chips)
Seat 6: Galileomax ($43.67 in chips)
Galileomax: posts small blind $0.25
canejo10: posts big blind $0.50
*** HOLE CARDS ***
romixon36: folds
allObar: raises $0.75 to $1.25
DanaEaston77: folds
Clamfish0: folds
Galileomax: folds
canejo10: raises $4.25 to $5.50
allObar: calls $4.25
*** FLOP *** [2d 6h 6s]
canejo10: bets $3
allObar: calls $3
*** TURN *** [2d 6h 6s] [Ah]
canejo10: bets $3.50
allObar: calls $3.50
*** RIVER *** [2d 6h 6s Ah] [7c]
canejo10: checks
allObar: bets $7.60
canejo10: calls $7.60
*** SHOW DOWN ***
allObar: shows [9c Ac] (two pair, Aces and Sixes)
canejo10: mucks hand
allObar collected $37.48 from pot
*** SUMMARY ***
Total pot $39.45 | Rake $1.97
Board [2d 6h 6s Ah 7c]
Seat 1: canejo10 (big blind) mucked
Seat 2: romixon36 folded before Flop (didn't bet)
Seat 3: allObar showed [9c Ac] and won ($37.48) with two pair, Aces and Sixes
Seat 4: DanaEaston77 folded before Flop (didn't bet)
Seat 5: Clamfish0 (button) folded before Flop (didn't bet)
Seat 6: Galileomax (small blind) folded before Flop


PokerStars Hand #208959506937:  Hold'em No Limit ($0.25/$0.50 USD) - 2020/02/07 20:16:34 ET
Table 'Aaltje III' 6-max Seat #6 is the button
Seat 1: canejo10 ($32.69 in chips)
Seat 2: romixon36 ($60.56 in chips)
Seat 3: allObar ($124.29 in chips)
Seat 4: DanaEaston77 ($38.52 in chips)
Seat 5: Clamfish0 ($81.21 in chips)
Seat 6: Galileomax ($43.42 in chips)
canejo10: posts small blind $0.25
romixon36: posts big blind $0.50
*** HOLE CARDS ***
allObar: folds
DanaEaston77: raises $1 to $1.50
Clamfish0: folds
Galileomax: folds
canejo10: calls $1.25
romixon36: folds
*** FLOP *** [8d Kh 3d]
canejo10: checks
DanaEaston77: checks
*** TURN *** [8d Kh 3d] [Jh]
canejo10: checks
DanaEaston77: bets $1.50
canejo10: calls $1.50
*** RIVER *** [8d Kh 3d Jh] [Kd]
canejo10: checks
DanaEaston77: bets $35.52 and is all-in
canejo10: folds
Uncalled bet ($35.52) returned to DanaEaston77
DanaEaston77 collected $6.18 from pot
*** SUMMARY ***
Total pot $6.50 | Rake $0.32
Board [8d Kh 3d Jh Kd]
Seat 1: canejo10 (small blind) folded on the River
Seat 2: romixon36 (big blind) folded before Flop
Seat 3: allObar folded before Flop (didn't bet)
Seat 4: DanaEaston77 collected ($6.18)
Seat 5: Clamfish0 folded before Flop (didn't bet)
Seat 6: Galileomax (button) folded before Flop (didn't bet)


PokerStars Hand #208959522624:  Hold'em No Limit ($0.25/$0.50 USD) - 2020/02/07 20:17:22 ET
Table 'Aaltje III' 6-max Seat #2 is the button
Seat 2: romixon36 ($60.06 in chips)
Seat 3: allObar ($124.29 in chips)
Seat 4: DanaEaston77 ($41.70 in chips)
Seat 5: Clamfish0 ($81.21 in chips)
Seat 6: Galileomax ($43.42 in chips)
allObar: posts small blind $0.25
DanaEaston77: posts big blind $0.50
*** HOLE CARDS ***
Clamfish0: folds
Galileomax: folds
romixon36: folds
allObar: raises $1 to $1.50
DanaEaston77: calls $1
*** FLOP *** [Th 2h 5d]
allObar: checks
DanaEaston77: bets $1.50
allObar: folds
Uncalled bet ($1.50) returned to DanaEaston77
DanaEaston77 collected $2.85 from pot
DanaEaston77: doesn't show hand
*** SUMMARY ***
Total pot $3 | Rake $0.15
Board [Th 2h 5d]
Seat 2: romixon36 (button) folded before Flop (didn't bet)
Seat 3: allObar (small blind) folded on the Flop
Seat 4: DanaEaston77 (big blind) collected ($2.85)
Seat 5: Clamfish0 folded before Flop (didn't bet)
Seat 6: Galileomax folded before Flop (didn't bet)


PokerStars Hand #208959531191:  Hold'em No Limit ($0.25/$0.50 USD) - 2020/02/07 20:17:47 ET
Table 'Aaltje III' 6-max Seat #3 is the button
Seat 2: romixon36 ($60.06 in chips)
Seat 3: allObar ($122.79 in chips)
Seat 4: DanaEaston77 ($43.05 in chips)
Seat 5: Clamfish0 ($81.21 in chips)
Seat 6: Galileomax ($43.42 in chips)
DanaEaston77: posts small blind $0.25
Clamfish0: posts big blind $0.50
*** HOLE CARDS ***
Galileomax: folds
romixon36: folds
allObar: raises $0.75 to $1.25
DanaEaston77: folds
Clamfish0: calls $0.75
*** FLOP *** [Jc 6c Kd]
Clamfish0: checks
allObar: checks
*** TURN *** [Jc 6c Kd] [5s]
Clamfish0: bets $1.83
allObar: calls $1.83
*** RIVER *** [Jc 6c Kd 5s] [6s]
Clamfish0: checks
allObar: bets $4.57
Clamfish0: folds
Uncalled bet ($4.57) returned to allObar
allObar collected $6.09 from pot
allObar: doesn't show hand
*** SUMMARY ***
Total pot $6.41 | Rake $0.32
Board [Jc 6c Kd 5s 6s]
Seat 2: romixon36 folded before Flop (didn't bet)
Seat 3: allObar (button) collected ($6.09)
Seat 4: DanaEaston77 (small blind) folded before Flop
Seat 5: Clamfish0 (big blind) folded on the River
Seat 6: Galileomax folded before Flop (didn't bet)


PokerStars Hand #208959565078:  Hold'em No Limit ($0.25/$0.50 USD) - 2020/02/07 20:19:03 ET
Table 'Aaltje III' 6-max Seat #4 is the button
Seat 1: canejo10 ($29.69 in chips)
Seat 2: romixon36 ($60.06 in chips)
Seat 3: allObar ($125.80 in chips)
Seat 4: DanaEaston77 ($42.80 in chips)
Seat 5: Clamfish0 ($78.13 in chips)
Seat 6: Galileomax ($43.42 in chips)
Clamfish0: posts small blind $0.25
Galileomax: posts big blind $0.50
*** HOLE CARDS ***
canejo10: calls $0.50
romixon36: folds
allObar: folds
DanaEaston77: folds
Clamfish0: raises $2.04 to $2.54
Galileomax: folds
canejo10: calls $2.04
*** FLOP *** [Tc Qs Ac]
Clamfish0: checks
canejo10: bets $2
Clamfish0: calls $2
*** TURN *** [Tc Qs Ac] [Jh]
Clamfish0: bets $2.34
canejo10: calls $2.34
*** RIVER *** [Tc Qs Ac Jh] [2h]
Clamfish0: checks
canejo10: bets $8.50
Clamfish0: folds
Uncalled bet ($8.50) returned to canejo10
canejo10 collected $13.55 from pot
canejo10: doesn't show hand
*** SUMMARY ***
Total pot $14.26 | Rake $0.71
Board [Tc Qs Ac Jh 2h]
Seat 1: canejo10 collected ($13.55)
Seat 2: romixon36 folded before Flop (didn't bet)
Seat 3: allObar folded before Flop (didn't bet)
Seat 4: DanaEaston77 (button) folded before Flop (didn't bet)
Seat 5: Clamfish0 (small blind) folded on the River
Seat 6: Galileomax (big blind) folded before Flop


PokerStars Hand #208959596329:  Hold'em No Limit ($0.25/$0.50 USD) - 2020/02/07 20:20:37 ET
Table 'Aaltje III' 6-max Seat #5 is the button
Seat 1: canejo10 ($36.36 in chips)
Seat 2: romixon36 ($60.06 in chips)
Seat 3: allObar ($125.80 in chips)
Seat 4: DanaEaston77 ($42.80 in chips)
Seat 5: Clamfish0 ($71.25 in chips)
Seat 6: Galileomax ($42.92 in chips)
Galileomax: posts small blind $0.25
canejo10: posts big blind $0.50
*** HOLE CARDS ***
romixon36: folds
allObar: folds
DanaEaston77: folds
Clamfish0: folds
Galileomax: calls $0.25
canejo10: checks
*** FLOP *** [Qc 9s Kc]
Galileomax: bets $0.64
canejo10: calls $0.64
*** TURN *** [Qc 9s Kc] [As]
Galileomax: bets $2
canejo10: calls $2
*** RIVER *** [Qc 9s Kc As] [Td]
Galileomax: bets $4.50
canejo10: folds
Uncalled bet ($4.50) returned to Galileomax
Galileomax collected $5.97 from pot
Galileomax: doesn't show hand
*** SUMMARY ***
Total pot $6.28 | Rake $0.31
Board [Qc 9s Kc As Td]
Seat 1: canejo10 (big blind) folded on the River
Seat 2: romixon36 folded before Flop (didn't bet)
Seat 3: allObar folded before Flop (didn't bet)
Seat 4: DanaEaston77 folded before Flop (didn't bet)
Seat 5: Clamfish0 (button) folded before Flop (didn't bet)
Seat 6: Galileomax (small blind) collected ($5.97)


PokerStars Hand #208959618538:  Hold'em No Limit ($0.25/$0.50 USD) - 2020/02/07 20:21:44 ET
Table 'Aaltje III' 6-max Seat #6 is the button
Seat 1: canejo10 ($33.22 in chips)
Seat 2: romixon36 ($60.06 in chips)
Seat 3: allObar ($125.80 in chips)
Seat 4: DanaEaston77 ($42.80 in chips)
Seat 5: Clamfish0 ($71.25 in chips)
Seat 6: Galileomax ($45.75 in chips)
canejo10: posts small blind $0.25
romixon36: posts big blind $0.50
*** HOLE CARDS ***
allObar: folds
DanaEaston77: calls $0.50
Clamfish0: folds
Galileomax: folds
canejo10: calls $0.25
romixon36: checks
*** FLOP *** [4s Qc 3h]
canejo10: checks
romixon36: checks
DanaEaston77: bets $1.50
canejo10: folds
romixon36: calls $1.50
*** TURN *** [4s Qc 3h] [Ac]
romixon36: checks
DanaEaston77: bets $2.50
romixon36: calls $2.50
*** RIVER *** [4s Qc 3h Ac] [8d]
romixon36: checks
DanaEaston77: checks
*** SHOW DOWN ***
romixon36: shows [2c 5s] (a straight, Ace to Five)
DanaEaston77: mucks hand
romixon36 collected $9.02 from pot
*** SUMMARY ***
Total pot $9.50 | Rake $0.48
Board [4s Qc 3h Ac 8d]
Seat 1: canejo10 (small blind) folded on the Flop
Seat 2: romixon36 (big blind) showed [2c 5s] and won ($9.02) with a straight, Ace to Five
Seat 3: allObar folded before Flop (didn't bet)
Seat 4: DanaEaston77 mucked
Seat 5: Clamfish0 folded before Flop (didn't bet)
Seat 6: Galileomax (button) folded before Flop (didn't bet)


PokerStars Hand #208959651532:  Hold'em No Limit ($0.25/$0.50 USD) - 2020/02/07 20:23:24 ET
Table 'Aaltje III' 6-max Seat #2 is the button
Seat 1: canejo10 ($33.31 in chips)
Seat 2: romixon36 ($63.58 in chips)
Seat 3: allObar ($125.30 in chips)
Seat 4: DanaEaston77 ($38.89 in chips)
Seat 5: Clamfish0 ($71.25 in chips)
allObar: posts small blind $0.25
DanaEaston77: posts big blind $0.50
*** HOLE CARDS ***
Clamfish0: folds
canejo10: calls $0.50
romixon36: folds
allObar: folds
DanaEaston77: checks
*** FLOP *** [5h Ad Kh]
DanaEaston77: checks
canejo10: checks
*** TURN *** [5h Ad Kh] [6s]
DanaEaston77: checks
canejo10: checks
*** RIVER *** [5h Ad Kh 6s] [2h]
DanaEaston77: checks
canejo10: checks
*** SHOW DOWN ***
DanaEaston77: shows [9c 8h] (high card Ace)
canejo10: shows [7s Qc] (high card Ace - King+Queen kicker)
canejo10 collected $1.19 from pot
*** SUMMARY ***
Total pot $1.25 | Rake $0.06
Board [5h Ad Kh 6s 2h]
Seat 1: canejo10 showed [7s Qc] and won ($1.19) with high card Ace
Seat 2: romixon36 (button) folded before Flop (didn't bet)
Seat 3: allObar (small blind) folded before Flop
Seat 4: DanaEaston77 (big blind) showed [9c 8h] and lost with high card Ace
Seat 5: Clamfish0 folded before Flop (didn't bet)


PokerStars Hand #208959660592:  Hold'em No Limit ($0.25/$0.50 USD) - 2020/02/07 20:23:51 ET
Table 'Aaltje III' 6-max Seat #3 is the button
Seat 1: canejo10 ($34 in chips)
Seat 2: romixon36 ($63.58 in chips)
Seat 3: allObar ($125.05 in chips)
Seat 4: DanaEaston77 ($38.39 in chips)
Seat 5: Clamfish0 ($71.25 in chips)
DanaEaston77: posts small blind $0.25
Clamfish0: posts big blind $0.50
*** HOLE CARDS ***
canejo10: calls $0.50
romixon36: folds
allObar: folds
DanaEaston77: folds
Clamfish0: checks
*** FLOP *** [8d Qh 7s]
Clamfish0: checks
canejo10: bets $0.50
Clamfish0: folds
Uncalled bet ($0.50) returned to canejo10
canejo10 collected $1.19 from pot
canejo10: doesn't show hand
*** SUMMARY ***
Total pot $1.25 | Rake $0.06
Board [8d Qh 7s]
Seat 1: canejo10 collected ($1.19)
Seat 2: romixon36 folded before Flop (didn't bet)
Seat 3: allObar (button) folded before Flop (didn't bet)
Seat 4: DanaEaston77 (small blind) folded before Flop
Seat 5: Clamfish0 (big blind) folded on the Flop


PokerStars Hand #208959631396:  Hold'em No Limit ($0.25/$0.50 USD) - 2020/02/07 20:22:23 ET
Table 'Aaltje III' 6-max Seat #1 is the button
Seat 1: canejo10 ($32.72 in chips)
Seat 2: romixon36 ($64.58 in chips)
Seat 3: allObar ($125.80 in chips)
Seat 4: DanaEaston77 ($38.30 in chips)
Seat 5: Clamfish0 ($71.25 in chips)
Seat 6: Galileomax ($45.75 in chips)
romixon36: posts small blind $0.25
allObar: posts big blind $0.50
*** HOLE CARDS ***
DanaEaston77: calls $0.50
Clamfish0: folds
Galileomax: folds
canejo10: calls $0.50
romixon36: calls $0.25
allObar: checks
*** FLOP *** [5h 9d 7h]
romixon36: checks
allObar: checks
DanaEaston77: bets $0.50
canejo10: calls $0.50
romixon36: calls $0.50
allObar: folds
*** TURN *** [5h 9d 7h] [4h]
romixon36: checks
DanaEaston77: bets $1.50
canejo10: calls $1.50
romixon36: folds
*** RIVER *** [5h 9d 7h 4h] [3d]
DanaEaston77: checks
canejo10: checks
*** SHOW DOWN ***
DanaEaston77: shows [4c As] (a pair of Fours)
canejo10: shows [4d Ac] (a pair of Fours)
DanaEaston77 collected $3.09 from pot
canejo10 collected $3.09 from pot
*** SUMMARY ***
Total pot $6.50 | Rake $0.32
Board [5h 9d 7h 4h 3d]
Seat 1: canejo10 (button) showed [4d Ac] and won ($3.09) with a pair of Fours
Seat 2: romixon36 (small blind) folded on the Turn
Seat 3: allObar (big blind) folded on the Flop
Seat 4: DanaEaston77 showed [4c As] and won ($3.09) with a pair of Fours
Seat 5: Clamfish0 folded before Flop (didn't bet)
Seat 6: Galileomax folded before Flop (didn't bet)


PokerStars Hand #208959666292:  Hold'em No Limit ($0.25/$0.50 USD) - 2020/02/07 20:24:09 ET
Table 'Aaltje III' 6-max Seat #4 is the button
Seat 1: canejo10 ($34.69 in chips)
Seat 2: romixon36 ($63.58 in chips)
Seat 3: allObar ($125.05 in chips)
Seat 4: DanaEaston77 ($38.14 in chips)
Seat 5: Clamfish0 ($70.75 in chips)
Clamfish0: posts small blind $0.25
canejo10: posts big blind $0.50
*** HOLE CARDS ***
romixon36: raises $0.75 to $1.25
allObar: folds
DanaEaston77: folds
Clamfish0: folds
canejo10: calls $0.75
*** FLOP *** [6s 6d Ts]
canejo10: checks
romixon36: bets $1.33
canejo10: folds
Uncalled bet ($1.33) returned to romixon36
romixon36 collected $2.61 from pot
*** SUMMARY ***
Total pot $2.75 | Rake $0.14
Board [6s 6d Ts]
Seat 1: canejo10 (big blind) folded on the Flop
Seat 2: romixon36 collected ($2.61)
Seat 3: allObar folded before Flop (didn't bet)
Seat 4: DanaEaston77 (button) folded before Flop (didn't bet)
Seat 5: Clamfish0 (small blind) folded before Flop


PokerStars Hand #208959672144:  Hold'em No Limit ($0.25/$0.50 USD) - 2020/02/07 20:24:27 ET
Table 'Aaltje III' 6-max Seat #5 is the button
Seat 1: canejo10 ($33.44 in chips)
Seat 2: romixon36 ($64.94 in chips)
Seat 3: allObar ($125.05 in chips)
Seat 4: DanaEaston77 ($38.14 in chips)
Seat 5: Clamfish0 ($70.50 in chips)
canejo10: posts small blind $0.25
romixon36: posts big blind $0.50
*** HOLE CARDS ***
allObar: folds
DanaEaston77: folds
Clamfish0: raises $0.83 to $1.33
canejo10: calls $1.08
romixon36: folds
*** FLOP *** [Ah 7s Jc]
canejo10: checks
Clamfish0: bets $0.96
canejo10: calls $0.96
*** TURN *** [Ah 7s Jc] [6s]
canejo10: checks
Clamfish0: checks
*** RIVER *** [Ah 7s Jc 6s] [Tc]
canejo10: checks
Clamfish0: checks
*** SHOW DOWN ***
canejo10: shows [8c 4c] (high card Ace)
Clamfish0: shows [Qs 8s] (high card Ace - Queen kicker)
Clamfish0 collected $4.83 from pot
*** SUMMARY ***
Total pot $5.08 | Rake $0.25
Board [Ah 7s Jc 6s Tc]
Seat 1: canejo10 (small blind) showed [8c 4c] and lost with high card Ace
Seat 2: romixon36 (big blind) folded before Flop
Seat 3: allObar folded before Flop (didn't bet)
Seat 4: DanaEaston77 folded before Flop (didn't bet)
Seat 5: Clamfish0 (button) showed [Qs 8s] and won ($4.83) with high card Ace


PokerStars Hand #208959691372:  Hold'em No Limit ($0.25/$0.50 USD) - 2020/02/07 20:25:25 ET
Table 'Aaltje III' 6-max Seat #1 is the button
Seat 1: canejo10 ($31.15 in chips)
Seat 2: romixon36 ($64.44 in chips)
Seat 3: allObar ($125.05 in chips)
Seat 4: DanaEaston77 ($38.14 in chips)
Seat 5: Clamfish0 ($73.04 in chips)
romixon36: posts small blind $0.25
allObar: posts big blind $0.50
Galileomax: sits out
*** HOLE CARDS ***
DanaEaston77: folds
Clamfish0: folds
canejo10: calls $0.50
romixon36: folds
allObar: checks
*** FLOP *** [7h 8h 4s]
allObar: checks
canejo10: bets $0.50
allObar: folds
Uncalled bet ($0.50) returned to canejo10
canejo10 collected $1.19 from pot
canejo10: doesn't show hand
*** SUMMARY ***
Total pot $1.25 | Rake $0.06
Board [7h 8h 4s]
Seat 1: canejo10 (button) collected ($1.19)
Seat 2: romixon36 (small blind) folded before Flop
Seat 3: allObar (big blind) folded on the Flop
Seat 4: DanaEaston77 folded before Flop (didn't bet)
Seat 5: Clamfish0 folded before Flop (didn't bet)


PokerStars Hand #208959710644:  Hold'em No Limit ($0.25/$0.50 USD) - 2020/02/07 20:26:23 ET
Table 'Aaltje III' 6-max Seat #3 is the button
Seat 1: canejo10 ($28.84 in chips)
Seat 2: romixon36 ($64.19 in chips)
Seat 3: allObar ($124.05 in chips)
Seat 4: DanaEaston77 ($41.32 in chips)
Seat 5: Clamfish0 ($73.04 in chips)
DanaEaston77: posts small blind $0.25
Clamfish0: posts big blind $0.50
Galileomax: sits out
*** HOLE CARDS ***
canejo10: calls $0.50
romixon36: raises $1.50 to $2
allObar: folds
DanaEaston77: folds
Clamfish0: folds
canejo10: calls $1.50
*** FLOP *** [3d Th 7c]
canejo10: checks
romixon36: bets $1.31
canejo10: folds
Uncalled bet ($1.31) returned to romixon36
romixon36 collected $4.51 from pot
romixon36: doesn't show hand
*** SUMMARY ***
Total pot $4.75 | Rake $0.24
Board [3d Th 7c]
Seat 1: canejo10 folded on the Flop
Seat 2: romixon36 collected ($4.51)
Seat 3: allObar (button) folded before Flop (didn't bet)
Seat 4: DanaEaston77 (small blind) folded before Flop
Seat 5: Clamfish0 (big blind) folded before Flop


PokerStars Hand #208959699224:  Hold'em No Limit ($0.25/$0.50 USD) - 2020/02/07 20:25:49 ET
Table 'Aaltje III' 6-max Seat #2 is the button
Seat 1: canejo10 ($31.84 in chips)
Seat 2: romixon36 ($64.19 in chips)
Seat 3: allObar ($124.55 in chips)
Seat 4: DanaEaston77 ($38.14 in chips)
Seat 5: Clamfish0 ($73.04 in chips)
allObar: posts small blind $0.25
DanaEaston77: posts big blind $0.50
Galileomax: sits out
*** HOLE CARDS ***
Clamfish0: folds
canejo10: calls $0.50
romixon36: folds
allObar: calls $0.25
DanaEaston77: raises $2.50 to $3
canejo10: calls $2.50
allObar: folds
*** FLOP *** [Qc 2h Th]
DanaEaston77: bets $6
canejo10: folds
Uncalled bet ($6) returned to DanaEaston77
DanaEaston77 collected $6.18 from pot
DanaEaston77: doesn't show hand
*** SUMMARY ***
Total pot $6.50 | Rake $0.32
Board [Qc 2h Th]
Seat 1: canejo10 folded on the Flop
Seat 2: romixon36 (button) folded before Flop (didn't bet)
Seat 3: allObar (small blind) folded before Flop
Seat 4: DanaEaston77 (big blind) collected ($6.18)
Seat 5: Clamfish0 folded before Flop (didn't bet)


PokerStars Hand #208959721625:  Hold'em No Limit ($0.25/$0.50 USD) - 2020/02/07 20:26:56 ET
Table 'Aaltje III' 6-max Seat #4 is the button
Seat 1: canejo10 ($26.84 in chips)
Seat 2: romixon36 ($66.70 in chips)
Seat 3: allObar ($124.05 in chips)
Seat 4: DanaEaston77 ($41.07 in chips)
Seat 5: Clamfish0 ($72.54 in chips)
Seat 6: Galileomax ($45.75 in chips)
Clamfish0: posts small blind $0.25
Galileomax: posts big blind $0.50
*** HOLE CARDS ***
canejo10: raises $3 to $3.50
romixon36: folds
allObar: folds
DanaEaston77: folds
Clamfish0: folds
Galileomax: folds
Uncalled bet ($3) returned to canejo10
canejo10 collected $1.25 from pot
canejo10: doesn't show hand
*** SUMMARY ***
Total pot $1.25 | Rake $0
Seat 1: canejo10 collected ($1.25)
Seat 2: romixon36 folded before Flop (didn't bet)
Seat 3: allObar folded before Flop (didn't bet)
Seat 4: DanaEaston77 (button) folded before Flop (didn't bet)
Seat 5: Clamfish0 (small blind) folded before Flop
Seat 6: Galileomax (big blind) folded before Flop


PokerStars Hand #208959756108:  Hold'em No Limit ($0.25/$0.50 USD) - 2020/02/07 20:28:33 ET
Table 'Aaltje III' 6-max Seat #6 is the button
Seat 1: canejo10 ($25.48 in chips)
Seat 3: allObar ($126.19 in chips)
Seat 4: DanaEaston77 ($41.07 in chips)
Seat 5: Clamfish0 ($72.29 in chips)
Seat 6: Galileomax ($45 in chips)
canejo10: posts small blind $0.25
romixon36: is sitting out
allObar: posts big blind $0.50
*** HOLE CARDS ***
romixon36 leaves the table
DanaEaston77: folds
Clamfish0: raises $0.83 to $1.33
Galileomax: folds
canejo10: calls $1.08
allObar: folds
*** FLOP *** [5d Ts 3s]
canejo10: bets $0.50
Lexusloal joins the table at seat #2
Clamfish0: calls $0.50
*** TURN *** [5d Ts 3s] [Js]
canejo10: bets $0.50
Clamfish0: folds
Uncalled bet ($0.50) returned to canejo10
canejo10 collected $3.95 from pot
canejo10: doesn't show hand
*** SUMMARY ***
Total pot $4.16 | Rake $0.21
Board [5d Ts 3s Js]
Seat 1: canejo10 (small blind) collected ($3.95)
Seat 3: allObar (big blind) folded before Flop
Seat 4: DanaEaston77 folded before Flop (didn't bet)
Seat 5: Clamfish0 folded on the Turn
Seat 6: Galileomax (button) folded before Flop (didn't bet)


PokerStars Hand #208959741218:  Hold'em No Limit ($0.25/$0.50 USD) - 2020/02/07 20:27:56 ET
Table 'Aaltje III' 6-max Seat #5 is the button
Seat 1: canejo10 ($27.59 in chips)
Seat 2: romixon36 ($66.70 in chips)
Seat 3: allObar ($124.05 in chips)
Seat 4: DanaEaston77 ($41.07 in chips)
Seat 5: Clamfish0 ($72.29 in chips)
Seat 6: Galileomax ($45.25 in chips)
Galileomax: posts small blind $0.25
canejo10: posts big blind $0.50
*** HOLE CARDS ***
romixon36: folds
allObar: raises $0.75 to $1.25
DanaEaston77: folds
Clamfish0: folds
Galileomax: folds
canejo10: calls $0.75
*** FLOP *** [4h As 3c]
canejo10: checks
allObar: bets $0.86
canejo10: calls $0.86
*** TURN *** [4h As 3c] [3s]
canejo10: checks
allObar: checks
*** RIVER *** [4h As 3c 3s] [Jh]
canejo10: checks
allObar: checks
*** SHOW DOWN ***
canejo10: shows [5h Ks] (a pair of Threes)
allObar: shows [2s 2h] (two pair, Threes and Deuces)
allObar collected $4.25 from pot
*** SUMMARY ***
Total pot $4.47 | Rake $0.22
Board [4h As 3c 3s Jh]
Seat 1: canejo10 (big blind) showed [5h Ks] and lost with a pair of Threes
Seat 2: romixon36 folded before Flop (didn't bet)
Seat 3: allObar showed [2s 2h] and won ($4.25) with two pair, Threes and Deuces
Seat 4: DanaEaston77 folded before Flop (didn't bet)
Seat 5: Clamfish0 (button) folded before Flop (didn't bet)
Seat 6: Galileomax (small blind) folded before Flop


PokerStars Hand #208959765593:  Hold'em No Limit ($0.25/$0.50 USD) - 2020/02/07 20:29:02 ET
Table 'Aaltje III' 6-max Seat #1 is the button
Seat 1: canejo10 ($27.60 in chips)
Seat 3: allObar ($125.69 in chips)
Seat 4: DanaEaston77 ($41.07 in chips)
Seat 5: Clamfish0 ($70.46 in chips)
Seat 6: Galileomax ($45 in chips)
allObar: posts small blind $0.25
DanaEaston77: posts big blind $0.50
*** HOLE CARDS ***
Clamfish0: raises $0.83 to $1.33
Galileomax: folds
canejo10: calls $1.33
allObar: folds
DanaEaston77: calls $0.83
*** FLOP *** [Kd 9s 8s]
DanaEaston77: checks
Clamfish0: checks
canejo10: bets $2
DanaEaston77: folds
Clamfish0: folds
Uncalled bet ($2) returned to canejo10
canejo10 collected $4.03 from pot
canejo10: doesn't show hand
*** SUMMARY ***
Total pot $4.24 | Rake $0.21
Board [Kd 9s 8s]
Seat 1: canejo10 (button) collected ($4.03)
Seat 3: allObar (small blind) folded before Flop
Seat 4: DanaEaston77 (big blind) folded on the Flop
Seat 5: Clamfish0 folded on the Flop
Seat 6: Galileomax folded before Flop (didn't bet)


PokerStars Hand #208959776280:  Hold'em No Limit ($0.25/$0.50 USD) - 2020/02/07 20:29:35 ET
Table 'Aaltje III' 6-max Seat #3 is the button
Seat 1: canejo10 ($30.30 in chips)
Seat 3: allObar ($125.44 in chips)
Seat 4: DanaEaston77 ($39.74 in chips)
Seat 5: Clamfish0 ($69.13 in chips)
Seat 6: Galileomax ($45 in chips)
DanaEaston77: posts small blind $0.25
Clamfish0: posts big blind $0.50
Lexusloal: sits out
*** HOLE CARDS ***
Galileomax: folds
canejo10: calls $0.50
allObar: folds
DanaEaston77: calls $0.25
Clamfish0: checks
*** FLOP *** [6c 7s 2s]
DanaEaston77: checks
Clamfish0: checks
canejo10 has timed out
canejo10: checks
*** TURN *** [6c 7s 2s] [2h]
DanaEaston77: checks
Clamfish0: checks
canejo10: checks
*** RIVER *** [6c 7s 2s 2h] [2d]
DanaEaston77: checks
Clamfish0: checks
canejo10: checks
*** SHOW DOWN ***
DanaEaston77: shows [8s Qh] (three of a kind, Deuces)
Clamfish0: mucks hand
canejo10: mucks hand
DanaEaston77 collected $1.42 from pot
*** SUMMARY ***
Total pot $1.50 | Rake $0.08
Board [6c 7s 2s 2h 2d]
Seat 1: canejo10 mucked
Seat 3: allObar (button) folded before Flop (didn't bet)
Seat 4: DanaEaston77 (small blind) showed [8s Qh] and won ($1.42) with three of a kind, Deuces
Seat 5: Clamfish0 (big blind) mucked
Seat 6: Galileomax folded before Flop (didn't bet)


PokerStars Hand #208959803363:  Hold'em No Limit ($0.25/$0.50 USD) - 2020/02/07 20:30:59 ET
Table 'Aaltje III' 6-max Seat #4 is the button
Seat 1: canejo10 ($29.80 in chips)
Seat 3: allObar ($125.44 in chips)
Seat 4: DanaEaston77 ($40.66 in chips)
Seat 5: Clamfish0 ($68.63 in chips)
Seat 6: Galileomax ($45 in chips)
Clamfish0: posts small blind $0.25
Galileomax: posts big blind $0.50
Lexusloal: sits out
*** HOLE CARDS ***
canejo10: calls $0.50
allObar: folds
DanaEaston77: folds
Clamfish0: folds
Galileomax: checks
*** FLOP *** [3c Tc 4d]
Galileomax: checks
canejo10: bets $0.50
Galileomax: calls $0.50
*** TURN *** [3c Tc 4d] [2c]
Galileomax: checks
canejo10: checks
*** RIVER *** [3c Tc 4d 2c] [Jd]
Galileomax: bets $2
canejo10: calls $2
*** SHOW DOWN ***
Galileomax: shows [6c 8c] (a flush, Ten high)
canejo10: mucks hand
Galileomax collected $5.94 from pot
*** SUMMARY ***
Total pot $6.25 | Rake $0.31
Board [3c Tc 4d 2c Jd]
Seat 1: canejo10 mucked
Seat 3: allObar folded before Flop (didn't bet)
Seat 4: DanaEaston77 (button) folded before Flop (didn't bet)
Seat 5: Clamfish0 (small blind) folded before Flop
Seat 6: Galileomax (big blind) showed [6c 8c] and won ($5.94) with a flush, Ten high


PokerStars Hand #208959829150:  Hold'em No Limit ($0.25/$0.50 USD) - 2020/02/07 20:32:04 ET
Table 'Aaltje III' 6-max Seat #5 is the button
Seat 1: canejo10 ($26.80 in chips)
Seat 3: allObar ($125.44 in chips)
Seat 4: DanaEaston77 ($40.66 in chips)
Seat 5: Clamfish0 ($68.38 in chips)
Seat 6: Galileomax ($47.94 in chips)
Galileomax: posts small blind $0.25
canejo10: posts big blind $0.50
Lexusloal: sits out
*** HOLE CARDS ***
allObar: folds
DanaEaston77: calls $0.50
Clamfish0: raises $1.23 to $1.73
Galileomax: folds
canejo10 has timed out
canejo10: folds
DanaEaston77: calls $1.23
*** FLOP *** [Tc 8c 3c]
DanaEaston77: checks
Clamfish0: bets $1.28
DanaEaston77: calls $1.28
*** TURN *** [Tc 8c 3c] [7h]
DanaEaston77: checks
Clamfish0: checks
*** RIVER *** [Tc 8c 3c 7h] [6s]
DanaEaston77: bets $6.50
Clamfish0: folds
Uncalled bet ($6.50) returned to DanaEaston77
DanaEaston77 collected $6.43 from pot
DanaEaston77: doesn't show hand
*** SUMMARY ***
Total pot $6.77 | Rake $0.34
Board [Tc 8c 3c 7h 6s]
Seat 1: canejo10 (big blind) folded before Flop
Seat 3: allObar folded before Flop (didn't bet)
Seat 4: DanaEaston77 collected ($6.43)
Seat 5: Clamfish0 (button) folded on the River
Seat 6: Galileomax (small blind) folded before Flop


PokerStars Hand #208959858244:  Hold'em No Limit ($0.25/$0.50 USD) - 2020/02/07 20:33:35 ET
Table 'Aaltje III' 6-max Seat #6 is the button
Seat 1: canejo10 ($26.30 in chips)
Seat 2: Lexusloal ($50 in chips)
Seat 3: allObar ($125.44 in chips)
Seat 4: DanaEaston77 ($44.08 in chips)
Seat 5: Clamfish0 ($65.37 in chips)
Seat 6: Galileomax ($47.69 in chips)
canejo10: posts small blind $0.25
Lexusloal: posts big blind $0.50
*** HOLE CARDS ***
allObar: folds
DanaEaston77: folds
Clamfish0: raises $0.83 to $1.33
Galileomax: calls $1.33
canejo10: calls $1.08
Lexusloal: folds
*** FLOP *** [7c 6d Ks]
canejo10: checks
Clamfish0: checks
Galileomax: checks
*** TURN *** [7c 6d Ks] [Tc]
canejo10: bets $1
Clamfish0: calls $1
Galileomax: folds
*** RIVER *** [7c 6d Ks Tc] [As]
canejo10: bets $1
Clamfish0: raises $3.43 to $4.43
canejo10: folds
Uncalled bet ($3.43) returned to Clamfish0
Clamfish0 collected $8.07 from pot
Clamfish0: doesn't show hand
*** SUMMARY ***
Total pot $8.49 | Rake $0.42
Board [7c 6d Ks Tc As]
Seat 1: canejo10 (small blind) folded on the River
Seat 2: Lexusloal (big blind) folded before Flop
Seat 3: allObar folded before Flop (didn't bet)
Seat 4: DanaEaston77 folded before Flop (didn't bet)
Seat 5: Clamfish0 collected ($8.07)
Seat 6: Galileomax (button) folded on the Turn


PokerStars Hand #208959896313:  Hold'em No Limit ($0.25/$0.50 USD) - 2020/02/07 20:35:35 ET
Table 'Aaltje III' 6-max Seat #2 is the button
Seat 2: Lexusloal ($71.47 in chips)
Seat 4: DanaEaston77 ($43.58 in chips)
Seat 5: Clamfish0 ($70.11 in chips)
Seat 6: Galileomax ($46.36 in chips)
DanaEaston77: posts small blind $0.25
Clamfish0: posts big blind $0.50
*** HOLE CARDS ***
Galileomax: folds
Lexusloal: folds
DanaEaston77: raises $1 to $1.50
Clamfish0: folds
Uncalled bet ($1) returned to DanaEaston77
DanaEaston77 collected $1 from pot
*** SUMMARY ***
Total pot $1 | Rake $0
Seat 2: Lexusloal (button) folded before Flop (didn't bet)
Seat 4: DanaEaston77 (small blind) collected ($1)
Seat 5: Clamfish0 (big blind) folded before Flop
Seat 6: Galileomax folded before Flop (didn't bet)


PokerStars Hand #208959881174:  Hold'em No Limit ($0.25/$0.50 USD) - 2020/02/07 20:34:48 ET
Table 'Aaltje III' 6-max Seat #1 is the button
Seat 1: canejo10 ($22.97 in chips)
Seat 2: Lexusloal ($50 in chips)
Seat 4: DanaEaston77 ($44.08 in chips)
Seat 5: Clamfish0 ($70.11 in chips)
Seat 6: Galileomax ($46.36 in chips)
Lexusloal: posts small blind $0.25
allObar: is sitting out
allObar leaves the table
DanaEaston77: posts big blind $0.50
*** HOLE CARDS ***
Clamfish0: folds
Galileomax: folds
canejo10: calls $0.50
Lexusloal: raises $2.50 to $3
DanaEaston77: folds
canejo10: calls $2.50
*** FLOP *** [7s 9s Js]
Lexusloal: bets $3.21
canejo10: calls $3.21
*** TURN *** [7s 9s Js] [Kh]
Meskalita joins the table at seat #3
Lexusloal: bets $43.79 and is all-in
canejo10: calls $16.76 and is all-in
Uncalled bet ($27.03) returned to Lexusloal
*** RIVER *** [7s 9s Js Kh] [4d]
*** SHOW DOWN ***
Lexusloal: shows [Ks Ah] (a pair of Kings)
canejo10: shows [4s 6c] (a pair of Fours)
Lexusloal collected $44.44 from pot
*** SUMMARY ***
Total pot $46.44 | Rake $2
Board [7s 9s Js Kh 4d]
Seat 1: canejo10 (button) showed [4s 6c] and lost with a pair of Fours
Seat 2: Lexusloal (small blind) showed [Ks Ah] and won ($44.44) with a pair of Kings
Seat 4: DanaEaston77 (big blind) folded before Flop
Seat 5: Clamfish0 folded before Flop (didn't bet)
Seat 6: Galileomax folded before Flop (didn't bet)


PokerStars Hand #208959913193:  Hold'em No Limit ($0.25/$0.50 USD) - 2020/02/07 20:36:28 ET
Table 'Aaltje III' 6-max Seat #5 is the button
Seat 4: DanaEaston77 ($42.58 in chips)
Seat 5: Clamfish0 ($72.39 in chips)
Seat 6: Galileomax ($44.86 in chips)
Galileomax: posts small blind $0.25
Lexusloal: is sitting out
DanaEaston77: posts big blind $0.50
*** HOLE CARDS ***
Clamfish0: folds
Lexusloal leaves the table
Galileomax: calls $0.25
DanaEaston77: raises $1 to $1.50
Galileomax: calls $1
*** FLOP *** [Ac Ks 5s]
Galileomax: checks
Bobruysk joins the table at seat #1
DanaEaston77: checks
*** TURN *** [Ac Ks 5s] [9h]
Galileomax: bets $1.91
DanaEaston77: folds
Uncalled bet ($1.91) returned to Galileomax
Galileomax collected $2.85 from pot
Galileomax: doesn't show hand
*** SUMMARY ***
Total pot $3 | Rake $0.15
Board [Ac Ks 5s 9h]
Seat 4: DanaEaston77 (big blind) folded on the Turn
Seat 5: Clamfish0 (button) folded before Flop (didn't bet)
Seat 6: Galileomax (small blind) collected ($2.85)


PokerStars Hand #208959901870:  Hold'em No Limit ($0.25/$0.50 USD) - 2020/02/07 20:35:53 ET
Table 'Aaltje III' 6-max Seat #4 is the button
Seat 2: Lexusloal ($71.47 in chips)
Seat 4: DanaEaston77 ($44.08 in chips)
Seat 5: Clamfish0 ($69.61 in chips)
Seat 6: Galileomax ($46.36 in chips)
Clamfish0: posts small blind $0.25
Galileomax: posts big blind $0.50
Meskalita: sits out
*** HOLE CARDS ***
canejo10 leaves the table
Lexusloal: folds
Meskalita leaves the table
DanaEaston77: raises $1 to $1.50
ZonTTT joins the table at seat #1
ZonTTT leaves the table
Clamfish0: calls $1.25
Galileomax: calls $1
*** FLOP *** [5s 9s 5c]
Clamfish0: checks
Galileomax: checks
é=mc² joins the table at seat #1
DanaEaston77: checks
*** TURN *** [5s 9s 5c] [4h]
é=mc² leaves the table
Clamfish0: bets $1.37
Galileomax: folds
DanaEaston77: folds
Uncalled bet ($1.37) returned to Clamfish0
Clamfish0 collected $4.28 from pot
Clamfish0: doesn't show hand
*** SUMMARY ***
Total pot $4.50 | Rake $0.22
Board [5s 9s 5c 4h]
Seat 2: Lexusloal folded before Flop (didn't bet)
Seat 4: DanaEaston77 (button) folded on the Turn
Seat 5: Clamfish0 (small blind) collected ($4.28)
Seat 6: Galileomax (big blind) folded on the Turn


PokerStars Hand #208959923523:  Hold'em No Limit ($0.25/$0.50 USD) - 2020/02/07 20:37:00 ET
Table 'Aaltje III' 6-max Seat #6 is the button
Seat 4: DanaEaston77 ($41.08 in chips)
Seat 5: Clamfish0 ($72.39 in chips)
Seat 6: Galileomax ($46.21 in chips)
DanaEaston77: posts small blind $0.25
Clamfish0: posts big blind $0.50
*** HOLE CARDS ***
Galileomax: folds
DanaEaston77: raises $1 to $1.50
Bobruysk leaves the table
Clamfish0: calls $1
*** FLOP *** [9d 5h Tc]
DanaEaston77: checks
ishuha joins the table at seat #3
ArfanTariq joins the table at seat #2
Respad Gammeing joins the table at seat #1
Clamfish0: checks
*** TURN *** [9d 5h Tc] [5d]
DanaEaston77: bets $1.50
Clamfish0: folds
Uncalled bet ($1.50) returned to DanaEaston77
DanaEaston77 collected $2.85 from pot
DanaEaston77: doesn't show hand
*** SUMMARY ***
Total pot $3 | Rake $0.15
Board [9d 5h Tc 5d]
Seat 4: DanaEaston77 (small blind) collected ($2.85)
Seat 5: Clamfish0 (big blind) folded on the Turn
Seat 6: Galileomax (button) folded before Flop (didn't bet)


PokerStars Hand #208959941154:  Hold'em No Limit ($0.25/$0.50 USD) - 2020/02/07 20:37:35 ET
Table 'Aaltje III' 6-max Seat #4 is the button
Seat 1: Respad Gammeing ($23.81 in chips)
Seat 2: ArfanTariq ($20 in chips)
Seat 4: DanaEaston77 ($42.43 in chips)
Seat 5: Clamfish0 ($70.89 in chips)
Seat 6: Galileomax ($46.21 in chips)
Clamfish0: posts small blind $0.25
Galileomax: posts big blind $0.50
Respad Gammeing: posts big blind $0.50
ArfanTariq: posts big blind $0.50
ishuha: sits out
*** HOLE CARDS ***
Respad Gammeing: checks
ArfanTariq: checks
DanaEaston77: folds
Clamfish0: folds
Galileomax: checks
*** FLOP *** [As Kh Qd]
Galileomax: checks
Respad Gammeing: checks
ArfanTariq: bets $2.19
Galileomax: folds
Respad Gammeing: calls $2.19
*** TURN *** [As Kh Qd] [8d]
Respad Gammeing: checks
ArfanTariq: checks
*** RIVER *** [As Kh Qd 8d] [3d]
Respad Gammeing: checks
ArfanTariq: bets $2.60
Respad Gammeing: folds
Uncalled bet ($2.60) returned to ArfanTariq
ArfanTariq collected $5.82 from pot
ArfanTariq: doesn't show hand
*** SUMMARY ***
Total pot $6.13 | Rake $0.31
Board [As Kh Qd 8d 3d]
Seat 1: Respad Gammeing folded on the River
Seat 2: ArfanTariq collected ($5.82)
Seat 4: DanaEaston77 (button) folded before Flop (didn't bet)
Seat 5: Clamfish0 (small blind) folded before Flop
Seat 6: Galileomax (big blind) folded on the Flop


PokerStars Hand #208960001498:  Hold'em No Limit ($0.25/$0.50 USD) - 2020/02/07 20:40:19 ET
Table 'Aaltje III' 6-max Seat #6 is the button
Seat 1: Respad Gammeing ($19.39 in chips)
Seat 2: ArfanTariq ($30.89 in chips)
Seat 4: DanaEaston77 ($42.43 in chips)
Seat 5: Clamfish0 ($68.91 in chips)
Seat 6: Galileomax ($50.55 in chips)
Respad Gammeing: posts small blind $0.25
ArfanTariq: posts big blind $0.50
ishuha: sits out
*** HOLE CARDS ***
DanaEaston77: raises $1 to $1.50
Clamfish0: folds
Galileomax: folds
Respad Gammeing: folds
ArfanTariq: calls $1
*** FLOP *** [Th Kd 3h]
ArfanTariq: checks
DanaEaston77: bets $1.50
ArfanTariq: calls $1.50
*** TURN *** [Th Kd 3h] [4s]
ArfanTariq: checks
DanaEaston77: bets $3
ArfanTariq: folds
Uncalled bet ($3) returned to DanaEaston77
DanaEaston77 collected $5.94 from pot
*** SUMMARY ***
Total pot $6.25 | Rake $0.31
Board [Th Kd 3h 4s]
Seat 1: Respad Gammeing (small blind) folded before Flop
Seat 2: ArfanTariq (big blind) folded on the Turn
Seat 4: DanaEaston77 collected ($5.94)
Seat 5: Clamfish0 folded before Flop (didn't bet)
Seat 6: Galileomax (button) folded before Flop (didn't bet)


PokerStars Hand #208959961864:  Hold'em No Limit ($0.25/$0.50 USD) - 2020/02/07 20:38:41 ET
Table 'Aaltje III' 6-max Seat #5 is the button
Seat 1: Respad Gammeing ($21.12 in chips)
Seat 2: ArfanTariq ($32.62 in chips)
Seat 4: DanaEaston77 ($42.43 in chips)
Seat 5: Clamfish0 ($70.64 in chips)
Seat 6: Galileomax ($45.71 in chips)
Galileomax: posts small blind $0.25
Respad Gammeing: posts big blind $0.50
ishuha: sits out
*** HOLE CARDS ***
ArfanTariq: calls $0.50
DanaEaston77: folds
Clamfish0: raises $1.23 to $1.73
Galileomax: calls $1.48
Respad Gammeing: calls $1.23
ArfanTariq: calls $1.23
*** FLOP *** [6s 4h Qc]
Galileomax: checks
Respad Gammeing: checks
ArfanTariq: checks
Clamfish0: checks
*** TURN *** [6s 4h Qc] [Qd]
Galileomax: checks
Respad Gammeing: checks
ArfanTariq: checks
Clamfish0: checks
*** RIVER *** [6s 4h Qc Qd] [2s]
Galileomax: bets $3.98
Respad Gammeing: folds
ArfanTariq: folds
Clamfish0: folds
Uncalled bet ($3.98) returned to Galileomax
Galileomax collected $6.57 from pot
Galileomax: doesn't show hand
*** SUMMARY ***
Total pot $6.92 | Rake $0.35
Board [6s 4h Qc Qd 2s]
Seat 1: Respad Gammeing (big blind) folded on the River
Seat 2: ArfanTariq folded on the River
Seat 4: DanaEaston77 folded before Flop (didn't bet)
Seat 5: Clamfish0 (button) folded on the River
Seat 6: Galileomax (small blind) collected ($6.57)


PokerStars Hand #208960014303:  Hold'em No Limit ($0.25/$0.50 USD) - 2020/02/07 20:40:59 ET
Table 'Aaltje III' 6-max Seat #1 is the button
Seat 1: Respad Gammeing ($19.14 in chips)
Seat 2: ArfanTariq ($27.89 in chips)
Seat 3: ishuha ($50 in chips)
Seat 4: DanaEaston77 ($45.37 in chips)
Seat 5: Clamfish0 ($68.91 in chips)
Seat 6: Galileomax ($50.55 in chips)
ArfanTariq: posts small blind $0.25
ishuha: posts big blind $0.50
*** HOLE CARDS ***
DanaEaston77: folds
Clamfish0: raises $0.83 to $1.33
Galileomax: folds
Respad Gammeing: calls $1.33
ArfanTariq: calls $1.08
ishuha: calls $0.83
*** FLOP *** [Jh 5s 8s]
ArfanTariq: checks
ishuha: checks
Clamfish0: checks
Respad Gammeing: bets $1.84
ArfanTariq: calls $1.84
ishuha: calls $1.84
Clamfish0: raises $65.74 to $67.58 and is all-in
Respad Gammeing: folds
ArfanTariq: folds
ishuha: folds
Uncalled bet ($65.74) returned to Clamfish0
Clamfish0 collected $12.05 from pot
Clamfish0: doesn't show hand
*** SUMMARY ***
Total pot $12.68 | Rake $0.63
Board [Jh 5s 8s]
Seat 1: Respad Gammeing (button) folded on the Flop
Seat 2: ArfanTariq (small blind) folded on the Flop
Seat 3: ishuha (big blind) folded on the Flop
Seat 4: DanaEaston77 folded before Flop (didn't bet)
Seat 5: Clamfish0 collected ($12.05)
Seat 6: Galileomax folded before Flop (didn't bet)


PokerStars Hand #208960040587:  Hold'em No Limit ($0.25/$0.50 USD) - 2020/02/07 20:42:23 ET
Table 'Aaltje III' 6-max Seat #2 is the button
Seat 1: Respad Gammeing ($15.97 in chips)
Seat 2: ArfanTariq ($24.72 in chips)
Seat 3: ishuha ($50 in chips)
Seat 4: DanaEaston77 ($45.37 in chips)
Seat 5: Clamfish0 ($77.79 in chips)
Seat 6: Galileomax ($50.55 in chips)
ishuha: posts small blind $0.25
DanaEaston77: posts big blind $0.50
*** HOLE CARDS ***
Clamfish0: folds
Galileomax: folds
Respad Gammeing: raises $1.66 to $2.16
ArfanTariq: calls $2.16
ishuha: folds
DanaEaston77: folds
*** FLOP *** [Td 3h 9c]
Respad Gammeing: bets $1.74
ArfanTariq: calls $1.74
*** TURN *** [Td 3h 9c] [7c]
Respad Gammeing: bets $2.79
ArfanTariq: calls $2.79
*** RIVER *** [Td 3h 9c 7c] [4c]
Respad Gammeing: bets $4.51
ArfanTariq: calls $4.51
*** SHOW DOWN ***
Respad Gammeing: shows [9s As] (a pair of Nines)
ArfanTariq: mucks hand
Respad Gammeing collected $21.99 from pot
*** SUMMARY ***
Total pot $23.15 | Rake $1.16
Board [Td 3h 9c 7c 4c]
Seat 1: Respad Gammeing showed [9s As] and won ($21.99) with a pair of Nines
Seat 2: ArfanTariq (button) mucked
Seat 3: ishuha (small blind) folded before Flop
Seat 4: DanaEaston77 (big blind) folded before Flop
Seat 5: Clamfish0 folded before Flop (didn't bet)
Seat 6: Galileomax folded before Flop (didn't bet)


PokerStars Hand #208960054976:  Hold'em No Limit ($0.25/$0.50 USD) - 2020/02/07 20:43:09 ET
Table 'Aaltje III' 6-max Seat #3 is the button
Seat 1: Respad Gammeing ($26.76 in chips)
Seat 2: ArfanTariq ($13.52 in chips)
Seat 3: ishuha ($50 in chips)
Seat 4: DanaEaston77 ($44.87 in chips)
Seat 5: Clamfish0 ($77.79 in chips)
Seat 6: Galileomax ($50.55 in chips)
DanaEaston77: posts small blind $0.25
Clamfish0: posts big blind $0.50
*** HOLE CARDS ***
Galileomax: folds
Respad Gammeing: raises $2.82 to $3.32
ArfanTariq: calls $3.32
ishuha: folds
DanaEaston77: raises $2.82 to $6.14
Clamfish0: folds
Respad Gammeing: calls $2.82
ArfanTariq: calls $2.82
*** FLOP *** [6s As 2s]
DanaEaston77: bets $38.73 and is all-in
Respad Gammeing: folds
ArfanTariq: calls $7.38 and is all-in
Uncalled bet ($31.35) returned to DanaEaston77
*** TURN *** [6s As 2s] [4s]
*** RIVER *** [6s As 2s 4s] [6d]
*** SHOW DOWN ***
DanaEaston77: shows [Jc Ac] (two pair, Aces and Sixes)
ArfanTariq: shows [Js Qs] (a flush, Ace high)
ArfanTariq collected $32 from pot
*** SUMMARY ***
Total pot $33.68 | Rake $1.68
Board [6s As 2s 4s 6d]
Seat 1: Respad Gammeing folded on the Flop
Seat 2: ArfanTariq showed [Js Qs] and won ($32) with a flush, Ace high
Seat 3: ishuha (button) folded before Flop (didn't bet)
Seat 4: DanaEaston77 (small blind) showed [Jc Ac] and lost with two pair, Aces and Sixes
Seat 5: Clamfish0 (big blind) folded before Flop
Seat 6: Galileomax folded before Flop (didn't bet)


PokerStars Hand #208960081471:  Hold'em No Limit ($0.25/$0.50 USD) - 2020/02/07 20:44:21 ET
Table 'Aaltje III' 6-max Seat #4 is the button
Seat 1: Respad Gammeing ($20.62 in chips)
Seat 2: ArfanTariq ($32 in chips)
Seat 3: ishuha ($50 in chips)
Seat 4: DanaEaston77 ($31.35 in chips)
Seat 5: Clamfish0 ($77.29 in chips)
Seat 6: Galileomax ($50.55 in chips)
Clamfish0: posts small blind $0.25
Galileomax: posts big blind $0.50
*** HOLE CARDS ***
Respad Gammeing: calls $0.50
ArfanTariq: folds
ishuha: raises $1 to $1.50
DanaEaston77: calls $1.50
Clamfish0: folds
Galileomax: folds
Respad Gammeing: calls $1
*** FLOP *** [2d 4d 3s]
Respad Gammeing: bets $1.71
ishuha: folds
DanaEaston77: calls $1.71
*** TURN *** [2d 4d 3s] [9h]
Respad Gammeing: bets $17.41 and is all-in
DanaEaston77: calls $17.41
*** RIVER *** [2d 4d 3s 9h] [6c]
*** SHOW DOWN ***
Respad Gammeing: shows [3h 2h] (two pair, Threes and Deuces)
DanaEaston77: shows [Jc 9s] (a pair of Nines)
Respad Gammeing collected $41.49 from pot
*** SUMMARY ***
Total pot $43.49 | Rake $2
Board [2d 4d 3s 9h 6c]
Seat 1: Respad Gammeing showed [3h 2h] and won ($41.49) with two pair, Threes and Deuces
Seat 2: ArfanTariq folded before Flop (didn't bet)
Seat 3: ishuha folded on the Flop
Seat 4: DanaEaston77 (button) showed [Jc 9s] and lost with a pair of Nines
Seat 5: Clamfish0 (small blind) folded before Flop
Seat 6: Galileomax (big blind) folded before Flop


PokerStars Hand #208960095144:  Hold'em No Limit ($0.25/$0.50 USD) - 2020/02/07 20:45:04 ET
Table 'Aaltje III' 6-max Seat #5 is the button
Seat 1: Respad Gammeing ($41.49 in chips)
Seat 2: ArfanTariq ($50 in chips)
Seat 3: ishuha ($50 in chips)
Seat 4: DanaEaston77 ($10.73 in chips)
Seat 5: Clamfish0 ($77.04 in chips)
Seat 6: Galileomax ($50.05 in chips)
Galileomax: posts small blind $0.25
Respad Gammeing: posts big blind $0.50
*** HOLE CARDS ***
ArfanTariq: folds
ishuha: folds
DanaEaston77: folds
Clamfish0: folds
Galileomax: calls $0.25
Respad Gammeing: checks
*** FLOP *** [7d 5s 7c]
Galileomax: checks
Respad Gammeing: checks
*** TURN *** [7d 5s 7c] [Ah]
Galileomax: checks
Respad Gammeing: checks
*** RIVER *** [7d 5s 7c Ah] [Jh]
Galileomax: bets $0.78
Respad Gammeing: folds
Uncalled bet ($0.78) returned to Galileomax
Galileomax collected $0.95 from pot
Galileomax: doesn't show hand
*** SUMMARY ***
Total pot $1 | Rake $0.05
Board [7d 5s 7c Ah Jh]
Seat 1: Respad Gammeing (big blind) folded on the River
Seat 2: ArfanTariq folded before Flop (didn't bet)
Seat 3: ishuha folded before Flop (didn't bet)
Seat 4: DanaEaston77 folded before Flop (didn't bet)
Seat 5: Clamfish0 (button) folded before Flop (didn't bet)
Seat 6: Galileomax (small blind) collected ($0.95)


PokerStars Hand #208960110843:  Hold'em No Limit ($0.25/$0.50 USD) - 2020/02/07 20:45:55 ET
Table 'Aaltje III' 6-max Seat #6 is the button
Seat 1: Respad Gammeing ($40.99 in chips)
Seat 2: ArfanTariq ($50 in chips)
Seat 3: ishuha ($50 in chips)
Seat 4: DanaEaston77 ($10.73 in chips)
Seat 5: Clamfish0 ($77.04 in chips)
Seat 6: Galileomax ($50.50 in chips)
Respad Gammeing: posts small blind $0.25
ArfanTariq: posts big blind $0.50
*** HOLE CARDS ***
ishuha: raises $0.75 to $1.25
DanaEaston77: raises $9.48 to $10.73 and is all-in
Clamfish0: folds
Galileomax: folds
Respad Gammeing: folds
ArfanTariq: folds
ishuha: folds
Uncalled bet ($9.48) returned to DanaEaston77
DanaEaston77 collected $3.25 from pot
DanaEaston77: doesn't show hand
*** SUMMARY ***
Total pot $3.25 | Rake $0
Seat 1: Respad Gammeing (small blind) folded before Flop
Seat 2: ArfanTariq (big blind) folded before Flop
Seat 3: ishuha folded before Flop
Seat 4: DanaEaston77 collected ($3.25)
Seat 5: Clamfish0 folded before Flop (didn't bet)
Seat 6: Galileomax (button) folded before Flop (didn't bet)


PokerStars Hand #208960116761:  Hold'em No Limit ($0.25/$0.50 USD) - 2020/02/07 20:46:14 ET
Table 'Aaltje III' 6-max Seat #1 is the button
Seat 1: Respad Gammeing ($40.74 in chips)
Seat 2: ArfanTariq ($49.50 in chips)
Seat 3: ishuha ($50 in chips)
Seat 4: DanaEaston77 ($12.73 in chips)
Seat 5: Clamfish0 ($77.04 in chips)
Seat 6: Galileomax ($50.50 in chips)
ArfanTariq: posts small blind $0.25
ishuha: posts big blind $0.50
*** HOLE CARDS ***
DanaEaston77: folds
Clamfish0: folds
Galileomax: folds
Respad Gammeing: folds
ArfanTariq: calls $0.25
ishuha: checks
*** FLOP *** [Th 6c 3s]
ArfanTariq: checks
ishuha: checks
*** TURN *** [Th 6c 3s] [Qs]
ArfanTariq: checks
ishuha: checks
*** RIVER *** [Th 6c 3s Qs] [6h]
ArfanTariq: bets $1.75
ishuha: folds
Uncalled bet ($1.75) returned to ArfanTariq
ArfanTariq collected $0.95 from pot
ArfanTariq: doesn't show hand
*** SUMMARY ***
Total pot $1 | Rake $0.05
Board [Th 6c 3s Qs 6h]
Seat 1: Respad Gammeing (button) folded before Flop (didn't bet)
Seat 2: ArfanTariq (small blind) collected ($0.95)
Seat 3: ishuha (big blind) folded on the River
Seat 4: DanaEaston77 folded before Flop (didn't bet)
Seat 5: Clamfish0 folded before Flop (didn't bet)
Seat 6: Galileomax folded before Flop (didn't bet)


PokerStars Hand #208960126037:  Hold'em No Limit ($0.25/$0.50 USD) - 2020/02/07 20:46:45 ET
Table 'Aaltje III' 6-max Seat #2 is the button
Seat 1: Respad Gammeing ($40.74 in chips)
Seat 2: ArfanTariq ($49.95 in chips)
Seat 3: ishuha ($50 in chips)
Seat 4: DanaEaston77 ($12.73 in chips)
Seat 5: Clamfish0 ($77.04 in chips)
Seat 6: Galileomax ($50.50 in chips)
ishuha: posts small blind $0.25
DanaEaston77: posts big blind $0.50
*** HOLE CARDS ***
Clamfish0: raises $0.83 to $1.33
Galileomax has timed out
Galileomax: folds
Respad Gammeing: folds
ArfanTariq: folds
ishuha: folds
DanaEaston77: calls $0.83
*** FLOP *** [6c 4c 7d]
DanaEaston77: bets $11.40 and is all-in
Clamfish0: folds
Uncalled bet ($11.40) returned to DanaEaston77
DanaEaston77 collected $2.76 from pot
DanaEaston77: doesn't show hand
*** SUMMARY ***
Total pot $2.91 | Rake $0.15
Board [6c 4c 7d]
Seat 1: Respad Gammeing folded before Flop (didn't bet)
Seat 2: ArfanTariq (button) folded before Flop (didn't bet)
Seat 3: ishuha (small blind) folded before Flop
Seat 4: DanaEaston77 (big blind) collected ($2.76)
Seat 5: Clamfish0 folded on the Flop
Seat 6: Galileomax folded before Flop (didn't bet)


PokerStars Hand #208960138522:  Hold'em No Limit ($0.25/$0.50 USD) - 2020/02/07 20:47:25 ET
Table 'Aaltje III' 6-max Seat #3 is the button
Seat 1: Respad Gammeing ($40.74 in chips)
Seat 2: ArfanTariq ($49.95 in chips)
Seat 3: ishuha ($50 in chips)
Seat 4: DanaEaston77 ($14.16 in chips)
Seat 5: Clamfish0 ($75.71 in chips)
Seat 6: Galileomax ($50.50 in chips)
DanaEaston77: posts small blind $0.25
Clamfish0: posts big blind $0.50
*** HOLE CARDS ***
Galileomax: folds
Respad Gammeing: calls $0.50
ArfanTariq: folds
ishuha: folds
DanaEaston77: folds
Clamfish0: checks
*** FLOP *** [5s Kc 3c]
Clamfish0: checks
Respad Gammeing: checks
*** TURN *** [5s Kc 3c] [4s]
Clamfish0: bets $2.50
Respad Gammeing: calls $2.50
*** RIVER *** [5s Kc 3c 4s] [Ks]
Clamfish0: bets $2.49
Respad Gammeing: raises $7.41 to $9.90
Clamfish0: folds
Uncalled bet ($7.41) returned to Respad Gammeing
Respad Gammeing collected $10.67 from pot
Respad Gammeing: doesn't show hand
*** SUMMARY ***
Total pot $11.23 | Rake $0.56
Board [5s Kc 3c 4s Ks]
Seat 1: Respad Gammeing collected ($10.67)
Seat 2: ArfanTariq folded before Flop (didn't bet)
Seat 3: ishuha (button) folded before Flop (didn't bet)
Seat 4: DanaEaston77 (small blind) folded before Flop
Seat 5: Clamfish0 (big blind) folded on the River
Seat 6: Galileomax folded before Flop (didn't bet)


PokerStars Hand #208960175342:  Hold'em No Limit ($0.25/$0.50 USD) - 2020/02/07 20:49:01 ET
Table 'Aaltje III' 6-max Seat #4 is the button
Seat 1: Respad Gammeing ($45.92 in chips)
Seat 2: ArfanTariq ($49.95 in chips)
Seat 3: ishuha ($50 in chips)
Seat 4: DanaEaston77 ($13.91 in chips)
Seat 5: Clamfish0 ($70.22 in chips)
Seat 6: Galileomax ($50.50 in chips)
Clamfish0: posts small blind $0.25
Galileomax: posts big blind $0.50
*** HOLE CARDS ***
Respad Gammeing: raises $0.50 to $1
ArfanTariq: calls $1
ishuha: folds
DanaEaston77: raises $12.91 to $13.91 and is all-in
Clamfish0: folds
Galileomax: folds
Respad Gammeing: folds
ArfanTariq: folds
Uncalled bet ($12.91) returned to DanaEaston77
DanaEaston77 collected $3.75 from pot
DanaEaston77: doesn't show hand
*** SUMMARY ***
Total pot $3.75 | Rake $0
Seat 1: Respad Gammeing folded before Flop
Seat 2: ArfanTariq folded before Flop
Seat 3: ishuha folded before Flop (didn't bet)
Seat 4: DanaEaston77 (button) collected ($3.75)
Seat 5: Clamfish0 (small blind) folded before Flop
Seat 6: Galileomax (big blind) folded before Flop


PokerStars Hand #208960183561:  Hold'em No Limit ($0.25/$0.50 USD) - 2020/02/07 20:49:28 ET
Table 'Aaltje III' 6-max Seat #5 is the button
Seat 1: Respad Gammeing ($44.92 in chips)
Seat 2: ArfanTariq ($48.95 in chips)
Seat 3: ishuha ($50 in chips)
Seat 4: DanaEaston77 ($16.66 in chips)
Seat 5: Clamfish0 ($69.97 in chips)
Seat 6: Galileomax ($50 in chips)
Galileomax: posts small blind $0.25
Respad Gammeing: posts big blind $0.50
*** HOLE CARDS ***
ArfanTariq: calls $0.50
ishuha: raises $2 to $2.50
DanaEaston77: folds
Clamfish0: folds
Galileomax: folds
Respad Gammeing: folds
ArfanTariq: folds
Uncalled bet ($2) returned to ishuha
ishuha collected $1.75 from pot
ishuha: doesn't show hand
*** SUMMARY ***
Total pot $1.75 | Rake $0
Seat 1: Respad Gammeing (big blind) folded before Flop
Seat 2: ArfanTariq folded before Flop
Seat 3: ishuha collected ($1.75)
Seat 4: DanaEaston77 folded before Flop (didn't bet)
Seat 5: Clamfish0 (button) folded before Flop (didn't bet)
Seat 6: Galileomax (small blind) folded before Flop


PokerStars Hand #208960192143:  Hold'em No Limit ($0.25/$0.50 USD) - 2020/02/07 20:49:56 ET
Table 'Aaltje III' 6-max Seat #6 is the button
Seat 1: Respad Gammeing ($44.42 in chips)
Seat 2: ArfanTariq ($48.45 in chips)
Seat 3: ishuha ($51.25 in chips)
Seat 4: DanaEaston77 ($16.66 in chips)
Seat 5: Clamfish0 ($69.97 in chips)
Seat 6: Galileomax ($49.75 in chips)
Respad Gammeing: posts small blind $0.25
ArfanTariq: posts big blind $0.50
*** HOLE CARDS ***
ishuha: folds
DanaEaston77: folds
Clamfish0: folds
Galileomax: folds
Respad Gammeing: folds
Uncalled bet ($0.25) returned to ArfanTariq
ArfanTariq collected $0.50 from pot
ArfanTariq: doesn't show hand
*** SUMMARY ***
Total pot $0.50 | Rake $0
Seat 1: Respad Gammeing (small blind) folded before Flop
Seat 2: ArfanTariq (big blind) collected ($0.50)
Seat 3: ishuha folded before Flop (didn't bet)
Seat 4: DanaEaston77 folded before Flop (didn't bet)
Seat 5: Clamfish0 folded before Flop (didn't bet)
Seat 6: Galileomax (button) folded before Flop (didn't bet)


PokerStars Hand #208960202386:  Hold'em No Limit ($0.25/$0.50 USD) - 2020/02/07 20:50:30 ET
Table 'Aaltje III' 6-max Seat #1 is the button
Seat 1: Respad Gammeing ($44.17 in chips)
Seat 2: ArfanTariq ($48.70 in chips)
Seat 3: ishuha ($51.25 in chips)
Seat 4: DanaEaston77 ($16.66 in chips)
Seat 5: Clamfish0 ($69.97 in chips)
Seat 6: Galileomax ($49.75 in chips)
ArfanTariq: posts small blind $0.25
ishuha: posts big blind $0.50
*** HOLE CARDS ***
DanaEaston77: folds
Clamfish0: folds
Galileomax: raises $0.75 to $1.25
Respad Gammeing: calls $1.25
ArfanTariq: calls $1
ishuha: folds
*** FLOP *** [Qc 7d 5h]
ArfanTariq: checks
Galileomax: bets $1.33
Respad Gammeing: calls $1.33
ArfanTariq: calls $1.33
*** TURN *** [Qc 7d 5h] [5d]
ArfanTariq: checks
Galileomax: checks
Respad Gammeing: checks
*** RIVER *** [Qc 7d 5h 5d] [6c]
ArfanTariq: checks
Galileomax: bets $5.50
Respad Gammeing: folds
ArfanTariq: folds
Uncalled bet ($5.50) returned to Galileomax
Galileomax collected $7.83 from pot
Galileomax: doesn't show hand
*** SUMMARY ***
Total pot $8.24 | Rake $0.41
Board [Qc 7d 5h 5d 6c]
Seat 1: Respad Gammeing (button) folded on the River
Seat 2: ArfanTariq (small blind) folded on the River
Seat 3: ishuha (big blind) folded before Flop
Seat 4: DanaEaston77 folded before Flop (didn't bet)
Seat 5: Clamfish0 folded before Flop (didn't bet)
Seat 6: Galileomax collected ($7.83)


PokerStars Hand #208960249075:  Hold'em No Limit ($0.25/$0.50 USD) - 2020/02/07 20:53:04 ET
Table 'Aaltje III' 6-max Seat #2 is the button
Seat 1: Respad Gammeing ($41.59 in chips)
Seat 2: ArfanTariq ($46.12 in chips)
Seat 3: ishuha ($50.75 in chips)
Seat 4: DanaEaston77 ($16.66 in chips)
Seat 5: Clamfish0 ($69.97 in chips)
Seat 6: Galileomax ($55 in chips)
ishuha: posts small blind $0.25
DanaEaston77: posts big blind $0.50
*** HOLE CARDS ***
Clamfish0: raises $0.83 to $1.33
Galileomax: folds
Respad Gammeing: folds
ArfanTariq: calls $1.33
ishuha: folds
DanaEaston77: calls $0.83
*** FLOP *** [5d Qh 6h]
DanaEaston77: bets $15.33 and is all-in
Clamfish0: calls $15.33
ArfanTariq: folds
*** TURN *** [5d Qh 6h] [7s]
*** RIVER *** [5d Qh 6h 7s] [2c]
*** SHOW DOWN ***
DanaEaston77: shows [4c 3c] (a straight, Three to Seven)
Clamfish0: shows [Ah Qc] (a pair of Queens)
DanaEaston77 collected $33.16 from pot
*** SUMMARY ***
Total pot $34.90 | Rake $1.74
Board [5d Qh 6h 7s 2c]
Seat 1: Respad Gammeing folded before Flop (didn't bet)
Seat 2: ArfanTariq (button) folded on the Flop
Seat 3: ishuha (small blind) folded before Flop
Seat 4: DanaEaston77 (big blind) showed [4c 3c] and won ($33.16) with a straight, Three to Seven
Seat 5: Clamfish0 showed [Ah Qc] and lost with a pair of Queens
Seat 6: Galileomax folded before Flop (didn't bet)


PokerStars Hand #208960270205:  Hold'em No Limit ($0.25/$0.50 USD) - 2020/02/07 20:54:14 ET
Table 'Aaltje III' 6-max Seat #3 is the button
Seat 1: Respad Gammeing ($41.59 in chips)
Seat 2: ArfanTariq ($44.79 in chips)
Seat 3: ishuha ($50.50 in chips)
Seat 4: DanaEaston77 ($33.16 in chips)
Seat 5: Clamfish0 ($53.31 in chips)
Seat 6: Galileomax ($55 in chips)
DanaEaston77: posts small blind $0.25
Clamfish0: posts big blind $0.50
*** HOLE CARDS ***
Galileomax: folds
Respad Gammeing: calls $0.50
ArfanTariq: calls $0.50
ishuha: folds
DanaEaston77: calls $0.25
Clamfish0: checks
*** FLOP *** [Tc 7s 8d]
DanaEaston77: checks
Clamfish0: checks
Respad Gammeing: checks
ArfanTariq: checks
*** TURN *** [Tc 7s 8d] [7h]
DanaEaston77: checks
Clamfish0: bets $2.58
Respad Gammeing: calls $2.58
ArfanTariq: calls $2.58
DanaEaston77: folds
*** RIVER *** [Tc 7s 8d 7h] [5s]
Clamfish0: checks
Respad Gammeing: checks
ArfanTariq: checks
*** SHOW DOWN ***
Clamfish0: shows [6d 9s] (a straight, Six to Ten)
Respad Gammeing: mucks hand
ArfanTariq: mucks hand
Clamfish0 collected $9.25 from pot
*** SUMMARY ***
Total pot $9.74 | Rake $0.49
Board [Tc 7s 8d 7h 5s]
Seat 1: Respad Gammeing mucked
Seat 2: ArfanTariq mucked
Seat 3: ishuha (button) folded before Flop (didn't bet)
Seat 4: DanaEaston77 (small blind) folded on the Turn
Seat 5: Clamfish0 (big blind) showed [6d 9s] and won ($9.25) with a straight, Six to Ten
Seat 6: Galileomax folded before Flop (didn't bet)


PokerStars Hand #208960332473:  Hold'em No Limit ($0.25/$0.50 USD) - 2020/02/07 20:57:35 ET
Table 'Aaltje III' 6-max Seat #5 is the button
Seat 1: Respad Gammeing ($38.51 in chips)
Seat 2: ArfanTariq ($41.21 in chips)
Seat 3: ishuha ($50.50 in chips)
Seat 4: DanaEaston77 ($32.66 in chips)
Seat 5: Clamfish0 ($59.23 in chips)
Seat 6: Galileomax ($55.69 in chips)
Galileomax: posts small blind $0.25
Respad Gammeing: posts big blind $0.50
*** HOLE CARDS ***
ArfanTariq: raises $4.68 to $5.18
ishuha: folds
DanaEaston77: raises $27.48 to $32.66 and is all-in
Clamfish0: folds
Galileomax: folds
Respad Gammeing: folds
ArfanTariq: folds
Uncalled bet ($27.48) returned to DanaEaston77
DanaEaston77 collected $11.11 from pot
DanaEaston77: doesn't show hand
*** SUMMARY ***
Total pot $11.11 | Rake $0
Seat 1: Respad Gammeing (big blind) folded before Flop
Seat 2: ArfanTariq folded before Flop
Seat 3: ishuha folded before Flop (didn't bet)
Seat 4: DanaEaston77 collected ($11.11)
Seat 5: Clamfish0 (button) folded before Flop (didn't bet)
Seat 6: Galileomax (small blind) folded before Flop


PokerStars Hand #208960305916:  Hold'em No Limit ($0.25/$0.50 USD) - 2020/02/07 20:56:22 ET
Table 'Aaltje III' 6-max Seat #4 is the button
Seat 1: Respad Gammeing ($38.51 in chips)
Seat 2: ArfanTariq ($41.71 in chips)
Seat 3: ishuha ($50.50 in chips)
Seat 4: DanaEaston77 ($32.66 in chips)
Seat 5: Clamfish0 ($59.48 in chips)
Seat 6: Galileomax ($55 in chips)
Clamfish0: posts small blind $0.25
Galileomax: posts big blind $0.50
*** HOLE CARDS ***
Respad Gammeing: folds
ArfanTariq: calls $0.50
ishuha: folds
DanaEaston77: folds
Clamfish0: folds
Galileomax: checks
*** FLOP *** [Kh 2s Jd]
Galileomax: checks
ArfanTariq: checks
*** TURN *** [Kh 2s Jd] [Qd]
Galileomax: checks
ArfanTariq: checks
*** RIVER *** [Kh 2s Jd Qd] [7s]
Galileomax: checks
ArfanTariq: checks
*** SHOW DOWN ***
Galileomax: shows [Qh Ts] (a pair of Queens)
ArfanTariq: mucks hand
Galileomax collected $1.19 from pot
*** SUMMARY ***
Total pot $1.25 | Rake $0.06
Board [Kh 2s Jd Qd 7s]
Seat 1: Respad Gammeing folded before Flop (didn't bet)
Seat 2: ArfanTariq mucked
Seat 3: ishuha folded before Flop (didn't bet)
Seat 4: DanaEaston77 (button) folded before Flop (didn't bet)
Seat 5: Clamfish0 (small blind) folded before Flop
Seat 6: Galileomax (big blind) showed [Qh Ts] and won ($1.19) with a pair of Queens


PokerStars Hand #208960339980:  Hold'em No Limit ($0.25/$0.50 USD) - 2020/02/07 20:58:04 ET
Table 'Aaltje III' 6-max Seat #6 is the button
Seat 1: Respad Gammeing ($38.01 in chips)
Seat 2: ArfanTariq ($36.03 in chips)
Seat 3: ishuha ($50.50 in chips)
Seat 4: DanaEaston77 ($38.59 in chips)
Seat 5: Clamfish0 ($59.23 in chips)
Seat 6: Galileomax ($55.44 in chips)
Respad Gammeing: posts small blind $0.25
ArfanTariq: posts big blind $0.50
*** HOLE CARDS ***
ishuha: folds
DanaEaston77: folds
Clamfish0: folds
Galileomax: folds
Respad Gammeing: calls $0.25
ArfanTariq: checks
*** FLOP *** [Tc 9s Kh]
Respad Gammeing: checks
ArfanTariq: checks
*** TURN *** [Tc 9s Kh] [9d]
Respad Gammeing: checks
ArfanTariq: checks
*** RIVER *** [Tc 9s Kh 9d] [2h]
Respad Gammeing: checks
ArfanTariq: checks
*** SHOW DOWN ***
Respad Gammeing: shows [4h 5c] (a pair of Nines)
ArfanTariq: shows [2s 8c] (two pair, Nines and Deuces)
ArfanTariq collected $0.95 from pot
*** SUMMARY ***
Total pot $1 | Rake $0.05
Board [Tc 9s Kh 9d 2h]
Seat 1: Respad Gammeing (small blind) showed [4h 5c] and lost with a pair of Nines
Seat 2: ArfanTariq (big blind) showed [2s 8c] and won ($0.95) with two pair, Nines and Deuces
Seat 3: ishuha folded before Flop (didn't bet)
Seat 4: DanaEaston77 folded before Flop (didn't bet)
Seat 5: Clamfish0 folded before Flop (didn't bet)
Seat 6: Galileomax (button) folded before Flop (didn't bet)


PokerStars Hand #208960360645:  Hold'em No Limit ($0.25/$0.50 USD) - 2020/02/07 20:59:24 ET
Table 'Aaltje III' 6-max Seat #2 is the button
Seat 1: Respad Gammeing ($35.01 in chips)
Seat 2: ArfanTariq ($33.98 in chips)
Seat 3: ishuha ($50 in chips)
Seat 4: DanaEaston77 ($44.09 in chips)
Seat 5: Clamfish0 ($59.23 in chips)
Seat 6: Galileomax ($55.44 in chips)
ishuha: posts small blind $0.25
DanaEaston77: posts big blind $0.50
*** HOLE CARDS ***
Clamfish0: folds
Galileomax: folds
Respad Gammeing: raises $2.60 to $3.10
ArfanTariq: calls $3.10
ishuha: folds
DanaEaston77: folds
*** FLOP *** [3d Kc Qh]
Respad Gammeing: checks
ArfanTariq: checks
*** TURN *** [3d Kc Qh] [3h]
Respad Gammeing: bets $3.53
ArfanTariq: calls $3.53
*** RIVER *** [3d Kc Qh 3h] [Qs]
Respad Gammeing: checks
ArfanTariq: checks
*** SHOW DOWN ***
Respad Gammeing: shows [7c 7d] (two pair, Queens and Sevens)
ArfanTariq: mucks hand
Respad Gammeing collected $13.31 from pot
*** SUMMARY ***
Total pot $14.01 | Rake $0.70
Board [3d Kc Qh 3h Qs]
Seat 1: Respad Gammeing showed [7c 7d] and won ($13.31) with two pair, Queens and Sevens
Seat 2: ArfanTariq (button) mucked
Seat 3: ishuha (small blind) folded before Flop
Seat 4: DanaEaston77 (big blind) folded before Flop
Seat 5: Clamfish0 folded before Flop (didn't bet)
Seat 6: Galileomax folded before Flop (didn't bet)


PokerStars Hand #208960349513:  Hold'em No Limit ($0.25/$0.50 USD) - 2020/02/07 20:58:40 ET
Table 'Aaltje III' 6-max Seat #1 is the button
Seat 1: Respad Gammeing ($37.51 in chips)
Seat 2: ArfanTariq ($36.48 in chips)
Seat 3: ishuha ($50.50 in chips)
Seat 4: DanaEaston77 ($38.59 in chips)
Seat 5: Clamfish0 ($59.23 in chips)
Seat 6: Galileomax ($55.44 in chips)
ArfanTariq: posts small blind $0.25
ishuha: posts big blind $0.50
*** HOLE CARDS ***
DanaEaston77: raises $1 to $1.50
Clamfish0: folds
Galileomax: folds
Respad Gammeing: raises $1 to $2.50
ArfanTariq: calls $2.25
ishuha: folds
DanaEaston77: raises $36.09 to $38.59 and is all-in
Respad Gammeing: folds
ArfanTariq: folds
Uncalled bet ($36.09) returned to DanaEaston77
DanaEaston77 collected $8 from pot
DanaEaston77: doesn't show hand
*** SUMMARY ***
Total pot $8 | Rake $0
Seat 1: Respad Gammeing (button) folded before Flop
Seat 2: ArfanTariq (small blind) folded before Flop
Seat 3: ishuha (big blind) folded before Flop
Seat 4: DanaEaston77 collected ($8)
Seat 5: Clamfish0 folded before Flop (didn't bet)
Seat 6: Galileomax folded before Flop (didn't bet)


PokerStars Hand #208960371412:  Hold'em No Limit ($0.25/$0.50 USD) - 2020/02/07 21:00:05 ET
Table 'Aaltje III' 6-max Seat #3 is the button
Seat 1: Respad Gammeing ($41.69 in chips)
Seat 2: ArfanTariq ($27.35 in chips)
Seat 3: ishuha ($50 in chips)
Seat 4: DanaEaston77 ($43.59 in chips)
Seat 5: Clamfish0 ($59.23 in chips)
Seat 6: Galileomax ($55.44 in chips)
DanaEaston77: posts small blind $0.25
Clamfish0: posts big blind $0.50
*** HOLE CARDS ***
Galileomax: folds
Respad Gammeing: calls $0.50
ArfanTariq: raises $2.45 to $2.95
ishuha: folds
DanaEaston77: folds
Clamfish0: raises $56.28 to $59.23 and is all-in
Respad Gammeing: folds
ArfanTariq: calls $24.40 and is all-in
Uncalled bet ($31.88) returned to Clamfish0
*** FLOP *** [5h 8d Tc]
*** TURN *** [5h 8d Tc] [Qd]
*** RIVER *** [5h 8d Tc Qd] [3h]
*** SHOW DOWN ***
Clamfish0: shows [Ad Kd] (high card Ace)
ArfanTariq: shows [Ah As] (a pair of Aces)
ArfanTariq collected $53.45 from pot
*** SUMMARY ***
Total pot $55.45 | Rake $2
Board [5h 8d Tc Qd 3h]
Seat 1: Respad Gammeing folded before Flop
Seat 2: ArfanTariq showed [Ah As] and won ($53.45) with a pair of Aces
Seat 3: ishuha (button) folded before Flop (didn't bet)
Seat 4: DanaEaston77 (small blind) folded before Flop
Seat 5: Clamfish0 (big blind) showed [Ad Kd] and lost with high card Ace
Seat 6: Galileomax folded before Flop (didn't bet)


PokerStars Hand #208960390123:  Hold'em No Limit ($0.25/$0.50 USD) - 2020/02/07 21:01:14 ET
Table 'Aaltje III' 6-max Seat #4 is the button
Seat 1: Respad Gammeing ($41.19 in chips)
Seat 2: ArfanTariq ($53.45 in chips)
Seat 3: ishuha ($50 in chips)
Seat 4: DanaEaston77 ($43.34 in chips)
Seat 5: Clamfish0 ($50 in chips)
Seat 6: Galileomax ($55.44 in chips)
Clamfish0: posts small blind $0.25
Galileomax: posts big blind $0.50
*** HOLE CARDS ***
Respad Gammeing: raises $0.50 to $1
ArfanTariq: raises $0.50 to $1.50
ishuha: folds
DanaEaston77: folds
Clamfish0: calls $1.25
Galileomax: folds
Respad Gammeing: calls $0.50
*** FLOP *** [9d Qd 8d]
Clamfish0: checks
Respad Gammeing: checks
ArfanTariq: bets $5.69
Clamfish0: raises $6.77 to $12.46
Respad Gammeing: folds
ArfanTariq: raises $6.77 to $19.23
Clamfish0: raises $29.27 to $48.50 and is all-in
ArfanTariq: calls $29.27
*** TURN *** [9d Qd 8d] [Qc]
*** RIVER *** [9d Qd 8d Qc] [3h]
*** SHOW DOWN ***
Clamfish0: shows [8h 8s] (a full house, Eights full of Queens)
ArfanTariq: shows [Qs 9c] (a full house, Queens full of Nines)
ArfanTariq collected $100 from pot
*** SUMMARY ***
Total pot $102 | Rake $2
Board [9d Qd 8d Qc 3h]
Seat 1: Respad Gammeing folded on the Flop
Seat 2: ArfanTariq showed [Qs 9c] and won ($100) with a full house, Queens full of Nines
Seat 3: ishuha folded before Flop (didn't bet)
Seat 4: DanaEaston77 (button) folded before Flop (didn't bet)
Seat 5: Clamfish0 (small blind) showed [8h 8s] and lost with a full house, Eights full of Queens
Seat 6: Galileomax (big blind) folded before Flop


PokerStars Hand #208960420969:  Hold'em No Limit ($0.25/$0.50 USD) - 2020/02/07 21:02:58 ET
Table 'Aaltje III' 6-max Seat #5 is the button
Seat 1: Respad Gammeing ($39.69 in chips)
Seat 2: ArfanTariq ($103.45 in chips)
Seat 3: ishuha ($50 in chips)
Seat 4: DanaEaston77 ($43.34 in chips)
Seat 5: Clamfish0 ($50 in chips)
Seat 6: Galileomax ($54.94 in chips)
Galileomax: posts small blind $0.25
Respad Gammeing: posts big blind $0.50
*** HOLE CARDS ***
ArfanTariq: calls $0.50
ishuha: folds
DanaEaston77: calls $0.50
Clamfish0: raises $1.58 to $2.08
Galileomax: folds
Respad Gammeing: raises $1.58 to $3.66
ArfanTariq: calls $3.16
DanaEaston77: folds
Clamfish0: calls $1.58
*** FLOP *** [4h 5c 8d]
Respad Gammeing: checks
ArfanTariq: checks
Clamfish0: checks
*** TURN *** [4h 5c 8d] [2h]
Respad Gammeing: checks
ArfanTariq: checks
Clamfish0: checks
*** RIVER *** [4h 5c 8d 2h] [Qs]
Respad Gammeing: checks
ArfanTariq: checks
Clamfish0: checks
*** SHOW DOWN ***
Respad Gammeing: shows [Js As] (high card Ace)
ArfanTariq: shows [8c 3c] (a pair of Eights)
Clamfish0: mucks hand
ArfanTariq collected $11.14 from pot
*** SUMMARY ***
Total pot $11.73 | Rake $0.59
Board [4h 5c 8d 2h Qs]
Seat 1: Respad Gammeing (big blind) showed [Js As] and lost with high card Ace
Seat 2: ArfanTariq showed [8c 3c] and won ($11.14) with a pair of Eights
Seat 3: ishuha folded before Flop (didn't bet)
Seat 4: DanaEaston77 folded before Flop
Seat 5: Clamfish0 (button) mucked
Seat 6: Galileomax (small blind) folded before Flop


PokerStars Hand #208960440713:  Hold'em No Limit ($0.25/$0.50 USD) - 2020/02/07 21:04:05 ET
Table 'Aaltje III' 6-max Seat #6 is the button
Seat 1: Respad Gammeing ($36.03 in chips)
Seat 2: ArfanTariq ($110.93 in chips)
Seat 3: ishuha ($50 in chips)
Seat 4: DanaEaston77 ($42.84 in chips)
Seat 5: Clamfish0 ($50 in chips)
Seat 6: Galileomax ($54.69 in chips)
Respad Gammeing: posts small blind $0.25
ArfanTariq: posts big blind $0.50
*** HOLE CARDS ***
ishuha: raises $0.75 to $1.25
DanaEaston77: folds
Clamfish0: folds
Galileomax: folds
Respad Gammeing: folds
ArfanTariq: folds
Uncalled bet ($0.75) returned to ishuha
ishuha collected $1.25 from pot
ishuha: doesn't show hand
*** SUMMARY ***
Total pot $1.25 | Rake $0
Seat 1: Respad Gammeing (small blind) folded before Flop
Seat 2: ArfanTariq (big blind) folded before Flop
Seat 3: ishuha collected ($1.25)
Seat 4: DanaEaston77 folded before Flop (didn't bet)
Seat 5: Clamfish0 folded before Flop (didn't bet)
Seat 6: Galileomax (button) folded before Flop (didn't bet)


PokerStars Hand #208960447804:  Hold'em No Limit ($0.25/$0.50 USD) - 2020/02/07 21:04:29 ET
Table 'Aaltje III' 6-max Seat #1 is the button
Seat 1: Respad Gammeing ($35.78 in chips)
Seat 2: ArfanTariq ($110.43 in chips)
Seat 3: ishuha ($50.75 in chips)
Seat 4: DanaEaston77 ($42.84 in chips)
Seat 5: Clamfish0 ($50 in chips)
Seat 6: Galileomax ($54.69 in chips)
ArfanTariq: posts small blind $0.25
ishuha: posts big blind $0.50
*** HOLE CARDS ***
DanaEaston77: raises $1 to $1.50
Clamfish0: folds
Galileomax: calls $1.50
Respad Gammeing: calls $1.50
ArfanTariq: calls $1.25
ishuha: folds
*** FLOP *** [2c 9d 4s]
ArfanTariq: checks
DanaEaston77: checks
Galileomax: checks
Respad Gammeing: checks
*** TURN *** [2c 9d 4s] [6c]
ArfanTariq: checks
DanaEaston77: bets $1.50
Galileomax: folds
Respad Gammeing: calls $1.50
ArfanTariq: calls $1.50
*** RIVER *** [2c 9d 4s 6c] [8c]
ArfanTariq: checks
DanaEaston77: checks
Respad Gammeing: checks
*** SHOW DOWN ***
ArfanTariq: shows [5d 5c] (a pair of Fives)
DanaEaston77: shows [Ad 6h] (a pair of Sixes)
Respad Gammeing: mucks hand
DanaEaston77 collected $10.45 from pot
*** SUMMARY ***
Total pot $11 | Rake $0.55
Board [2c 9d 4s 6c 8c]
Seat 1: Respad Gammeing (button) mucked
Seat 2: ArfanTariq (small blind) showed [5d 5c] and lost with a pair of Fives
Seat 3: ishuha (big blind) folded before Flop
Seat 4: DanaEaston77 showed [Ad 6h] and won ($10.45) with a pair of Sixes
Seat 5: Clamfish0 folded before Flop (didn't bet)
Seat 6: Galileomax folded on the Turn


PokerStars Hand #208960479487:  Hold'em No Limit ($0.25/$0.50 USD) - 2020/02/07 21:06:11 ET
Table 'Aaltje III' 6-max Seat #2 is the button
Seat 1: Respad Gammeing ($32.78 in chips)
Seat 2: ArfanTariq ($107.43 in chips)
Seat 3: ishuha ($50.25 in chips)
Seat 4: DanaEaston77 ($50.29 in chips)
Seat 5: Clamfish0 ($50 in chips)
Seat 6: Galileomax ($53.19 in chips)
ishuha: posts small blind $0.25
DanaEaston77: posts big blind $0.50
*** HOLE CARDS ***
Clamfish0: folds
Galileomax has timed out
Galileomax: folds
Respad Gammeing: raises $2.76 to $3.26
ArfanTariq: calls $3.26
ishuha: folds
DanaEaston77: calls $2.76
*** FLOP *** [8s 8c 7h]
DanaEaston77: checks
Respad Gammeing: bets $3.76
ArfanTariq: calls $3.76
DanaEaston77: folds
*** TURN *** [8s 8c 7h] [Qs]
Respad Gammeing: checks
ArfanTariq: checks
*** RIVER *** [8s 8c 7h Qs] [3s]
Respad Gammeing: bets $6.05
ArfanTariq: folds
Uncalled bet ($6.05) returned to Respad Gammeing
Respad Gammeing collected $16.67 from pot
Respad Gammeing: doesn't show hand
*** SUMMARY ***
Total pot $17.55 | Rake $0.88
Board [8s 8c 7h Qs 3s]
Seat 1: Respad Gammeing collected ($16.67)
Seat 2: ArfanTariq (button) folded on the River
Seat 3: ishuha (small blind) folded before Flop
Seat 4: DanaEaston77 (big blind) folded on the Flop
Seat 5: Clamfish0 folded before Flop (didn't bet)
Seat 6: Galileomax folded before Flop (didn't bet)


PokerStars Hand #208960507929:  Hold'em No Limit ($0.25/$0.50 USD) - 2020/02/07 21:07:17 ET
Table 'Aaltje III' 6-max Seat #3 is the button
Seat 1: Respad Gammeing ($42.43 in chips)
Seat 2: ArfanTariq ($100.41 in chips)
Seat 3: ishuha ($50 in chips)
Seat 4: DanaEaston77 ($47.03 in chips)
Seat 5: Clamfish0 ($50 in chips)
Seat 6: Galileomax ($53.19 in chips)
DanaEaston77: posts small blind $0.25
Clamfish0: posts big blind $0.50
*** HOLE CARDS ***
Galileomax: folds
Respad Gammeing: raises $3.06 to $3.56
ArfanTariq: calls $3.56
ishuha: calls $3.56
DanaEaston77: folds
Clamfish0: folds
*** FLOP *** [7c 3c 5h]
Respad Gammeing: bets $3.48
ArfanTariq: calls $3.48
ishuha: calls $3.48
*** TURN *** [7c 3c 5h] [6h]
Respad Gammeing: bets $3.32
ArfanTariq: calls $3.32
ishuha: calls $3.32
*** RIVER *** [7c 3c 5h 6h] [As]
Respad Gammeing: bets $8.44
ArfanTariq: folds
ishuha: calls $8.44
*** SHOW DOWN ***
Respad Gammeing: shows [4c 4d] (a straight, Three to Seven)
ishuha: mucks hand
Respad Gammeing collected $46.71 from pot
*** SUMMARY ***
Total pot $48.71 | Rake $2
Board [7c 3c 5h 6h As]
Seat 1: Respad Gammeing showed [4c 4d] and won ($46.71) with a straight, Three to Seven
Seat 2: ArfanTariq folded on the River
Seat 3: ishuha (button) mucked
Seat 4: DanaEaston77 (small blind) folded before Flop
Seat 5: Clamfish0 (big blind) folded before Flop
Seat 6: Galileomax folded before Flop (didn't bet)


PokerStars Hand #208960526741:  Hold'em No Limit ($0.25/$0.50 USD) - 2020/02/07 21:08:21 ET
Table 'Aaltje III' 6-max Seat #4 is the button
Seat 1: Respad Gammeing ($70.34 in chips)
Seat 2: ArfanTariq ($90.05 in chips)
Seat 3: ishuha ($50 in chips)
Seat 4: DanaEaston77 ($46.78 in chips)
Seat 5: Clamfish0 ($50 in chips)
Seat 6: Galileomax ($53.19 in chips)
Clamfish0: posts small blind $0.25
Galileomax: posts big blind $0.50
*** HOLE CARDS ***
Respad Gammeing: raises $0.50 to $1
ArfanTariq: calls $1
ishuha: folds
DanaEaston77: folds
Clamfish0: folds
Galileomax: calls $0.50
*** FLOP *** [7h 3d 6d]
Galileomax: checks
Respad Gammeing: checks
ArfanTariq: bets $5.71
Galileomax: folds
Respad Gammeing: folds
Uncalled bet ($5.71) returned to ArfanTariq
ArfanTariq collected $3.09 from pot
ArfanTariq: doesn't show hand
*** SUMMARY ***
Total pot $3.25 | Rake $0.16
Board [7h 3d 6d]
Seat 1: Respad Gammeing folded on the Flop
Seat 2: ArfanTariq collected ($3.09)
Seat 3: ishuha folded before Flop (didn't bet)
Seat 4: DanaEaston77 (button) folded before Flop (didn't bet)
Seat 5: Clamfish0 (small blind) folded before Flop
Seat 6: Galileomax (big blind) folded on the Flop


PokerStars Hand #208960560342:  Hold'em No Limit ($0.25/$0.50 USD) - 2020/02/07 21:10:16 ET
Table 'Aaltje III' 6-max Seat #6 is the button
Seat 1: Respad Gammeing ($90.28 in chips)
Seat 2: ArfanTariq ($75.65 in chips)
Seat 3: ishuha ($50 in chips)
Seat 4: DanaEaston77 ($46.78 in chips)
Seat 5: Clamfish0 ($50 in chips)
Seat 6: Galileomax ($51.94 in chips)
Respad Gammeing: posts small blind $0.25
ArfanTariq: posts big blind $0.50
*** HOLE CARDS ***
ishuha: folds
DanaEaston77: folds
Clamfish0: folds
Galileomax: raises $0.50 to $1
Respad Gammeing: calls $0.75
ArfanTariq: calls $0.50
*** FLOP *** [4h 8s Ad]
Respad Gammeing: checks
ArfanTariq: checks
Galileomax: checks
*** TURN *** [4h 8s Ad] [7h]
Respad Gammeing: checks
ArfanTariq: checks
Galileomax: checks
*** RIVER *** [4h 8s Ad 7h] [2s]
Respad Gammeing: bets $4.58
ArfanTariq: folds
Galileomax: folds
Uncalled bet ($4.58) returned to Respad Gammeing
Respad Gammeing collected $2.85 from pot
Respad Gammeing: doesn't show hand
*** SUMMARY ***
Total pot $3 | Rake $0.15
Board [4h 8s Ad 7h 2s]
Seat 1: Respad Gammeing (small blind) collected ($2.85)
Seat 2: ArfanTariq (big blind) folded on the River
Seat 3: ishuha folded before Flop (didn't bet)
Seat 4: DanaEaston77 folded before Flop (didn't bet)
Seat 5: Clamfish0 folded before Flop (didn't bet)
Seat 6: Galileomax (button) folded on the River


PokerStars Hand #208960538738:  Hold'em No Limit ($0.25/$0.50 USD) - 2020/02/07 21:09:02 ET
Table 'Aaltje III' 6-max Seat #5 is the button
Seat 1: Respad Gammeing ($69.34 in chips)
Seat 2: ArfanTariq ($92.14 in chips)
Seat 3: ishuha ($50 in chips)
Seat 4: DanaEaston77 ($46.78 in chips)
Seat 5: Clamfish0 ($50 in chips)
Seat 6: Galileomax ($52.19 in chips)
Galileomax: posts small blind $0.25
Respad Gammeing: posts big blind $0.50
*** HOLE CARDS ***
ArfanTariq: raises $0.50 to $1
ishuha: folds
DanaEaston77: folds
Clamfish0: raises $1.57 to $2.57
Galileomax: folds
Respad Gammeing: calls $2.07
ArfanTariq: calls $1.57
*** FLOP *** [9h 7h Kh]
Respad Gammeing: checks
ArfanTariq: checks
Clamfish0: checks
*** TURN *** [9h 7h Kh] [9c]
Respad Gammeing: checks
ArfanTariq: bets $3.60
Clamfish0: calls $3.60
Respad Gammeing: calls $3.60
*** RIVER *** [9h 7h Kh 9c] [3s]
Respad Gammeing: bets $5.16
ArfanTariq: raises $5.16 to $10.32
Clamfish0: folds
Respad Gammeing: calls $5.16
*** SHOW DOWN ***
ArfanTariq: shows [7s 4d] (two pair, Nines and Sevens)
Respad Gammeing: shows [Ah Kd] (two pair, Kings and Nines)
Respad Gammeing collected $37.43 from pot
*** SUMMARY ***
Total pot $39.40 | Rake $1.97
Board [9h 7h Kh 9c 3s]
Seat 1: Respad Gammeing (big blind) showed [Ah Kd] and won ($37.43) with two pair, Kings and Nines
Seat 2: ArfanTariq showed [7s 4d] and lost with two pair, Nines and Sevens
Seat 3: ishuha folded before Flop (didn't bet)
Seat 4: DanaEaston77 folded before Flop (didn't bet)
Seat 5: Clamfish0 (button) folded on the River
Seat 6: Galileomax (small blind) folded before Flop


PokerStars Hand #208960576756:  Hold'em No Limit ($0.25/$0.50 USD) - 2020/02/07 21:11:13 ET
Table 'Aaltje III' 6-max Seat #1 is the button
Seat 1: Respad Gammeing ($92.13 in chips)
Seat 2: ArfanTariq ($74.65 in chips)
Seat 3: ishuha ($50 in chips)
Seat 4: DanaEaston77 ($46.78 in chips)
Seat 5: Clamfish0 ($50 in chips)
Seat 6: Galileomax ($50.94 in chips)
ArfanTariq: posts small blind $0.25
ishuha: posts big blind $0.50
*** HOLE CARDS ***
DanaEaston77: folds
Clamfish0: folds
Galileomax: folds
Respad Gammeing: calls $0.50
ArfanTariq: calls $0.25
ishuha: checks
*** FLOP *** [2d 5s Qs]
ArfanTariq: checks
ishuha: bets $1.50
Respad Gammeing: raises $1.50 to $3
ArfanTariq: calls $3
ishuha: calls $1.50
*** TURN *** [2d 5s Qs] [Ad]
ArfanTariq: bets $2.11
ishuha: calls $2.11
Respad Gammeing: calls $2.11
*** RIVER *** [2d 5s Qs Ad] [2s]
ArfanTariq: bets $15.03
ishuha: folds
Respad Gammeing: folds
Uncalled bet ($15.03) returned to ArfanTariq
ArfanTariq collected $15.99 from pot
ArfanTariq: doesn't show hand
*** SUMMARY ***
Total pot $16.83 | Rake $0.84
Board [2d 5s Qs Ad 2s]
Seat 1: Respad Gammeing (button) folded on the River
Seat 2: ArfanTariq (small blind) collected ($15.99)
Seat 3: ishuha (big blind) folded on the River
Seat 4: DanaEaston77 folded before Flop (didn't bet)
Seat 5: Clamfish0 folded before Flop (didn't bet)
Seat 6: Galileomax folded before Flop (didn't bet)


PokerStars Hand #208960593097:  Hold'em No Limit ($0.25/$0.50 USD) - 2020/02/07 21:12:10 ET
Table 'Aaltje III' 6-max Seat #2 is the button
Seat 1: Respad Gammeing ($86.52 in chips)
Seat 2: ArfanTariq ($85.03 in chips)
Seat 3: ishuha ($50 in chips)
Seat 4: DanaEaston77 ($46.78 in chips)
Seat 5: Clamfish0 ($50 in chips)
Seat 6: Galileomax ($50.94 in chips)
ishuha: posts small blind $0.25
DanaEaston77: posts big blind $0.50
*** HOLE CARDS ***
Clamfish0: folds
Galileomax: folds
Respad Gammeing: folds
ArfanTariq: calls $0.50
ishuha: calls $0.25
DanaEaston77: checks
*** FLOP *** [Ah 6h As]
ishuha: checks
DanaEaston77: bets $0.50
ArfanTariq: calls $0.50
ishuha: folds
*** TURN *** [Ah 6h As] [5d]
DanaEaston77: bets $1
ArfanTariq: calls $1
*** RIVER *** [Ah 6h As 5d] [7s]
DanaEaston77: checks
ArfanTariq: bets $6.85
DanaEaston77: folds
Uncalled bet ($6.85) returned to ArfanTariq
ArfanTariq collected $4.28 from pot
ArfanTariq: doesn't show hand
*** SUMMARY ***
Total pot $4.50 | Rake $0.22
Board [Ah 6h As 5d 7s]
Seat 1: Respad Gammeing folded before Flop (didn't bet)
Seat 2: ArfanTariq (button) collected ($4.28)
Seat 3: ishuha (small blind) folded on the Flop
Seat 4: DanaEaston77 (big blind) folded on the River
Seat 5: Clamfish0 folded before Flop (didn't bet)
Seat 6: Galileomax folded before Flop (didn't bet)


PokerStars Hand #208960606885:  Hold'em No Limit ($0.25/$0.50 USD) - 2020/02/07 21:12:58 ET
Table 'Aaltje III' 6-max Seat #3 is the button
Seat 1: Respad Gammeing ($86.52 in chips)
Seat 2: ArfanTariq ($87.31 in chips)
Seat 3: ishuha ($50 in chips)
Seat 4: DanaEaston77 ($44.78 in chips)
Seat 5: Clamfish0 ($50 in chips)
Seat 6: Galileomax ($50.94 in chips)
DanaEaston77: posts small blind $0.25
Clamfish0: posts big blind $0.50
*** HOLE CARDS ***
Galileomax: folds
Respad Gammeing: raises $3.62 to $4.12
ArfanTariq: calls $4.12
ishuha: folds
DanaEaston77: folds
Clamfish0: folds
*** FLOP *** [6d 3c 6h]
Respad Gammeing: bets $5.04
ArfanTariq: calls $5.04
*** TURN *** [6d 3c 6h] [3h]
Respad Gammeing: bets $4.28
ArfanTariq: calls $4.28
*** RIVER *** [6d 3c 6h 3h] [4c]
Respad Gammeing: bets $10.95
ArfanTariq: folds
Uncalled bet ($10.95) returned to Respad Gammeing
Respad Gammeing collected $26.25 from pot
Respad Gammeing: doesn't show hand
*** SUMMARY ***
Total pot $27.63 | Rake $1.38
Board [6d 3c 6h 3h 4c]
Seat 1: Respad Gammeing collected ($26.25)
Seat 2: ArfanTariq folded on the River
Seat 3: ishuha (button) folded before Flop (didn't bet)
Seat 4: DanaEaston77 (small blind) folded before Flop
Seat 5: Clamfish0 (big blind) folded before Flop
Seat 6: Galileomax folded before Flop (didn't bet)


PokerStars Hand #208960623408:  Hold'em No Limit ($0.25/$0.50 USD) - 2020/02/07 21:13:55 ET
Table 'Aaltje III' 6-max Seat #4 is the button
Seat 1: Respad Gammeing ($99.33 in chips)
Seat 2: ArfanTariq ($73.87 in chips)
Seat 3: ishuha ($50 in chips)
Seat 4: DanaEaston77 ($44.53 in chips)
Seat 5: Clamfish0 ($50 in chips)
Seat 6: Galileomax ($50.94 in chips)
Clamfish0: posts small blind $0.25
Galileomax: posts big blind $0.50
*** HOLE CARDS ***
Respad Gammeing: calls $0.50
ArfanTariq: folds
ishuha: folds
DanaEaston77: raises $1 to $1.50
Clamfish0: folds
Galileomax: folds
Respad Gammeing: calls $1
*** FLOP *** [5s Ah As]
Respad Gammeing: checks
DanaEaston77: checks
*** TURN *** [5s Ah As] [4s]
Respad Gammeing: bets $5.59
DanaEaston77: folds
Uncalled bet ($5.59) returned to Respad Gammeing
Respad Gammeing collected $3.56 from pot
Respad Gammeing: doesn't show hand
*** SUMMARY ***
Total pot $3.75 | Rake $0.19
Board [5s Ah As 4s]
Seat 1: Respad Gammeing collected ($3.56)
Seat 2: ArfanTariq folded before Flop (didn't bet)
Seat 3: ishuha folded before Flop (didn't bet)
Seat 4: DanaEaston77 (button) folded on the Turn
Seat 5: Clamfish0 (small blind) folded before Flop
Seat 6: Galileomax (big blind) folded before Flop


PokerStars Hand #208960650657:  Hold'em No Limit ($0.25/$0.50 USD) - 2020/02/07 21:15:30 ET
Table 'Aaltje III' 6-max Seat #6 is the button
Seat 1: Respad Gammeing ($100.89 in chips)
Seat 2: ArfanTariq ($73.87 in chips)
Seat 3: ishuha ($50 in chips)
Seat 5: Clamfish0 ($51.72 in chips)
Seat 6: Galileomax ($49.06 in chips)
Respad Gammeing: posts small blind $0.25
ArfanTariq: posts big blind $0.50
Dspn: sits out
*** HOLE CARDS ***
ishuha: raises $0.75 to $1.25
Clamfish0: folds
Galileomax: folds
Respad Gammeing: folds
ArfanTariq: calls $0.75
*** FLOP *** [5h 2s 3d]
ArfanTariq: checks
ishuha: checks
*** TURN *** [5h 2s 3d] [Kd]
ArfanTariq: checks
ishuha: checks
*** RIVER *** [5h 2s 3d Kd] [6c]
ArfanTariq: checks
ishuha: checks
*** SHOW DOWN ***
ArfanTariq: shows [Js Qd] (high card King)
ishuha: shows [8h Ac] (high card Ace)
ishuha collected $2.61 from pot
*** SUMMARY ***
Total pot $2.75 | Rake $0.14
Board [5h 2s 3d Kd 6c]
Seat 1: Respad Gammeing (small blind) folded before Flop
Seat 2: ArfanTariq (big blind) showed [Js Qd] and lost with high card King
Seat 3: ishuha showed [8h Ac] and won ($2.61) with high card Ace
Seat 5: Clamfish0 folded before Flop (didn't bet)
Seat 6: Galileomax (button) folded before Flop (didn't bet)


PokerStars Hand #208960636995:  Hold'em No Limit ($0.25/$0.50 USD) - 2020/02/07 21:14:42 ET
Table 'Aaltje III' 6-max Seat #5 is the button
Seat 1: Respad Gammeing ($101.39 in chips)
Seat 2: ArfanTariq ($73.87 in chips)
Seat 3: ishuha ($50 in chips)
Seat 4: DanaEaston77 ($43.03 in chips)
Seat 5: Clamfish0 ($50 in chips)
Seat 6: Galileomax ($50.44 in chips)
Galileomax: posts small blind $0.25
Respad Gammeing: posts big blind $0.50
*** HOLE CARDS ***
ArfanTariq: folds
ishuha: folds
DanaEaston77: folds
Clamfish0: raises $0.88 to $1.38
DanaEaston77 leaves the table
Galileomax: calls $1.13
Respad Gammeing: folds
*** FLOP *** [As 3s Jh]
Dspn joins the table at seat #4
Galileomax: checks
Clamfish0: bets $1.77
Galileomax: folds
Uncalled bet ($1.77) returned to Clamfish0
Clamfish0 collected $3.10 from pot
Clamfish0: doesn't show hand
*** SUMMARY ***
Total pot $3.26 | Rake $0.16
Board [As 3s Jh]
Seat 1: Respad Gammeing (big blind) folded before Flop
Seat 2: ArfanTariq folded before Flop (didn't bet)
Seat 3: ishuha folded before Flop (didn't bet)
Seat 4: DanaEaston77 folded before Flop (didn't bet)
Seat 5: Clamfish0 (button) collected ($3.10)
Seat 6: Galileomax (small blind) folded on the Flop


PokerStars Hand #208960660908:  Hold'em No Limit ($0.25/$0.50 USD) - 2020/02/07 21:16:02 ET
Table 'Aaltje III' 6-max Seat #1 is the button
Seat 1: Respad Gammeing ($100.64 in chips)
Seat 2: ArfanTariq ($72.62 in chips)
Seat 3: ishuha ($51.36 in chips)
Seat 5: Clamfish0 ($51.72 in chips)
Seat 6: Galileomax ($49.06 in chips)
ArfanTariq: posts small blind $0.25
ishuha: posts big blind $0.50
Dspn: sits out
*** HOLE CARDS ***
Clamfish0: folds
Galileomax: folds
Respad Gammeing: folds
ArfanTariq: calls $0.25
ishuha: checks
*** FLOP *** [7d Ah 5s]
ArfanTariq: checks
ishuha: checks
*** TURN *** [7d Ah 5s] [4h]
ArfanTariq: checks
ishuha: checks
*** RIVER *** [7d Ah 5s 4h] [5h]
ArfanTariq: bets $17.84
ishuha: folds
Uncalled bet ($17.84) returned to ArfanTariq
ArfanTariq collected $0.95 from pot
ArfanTariq: doesn't show hand
*** SUMMARY ***
Total pot $1 | Rake $0.05
Board [7d Ah 5s 4h 5h]
Seat 1: Respad Gammeing (button) folded before Flop (didn't bet)
Seat 2: ArfanTariq (small blind) collected ($0.95)
Seat 3: ishuha (big blind) folded on the River
Seat 5: Clamfish0 folded before Flop (didn't bet)
Seat 6: Galileomax folded before Flop (didn't bet)


PokerStars Hand #208960670278:  Hold'em No Limit ($0.25/$0.50 USD) - 2020/02/07 21:16:35 ET
Table 'Aaltje III' 6-max Seat #2 is the button
Seat 1: Respad Gammeing ($100.64 in chips)
Seat 2: ArfanTariq ($73.07 in chips)
Seat 3: ishuha ($50.86 in chips)
Seat 4: Dspn ($50 in chips)
Seat 5: Clamfish0 ($51.72 in chips)
Seat 6: Galileomax ($49.06 in chips)
ishuha: posts small blind $0.25
Dspn: posts big blind $0.50
*** HOLE CARDS ***
Clamfish0: folds
Galileomax: folds
Respad Gammeing: calls $0.50
ArfanTariq: folds
ishuha: raises $2 to $2.50
Dspn: calls $2
Respad Gammeing: calls $2
*** FLOP *** [2d 8s Tc]
ishuha: checks
Dspn: bets $2.14
Respad Gammeing: folds
ishuha: calls $2.14
*** TURN *** [2d 8s Tc] [7h]
ishuha: checks
Dspn: bets $6
ishuha: raises $7.50 to $13.50
Dspn: calls $7.50
*** RIVER *** [2d 8s Tc 7h] [Kc]
ishuha: bets $19.53
Dspn: calls $19.53
*** SHOW DOWN ***
ishuha: shows [8d 8c] (three of a kind, Eights)
Dspn: mucks hand
ishuha collected $75.84 from pot
*** SUMMARY ***
Total pot $77.84 | Rake $2
Board [2d 8s Tc 7h Kc]
Seat 1: Respad Gammeing folded on the Flop
Seat 2: ArfanTariq (button) folded before Flop (didn't bet)
Seat 3: ishuha (small blind) showed [8d 8c] and won ($75.84) with three of a kind, Eights
Seat 4: Dspn (big blind) mucked
Seat 5: Clamfish0 folded before Flop (didn't bet)
Seat 6: Galileomax folded before Flop (didn't bet)


PokerStars Hand #208960696404:  Hold'em No Limit ($0.25/$0.50 USD) - 2020/02/07 21:18:00 ET
Table 'Aaltje III' 6-max Seat #3 is the button
Seat 1: Respad Gammeing ($98.14 in chips)
Seat 2: ArfanTariq ($73.07 in chips)
Seat 3: ishuha ($89.03 in chips)
Seat 4: Dspn ($50 in chips)
Seat 5: Clamfish0 ($51.72 in chips)
Seat 6: Galileomax ($49.06 in chips)
Dspn: posts small blind $0.25
Clamfish0: posts big blind $0.50
*** HOLE CARDS ***
Galileomax: folds
Respad Gammeing: calls $0.50
ArfanTariq: calls $0.50
ishuha: folds
Dspn: raises $2.50 to $3
Clamfish0: folds
Respad Gammeing: calls $2.50
ArfanTariq: calls $2.50
*** FLOP *** [Ah 2d 3h]
Dspn: bets $2.71
Respad Gammeing: folds
ArfanTariq: calls $2.71
*** TURN *** [Ah 2d 3h] [8h]
Dspn: checks
ArfanTariq: checks
*** RIVER *** [Ah 2d 3h 8h] [Jc]
Dspn: checks
ArfanTariq: bets $11.06
Dspn: folds
Uncalled bet ($11.06) returned to ArfanTariq
ArfanTariq collected $14.17 from pot
ArfanTariq: doesn't show hand
*** SUMMARY ***
Total pot $14.92 | Rake $0.75
Board [Ah 2d 3h 8h Jc]
Seat 1: Respad Gammeing folded on the Flop
Seat 2: ArfanTariq collected ($14.17)
Seat 3: ishuha (button) folded before Flop (didn't bet)
Seat 4: Dspn (small blind) folded on the River
Seat 5: Clamfish0 (big blind) folded before Flop
Seat 6: Galileomax folded before Flop (didn't bet)


PokerStars Hand #208960720831:  Hold'em No Limit ($0.25/$0.50 USD) - 2020/02/07 21:18:57 ET
Table 'Aaltje III' 6-max Seat #4 is the button
Seat 1: Respad Gammeing ($95.14 in chips)
Seat 2: ArfanTariq ($81.53 in chips)
Seat 3: ishuha ($89.03 in chips)
Seat 4: Dspn ($50 in chips)
Seat 5: Clamfish0 ($51.22 in chips)
Seat 6: Galileomax ($49.06 in chips)
Clamfish0: posts small blind $0.25
Galileomax: posts big blind $0.50
*** HOLE CARDS ***
Respad Gammeing: raises $2.15 to $2.65
ArfanTariq: calls $2.65
ishuha: calls $2.65
Dspn: folds
Clamfish0: folds
Galileomax: folds
*** FLOP *** [Qc 4d Kh]
Respad Gammeing: checks
ArfanTariq: bets $3.70
ishuha: calls $3.70
Respad Gammeing: calls $3.70
*** TURN *** [Qc 4d Kh] [Ks]
Respad Gammeing: checks
ArfanTariq: bets $9.61
Dspn leaves the table
Glushchenko joins the table at seat #4
ishuha: calls $9.61
Respad Gammeing: folds
*** RIVER *** [Qc 4d Kh Ks] [Qs]
ArfanTariq: bets $39.31
ishuha: folds
Uncalled bet ($39.31) returned to ArfanTariq
ArfanTariq collected $37.07 from pot
ArfanTariq: doesn't show hand
*** SUMMARY ***
Total pot $39.02 | Rake $1.95
Board [Qc 4d Kh Ks Qs]
Seat 1: Respad Gammeing folded on the Turn
Seat 2: ArfanTariq collected ($37.07)
Seat 3: ishuha folded on the River
Seat 4: Dspn (button) folded before Flop (didn't bet)
Seat 5: Clamfish0 (small blind) folded before Flop
Seat 6: Galileomax (big blind) folded before Flop


PokerStars Hand #208960742088:  Hold'em No Limit ($0.25/$0.50 USD) - 2020/02/07 21:20:12 ET
Table 'Aaltje III' 6-max Seat #5 is the button
Seat 1: Respad Gammeing ($88.79 in chips)
Seat 2: ArfanTariq ($102.64 in chips)
Seat 3: ishuha ($73.07 in chips)
Seat 5: Clamfish0 ($50.97 in chips)
Seat 6: Galileomax ($48.56 in chips)
Galileomax: posts small blind $0.25
Respad Gammeing: posts big blind $0.50
Glushchenko: sits out
*** HOLE CARDS ***
ArfanTariq: calls $0.50
ishuha: folds
Clamfish0: raises $1.23 to $1.73
Galileomax: folds
Respad Gammeing: folds
ArfanTariq: calls $1.23
*** FLOP *** [Ac Ah Js]
ArfanTariq: checks
Clamfish0: checks
*** TURN *** [Ac Ah Js] [7d]
ArfanTariq: checks
Clamfish0: checks
*** RIVER *** [Ac Ah Js 7d] [6d]
ArfanTariq: checks
Clamfish0: checks
*** SHOW DOWN ***
ArfanTariq: shows [Tc 9d] (a pair of Aces)
Clamfish0: shows [9h Ks] (a pair of Aces - King kicker)
Clamfish0 collected $4 from pot
*** SUMMARY ***
Total pot $4.21 | Rake $0.21
Board [Ac Ah Js 7d 6d]
Seat 1: Respad Gammeing (big blind) folded before Flop
Seat 2: ArfanTariq showed [Tc 9d] and lost with a pair of Aces
Seat 3: ishuha folded before Flop (didn't bet)
Seat 5: Clamfish0 (button) showed [9h Ks] and won ($4) with a pair of Aces
Seat 6: Galileomax (small blind) folded before Flop


PokerStars Hand #208960755266:  Hold'em No Limit ($0.25/$0.50 USD) - 2020/02/07 21:20:58 ET
Table 'Aaltje III' 6-max Seat #6 is the button
Seat 1: Respad Gammeing ($88.29 in chips)
Seat 2: ArfanTariq ($100.91 in chips)
Seat 3: ishuha ($73.07 in chips)
Seat 5: Clamfish0 ($53.24 in chips)
Seat 6: Galileomax ($48.31 in chips)
Respad Gammeing: posts small blind $0.25
ArfanTariq: posts big blind $0.50
Glushchenko: sits out
*** HOLE CARDS ***
ishuha: folds
Clamfish0: folds
Galileomax has timed out
Galileomax: folds
Respad Gammeing: calls $0.25
ArfanTariq: checks
*** FLOP *** [3s 3h 2d]
Respad Gammeing: bets $3.13
ArfanTariq: calls $3.13
*** TURN *** [3s 3h 2d] [7c]
Respad Gammeing: checks
ArfanTariq: bets $6.49
Respad Gammeing: calls $6.49
*** RIVER *** [3s 3h 2d 7c] [4c]
Respad Gammeing: checks
ArfanTariq: bets $28.05
Respad Gammeing: calls $28.05
*** SHOW DOWN ***
ArfanTariq: shows [2s 5d] (two pair, Threes and Deuces)
Respad Gammeing: shows [Kd 2h] (two pair, Threes and Deuces - King kicker)
Respad Gammeing collected $74.34 from pot
*** SUMMARY ***
Total pot $76.34 | Rake $2
Board [3s 3h 2d 7c 4c]
Seat 1: Respad Gammeing (small blind) showed [Kd 2h] and won ($74.34) with two pair, Threes and Deuces
Seat 2: ArfanTariq (big blind) showed [2s 5d] and lost with two pair, Threes and Deuces
Seat 3: ishuha folded before Flop (didn't bet)
Seat 5: Clamfish0 folded before Flop (didn't bet)
Seat 6: Galileomax (button) folded before Flop (didn't bet)


PokerStars Hand #208960773981:  Hold'em No Limit ($0.25/$0.50 USD) - 2020/02/07 21:22:04 ET
Table 'Aaltje III' 6-max Seat #1 is the button
Seat 1: Respad Gammeing ($124.46 in chips)
Seat 2: ArfanTariq ($62.74 in chips)
Seat 3: ishuha ($73.07 in chips)
Seat 5: Clamfish0 ($53.24 in chips)
Seat 6: Galileomax ($48.31 in chips)
ArfanTariq: posts small blind $0.25
ishuha: posts big blind $0.50
Glushchenko: sits out
*** HOLE CARDS ***
Clamfish0: folds
Galileomax: folds
Respad Gammeing: folds
ArfanTariq: calls $0.25
ishuha: raises $1 to $1.50
ArfanTariq: calls $1
*** FLOP *** [5c 8s Kc]
ArfanTariq: bets $2.80
ishuha: folds
Uncalled bet ($2.80) returned to ArfanTariq
ArfanTariq collected $2.85 from pot
ArfanTariq: doesn't show hand
*** SUMMARY ***
Total pot $3 | Rake $0.15
Board [5c 8s Kc]
Seat 1: Respad Gammeing (button) folded before Flop (didn't bet)
Seat 2: ArfanTariq (small blind) collected ($2.85)
Seat 3: ishuha (big blind) folded on the Flop
Seat 5: Clamfish0 folded before Flop (didn't bet)
Seat 6: Galileomax folded before Flop (didn't bet)


PokerStars Hand #208960782354:  Hold'em No Limit ($0.25/$0.50 USD) - 2020/02/07 21:22:35 ET
Table 'Aaltje III' 6-max Seat #2 is the button
Seat 1: Respad Gammeing ($124.46 in chips)
Seat 2: ArfanTariq ($64.09 in chips)
Seat 3: ishuha ($71.57 in chips)
Seat 4: Glushchenko ($50 in chips)
Seat 5: Clamfish0 ($53.24 in chips)
Seat 6: Galileomax ($48.31 in chips)
ishuha: posts small blind $0.25
Glushchenko: posts big blind $0.50
*** HOLE CARDS ***
Clamfish0: folds
Galileomax: raises $1 to $1.50
Respad Gammeing: calls $1.50
ArfanTariq: folds
ishuha: folds
Glushchenko: folds
*** FLOP *** [Td 7d 5c]
Galileomax: bets $3
Respad Gammeing: folds
Uncalled bet ($3) returned to Galileomax
Galileomax collected $3.56 from pot
Galileomax: doesn't show hand
*** SUMMARY ***
Total pot $3.75 | Rake $0.19
Board [Td 7d 5c]
Seat 1: Respad Gammeing folded on the Flop
Seat 2: ArfanTariq (button) folded before Flop (didn't bet)
Seat 3: ishuha (small blind) folded before Flop
Seat 4: Glushchenko (big blind) folded before Flop
Seat 5: Clamfish0 folded before Flop (didn't bet)
Seat 6: Galileomax collected ($3.56)


PokerStars Hand #208960797702:  Hold'em No Limit ($0.25/$0.50 USD) - 2020/02/07 21:23:29 ET
Table 'Aaltje III' 6-max Seat #3 is the button
Seat 1: Respad Gammeing ($122.96 in chips)
Seat 2: ArfanTariq ($64.09 in chips)
Seat 3: ishuha ($71.32 in chips)
Seat 4: Glushchenko ($50 in chips)
Seat 5: Clamfish0 ($53.24 in chips)
Seat 6: Galileomax ($50.37 in chips)
Glushchenko: posts small blind $0.25
Clamfish0: posts big blind $0.50
*** HOLE CARDS ***
Galileomax: folds
Respad Gammeing: folds
ArfanTariq: calls $0.50
ishuha: folds
Glushchenko: calls $0.25
Clamfish0: checks
*** FLOP *** [Ad 6c 4h]
Glushchenko: bets $0.75
Clamfish0: calls $0.75
ArfanTariq: calls $0.75
*** TURN *** [Ad 6c 4h] [Qc]
Glushchenko: checks
Clamfish0: checks
ArfanTariq: checks
*** RIVER *** [Ad 6c 4h Qc] [2c]
Glushchenko: checks
Clamfish0: checks
ArfanTariq: checks
*** SHOW DOWN ***
Glushchenko: shows [7c 8h] (high card Ace)
Clamfish0: shows [6d As] (two pair, Aces and Sixes)
ArfanTariq: mucks hand
Clamfish0 collected $3.56 from pot
*** SUMMARY ***
Total pot $3.75 | Rake $0.19
Board [Ad 6c 4h Qc 2c]
Seat 1: Respad Gammeing folded before Flop (didn't bet)
Seat 2: ArfanTariq mucked
Seat 3: ishuha (button) folded before Flop (didn't bet)
Seat 4: Glushchenko (small blind) showed [7c 8h] and lost with high card Ace
Seat 5: Clamfish0 (big blind) showed [6d As] and won ($3.56) with two pair, Aces and Sixes
Seat 6: Galileomax folded before Flop (didn't bet)


PokerStars Hand #208960817401:  Hold'em No Limit ($0.25/$0.50 USD) - 2020/02/07 21:24:40 ET
Table 'Aaltje III' 6-max Seat #4 is the button
Seat 1: Respad Gammeing ($122.96 in chips)
Seat 2: ArfanTariq ($62.84 in chips)
Seat 3: ishuha ($71.32 in chips)
Seat 4: Glushchenko ($50 in chips)
Seat 5: Clamfish0 ($55.55 in chips)
Seat 6: Galileomax ($50.37 in chips)
Clamfish0: posts small blind $0.25
Galileomax: posts big blind $0.50
*** HOLE CARDS ***
Respad Gammeing: raises $0.50 to $1
ArfanTariq: folds
ishuha: folds
Glushchenko: folds
Clamfish0: folds
Galileomax: folds
Uncalled bet ($0.50) returned to Respad Gammeing
Respad Gammeing collected $1.25 from pot
Respad Gammeing: doesn't show hand
*** SUMMARY ***
Total pot $1.25 | Rake $0
Seat 1: Respad Gammeing collected ($1.25)
Seat 2: ArfanTariq folded before Flop (didn't bet)
Seat 3: ishuha folded before Flop (didn't bet)
Seat 4: Glushchenko (button) folded before Flop (didn't bet)
Seat 5: Clamfish0 (small blind) folded before Flop
Seat 6: Galileomax (big blind) folded before Flop


PokerStars Hand #208960822686:  Hold'em No Limit ($0.25/$0.50 USD) - 2020/02/07 21:24:58 ET
Table 'Aaltje III' 6-max Seat #5 is the button
Seat 1: Respad Gammeing ($123.71 in chips)
Seat 2: ArfanTariq ($62.84 in chips)
Seat 3: ishuha ($71.32 in chips)
Seat 4: Glushchenko ($50 in chips)
Seat 5: Clamfish0 ($55.30 in chips)
Seat 6: Galileomax ($49.87 in chips)
Galileomax: posts small blind $0.25
Respad Gammeing: posts big blind $0.50
*** HOLE CARDS ***
ArfanTariq: calls $0.50
ishuha: folds
Glushchenko: folds
Clamfish0: folds
Galileomax: folds
Respad Gammeing: checks
*** FLOP *** [7s 5d Jh]
Respad Gammeing: checks
ArfanTariq: bets $1.91
Respad Gammeing: calls $1.91
*** TURN *** [7s 5d Jh] [4s]
Respad Gammeing: checks
ArfanTariq: bets $1.87
Respad Gammeing: calls $1.87
*** RIVER *** [7s 5d Jh 4s] [Qd]
Respad Gammeing: checks
ArfanTariq: checks
*** SHOW DOWN ***
Respad Gammeing: shows [8d Ts] (high card Queen)
ArfanTariq: shows [3c 3d] (a pair of Threes)
ArfanTariq collected $8.37 from pot
*** SUMMARY ***
Total pot $8.81 | Rake $0.44
Board [7s 5d Jh 4s Qd]
Seat 1: Respad Gammeing (big blind) showed [8d Ts] and lost with high card Queen
Seat 2: ArfanTariq showed [3c 3d] and won ($8.37) with a pair of Threes
Seat 3: ishuha folded before Flop (didn't bet)
Seat 4: Glushchenko folded before Flop (didn't bet)
Seat 5: Clamfish0 (button) folded before Flop (didn't bet)
Seat 6: Galileomax (small blind) folded before Flop


PokerStars Hand #208960836543:  Hold'em No Limit ($0.25/$0.50 USD) - 2020/02/07 21:25:47 ET
Table 'Aaltje III' 6-max Seat #6 is the button
Seat 1: Respad Gammeing ($119.43 in chips)
Seat 2: ArfanTariq ($66.93 in chips)
Seat 3: ishuha ($71.32 in chips)
Seat 4: Glushchenko ($50 in chips)
Seat 5: Clamfish0 ($55.30 in chips)
Seat 6: Galileomax ($49.62 in chips)
Respad Gammeing: posts small blind $0.25
ArfanTariq: posts big blind $0.50
*** HOLE CARDS ***
ishuha: folds
Glushchenko: folds
Clamfish0: folds
Galileomax: raises $1 to $1.50
Respad Gammeing: calls $1.25
ArfanTariq: calls $1
*** FLOP *** [9d 9s 3d]
Respad Gammeing: checks
ArfanTariq: checks
Galileomax: checks
*** TURN *** [9d 9s 3d] [Ks]
Respad Gammeing: checks
ArfanTariq: checks
Galileomax: checks
*** RIVER *** [9d 9s 3d Ks] [Kh]
Respad Gammeing: checks
ArfanTariq: checks
Galileomax: checks
*** SHOW DOWN ***
Respad Gammeing: shows [5h 2h] (two pair, Kings and Nines)
ArfanTariq: shows [Js 7h] (two pair, Kings and Nines - Jack kicker)
Galileomax: shows [Ac 4c] (two pair, Kings and Nines - Ace kicker)
Galileomax collected $4.28 from pot
*** SUMMARY ***
Total pot $4.50 | Rake $0.22
Board [9d 9s 3d Ks Kh]
Seat 1: Respad Gammeing (small blind) showed [5h 2h] and lost with two pair, Kings and Nines
Seat 2: ArfanTariq (big blind) showed [Js 7h] and lost with two pair, Kings and Nines
Seat 3: ishuha folded before Flop (didn't bet)
Seat 4: Glushchenko folded before Flop (didn't bet)
Seat 5: Clamfish0 folded before Flop (didn't bet)
Seat 6: Galileomax (button) showed [Ac 4c] and won ($4.28) with two pair, Kings and Nines


PokerStars Hand #208960851305:  Hold'em No Limit ($0.25/$0.50 USD) - 2020/02/07 21:26:40 ET
Table 'Aaltje III' 6-max Seat #1 is the button
Seat 1: Respad Gammeing ($117.93 in chips)
Seat 2: ArfanTariq ($65.43 in chips)
Seat 3: ishuha ($71.32 in chips)
Seat 4: Glushchenko ($50 in chips)
Seat 5: Clamfish0 ($55.30 in chips)
Seat 6: Galileomax ($52.40 in chips)
ArfanTariq: posts small blind $0.25
ishuha: posts big blind $0.50
*** HOLE CARDS ***
Glushchenko: folds
Clamfish0: raises $0.88 to $1.38
Galileomax: folds
Respad Gammeing: folds
ArfanTariq: calls $1.13
ishuha: folds
*** FLOP *** [7d Ks 3s]
ArfanTariq: checks
Clamfish0: bets $0.99
ArfanTariq: calls $0.99
*** TURN *** [7d Ks 3s] [3h]
ArfanTariq: checks
Clamfish0: checks
*** RIVER *** [7d Ks 3s 3h] [8c]
ArfanTariq: bets $4.75
Clamfish0: calls $4.75
*** SHOW DOWN ***
ArfanTariq: shows [8h 7h] (two pair, Eights and Sevens)
Clamfish0: shows [Ts Tc] (two pair, Tens and Threes)
Clamfish0 collected $14 from pot
*** SUMMARY ***
Total pot $14.74 | Rake $0.74
Board [7d Ks 3s 3h 8c]
Seat 1: Respad Gammeing (button) folded before Flop (didn't bet)
Seat 2: ArfanTariq (small blind) showed [8h 7h] and lost with two pair, Eights and Sevens
Seat 3: ishuha (big blind) folded before Flop
Seat 4: Glushchenko folded before Flop (didn't bet)
Seat 5: Clamfish0 showed [Ts Tc] and won ($14) with two pair, Tens and Threes
Seat 6: Galileomax folded before Flop (didn't bet)


PokerStars Hand #208960865685:  Hold'em No Limit ($0.25/$0.50 USD) - 2020/02/07 21:27:20 ET
Table 'Aaltje III' 6-max Seat #2 is the button
Seat 1: Respad Gammeing ($117.93 in chips)
Seat 2: ArfanTariq ($58.31 in chips)
Seat 3: ishuha ($70.82 in chips)
Seat 4: Glushchenko ($50 in chips)
Seat 5: Clamfish0 ($62.18 in chips)
Seat 6: Galileomax ($52.40 in chips)
ishuha: posts small blind $0.25
Glushchenko: posts big blind $0.50
*** HOLE CARDS ***
Clamfish0: folds
Galileomax: raises $0.60 to $1.10
Respad Gammeing: folds
ArfanTariq: folds
ishuha: folds
Glushchenko: folds
Uncalled bet ($0.60) returned to Galileomax
Galileomax collected $1.25 from pot
Galileomax: doesn't show hand
*** SUMMARY ***
Total pot $1.25 | Rake $0
Seat 1: Respad Gammeing folded before Flop (didn't bet)
Seat 2: ArfanTariq (button) folded before Flop (didn't bet)
Seat 3: ishuha (small blind) folded before Flop
Seat 4: Glushchenko (big blind) folded before Flop
Seat 5: Clamfish0 folded before Flop (didn't bet)
Seat 6: Galileomax collected ($1.25)


PokerStars Hand #208960869676:  Hold'em No Limit ($0.25/$0.50 USD) - 2020/02/07 21:27:35 ET
Table 'Aaltje III' 6-max Seat #3 is the button
Seat 1: Respad Gammeing ($117.93 in chips)
Seat 2: ArfanTariq ($58.31 in chips)
Seat 3: ishuha ($70.57 in chips)
Seat 4: Glushchenko ($50 in chips)
Seat 5: Clamfish0 ($62.18 in chips)
Seat 6: Galileomax ($53.15 in chips)
Glushchenko: posts small blind $0.25
Clamfish0: posts big blind $0.50
*** HOLE CARDS ***
Galileomax: folds
Respad Gammeing: raises $2.92 to $3.42
ArfanTariq: calls $3.42
ishuha: folds
Glushchenko: folds
Clamfish0: folds
*** FLOP *** [Qh Td Qd]
Respad Gammeing: bets $5.74
ArfanTariq: calls $5.74
*** TURN *** [Qh Td Qd] [2c]
Respad Gammeing: bets $3.42
ArfanTariq: calls $3.42
*** RIVER *** [Qh Td Qd 2c] [8d]
Respad Gammeing: checks
ArfanTariq: bets $45.73 and is all-in
Respad Gammeing: calls $45.73
*** SHOW DOWN ***
ArfanTariq: shows [2d Jd] (a flush, Queen high)
Respad Gammeing: shows [Kd 6d] (a flush, King high)
Respad Gammeing collected $115.37 from pot
*** SUMMARY ***
Total pot $117.37 | Rake $2
Board [Qh Td Qd 2c 8d]
Seat 1: Respad Gammeing showed [Kd 6d] and won ($115.37) with a flush, King high
Seat 2: ArfanTariq showed [2d Jd] and lost with a flush, Queen high
Seat 3: ishuha (button) folded before Flop (didn't bet)
Seat 4: Glushchenko (small blind) folded before Flop
Seat 5: Clamfish0 (big blind) folded before Flop
Seat 6: Galileomax folded before Flop (didn't bet)


PokerStars Hand #208960886403:  Hold'em No Limit ($0.25/$0.50 USD) - 2020/02/07 21:28:34 ET
Table 'Aaltje III' 6-max Seat #4 is the button
Seat 1: Respad Gammeing ($174.99 in chips)
Seat 3: ishuha ($70.57 in chips)
Seat 4: Glushchenko ($50 in chips)
Seat 5: Clamfish0 ($61.68 in chips)
Seat 6: Galileomax ($53.15 in chips)
Clamfish0: posts small blind $0.25
Galileomax: posts big blind $0.50
*** HOLE CARDS ***
Respad Gammeing: calls $0.50
ishuha: raises $1 to $1.50
Glushchenko: folds
Clamfish0: folds
Galileomax: folds
Respad Gammeing: calls $1
*** FLOP *** [4d Qh Qs]
Respad Gammeing: bets $2.99
ishuha: calls $2.99
*** TURN *** [4d Qh Qs] [4s]
Respad Gammeing: bets $7.24
ishuha: calls $7.24
*** RIVER *** [4d Qh Qs 4s] [Ad]
Respad Gammeing: bets $16.73
ishuha: calls $16.73
*** SHOW DOWN ***
Respad Gammeing: shows [4h 2h] (a full house, Fours full of Queens)
ishuha: mucks hand
Respad Gammeing collected $55.67 from pot
*** SUMMARY ***
Total pot $57.67 | Rake $2
Board [4d Qh Qs 4s Ad]
Seat 1: Respad Gammeing showed [4h 2h] and won ($55.67) with a full house, Fours full of Queens
Seat 3: ishuha mucked
Seat 4: Glushchenko (button) folded before Flop (didn't bet)
Seat 5: Clamfish0 (small blind) folded before Flop
Seat 6: Galileomax (big blind) folded before Flop


PokerStars Hand #208960901366:  Hold'em No Limit ($0.25/$0.50 USD) - 2020/02/07 21:29:27 ET
Table 'Aaltje III' 6-max Seat #5 is the button
Seat 1: Respad Gammeing ($202.20 in chips)
Seat 2: ArfanTariq ($50 in chips)
Seat 3: ishuha ($50 in chips)
Seat 4: Glushchenko ($50 in chips)
Seat 5: Clamfish0 ($61.43 in chips)
Seat 6: Galileomax ($52.65 in chips)
Galileomax: posts small blind $0.25
Respad Gammeing: posts big blind $0.50
*** HOLE CARDS ***
ArfanTariq: folds
ishuha: folds
Glushchenko: raises $0.75 to $1.25
Clamfish0: folds
Galileomax: folds
Respad Gammeing: calls $0.75
*** FLOP *** [5h Qd 5c]
Respad Gammeing: checks
Glushchenko: bets $1.25
Respad Gammeing: calls $1.25
*** TURN *** [5h Qd 5c] [Qh]
Respad Gammeing: checks
Glushchenko: checks
*** RIVER *** [5h Qd 5c Qh] [Qc]
Respad Gammeing: checks
Glushchenko: checks
*** SHOW DOWN ***
Respad Gammeing: shows [Jh 9h] (a full house, Queens full of Fives)
Glushchenko: shows [Ks Ac] (a full house, Queens full of Fives)
Respad Gammeing collected $2.50 from pot
Glushchenko collected $2.49 from pot
*** SUMMARY ***
Total pot $5.25 | Rake $0.26
Board [5h Qd 5c Qh Qc]
Seat 1: Respad Gammeing (big blind) showed [Jh 9h] and won ($2.50) with a full house, Queens full of Fives
Seat 2: ArfanTariq folded before Flop (didn't bet)
Seat 3: ishuha folded before Flop (didn't bet)
Seat 4: Glushchenko showed [Ks Ac] and won ($2.49) with a full house, Queens full of Fives
Seat 5: Clamfish0 (button) folded before Flop (didn't bet)
Seat 6: Galileomax (small blind) folded before Flop


PokerStars Hand #208960913175:  Hold'em No Limit ($0.25/$0.50 USD) - 2020/02/07 21:30:10 ET
Table 'Aaltje III' 6-max Seat #6 is the button
Seat 1: Respad Gammeing ($202.20 in chips)
Seat 2: ArfanTariq ($50 in chips)
Seat 3: ishuha ($50 in chips)
Seat 4: Glushchenko ($50 in chips)
Seat 5: Clamfish0 ($61.43 in chips)
Seat 6: Galileomax ($52.40 in chips)
Respad Gammeing: posts small blind $0.25
ArfanTariq: posts big blind $0.50
*** HOLE CARDS ***
ishuha: folds
Glushchenko: folds
Clamfish0: raises $0.88 to $1.38
Galileomax: folds
Respad Gammeing: calls $1.13
ArfanTariq: calls $0.88
*** FLOP *** [6h 4h Jc]
Respad Gammeing: checks
ArfanTariq: checks
Clamfish0: bets $2.59
Respad Gammeing: calls $2.59
ArfanTariq: calls $2.59
*** TURN *** [6h 4h Jc] [6s]
Respad Gammeing: checks
ArfanTariq: checks
Clamfish0: bets $7.46
Respad Gammeing: folds
ArfanTariq: folds
Uncalled bet ($7.46) returned to Clamfish0
Clamfish0 collected $11.31 from pot
Clamfish0: doesn't show hand
*** SUMMARY ***
Total pot $11.91 | Rake $0.60
Board [6h 4h Jc 6s]
Seat 1: Respad Gammeing (small blind) folded on the Turn
Seat 2: ArfanTariq (big blind) folded on the Turn
Seat 3: ishuha folded before Flop (didn't bet)
Seat 4: Glushchenko folded before Flop (didn't bet)
Seat 5: Clamfish0 collected ($11.31)
Seat 6: Galileomax (button) folded before Flop (didn't bet)


PokerStars Hand #208960934010:  Hold'em No Limit ($0.25/$0.50 USD) - 2020/02/07 21:31:12 ET
Table 'Aaltje III' 6-max Seat #1 is the button
Seat 1: Respad Gammeing ($198.23 in chips)
Seat 2: ArfanTariq ($46.03 in chips)
Seat 3: ishuha ($50 in chips)
Seat 4: Glushchenko ($50 in chips)
Seat 5: Clamfish0 ($68.77 in chips)
Seat 6: Galileomax ($52.40 in chips)
ArfanTariq: posts small blind $0.25
ishuha: posts big blind $0.50
*** HOLE CARDS ***
Glushchenko: folds
Clamfish0: folds
Galileomax: folds
Respad Gammeing: raises $3.33 to $3.83
ArfanTariq: calls $3.58
ishuha: calls $3.33
*** FLOP *** [Js Qh Jh]
ArfanTariq: bets $5.34
ishuha: folds
Respad Gammeing: calls $5.34
*** TURN *** [Js Qh Jh] [4c]
ArfanTariq: bets $36.86 and is all-in
Respad Gammeing: calls $36.86
*** FIRST RIVER *** [Js Qh Jh 4c] [Kh]
*** SECOND RIVER *** [Js Qh Jh 4c] [8h]
*** FIRST SHOW DOWN ***
ArfanTariq: shows [2s Qc] (two pair, Queens and Jacks)
Respad Gammeing: shows [Jc Jd] (four of a kind, Jacks)
Respad Gammeing collected $46.95 from pot
*** SECOND SHOW DOWN ***
ArfanTariq: shows [2s Qc] (two pair, Queens and Jacks)
Respad Gammeing: shows [Jc Jd] (four of a kind, Jacks)
Respad Gammeing collected $46.94 from pot
*** SUMMARY ***
Total pot $95.89 | Rake $2
Hand was run twice
FIRST Board [Js Qh Jh 4c Kh]
SECOND Board [Js Qh Jh 4c 8h]
Seat 1: Respad Gammeing (button) showed [Jc Jd] and won ($46.95) with four of a kind, Jacks, and won ($46.94) with four of a kind, Jacks
Seat 2: ArfanTariq (small blind) showed [2s Qc] and lost with two pair, Queens and Jacks, and lost with two pair, Queens and Jacks
Seat 3: ishuha (big blind) folded on the Flop
Seat 4: Glushchenko folded before Flop (didn't bet)
Seat 5: Clamfish0 folded before Flop (didn't bet)
Seat 6: Galileomax folded before Flop (didn't bet)


PokerStars Hand #208960951943:  Hold'em No Limit ($0.25/$0.50 USD) - 2020/02/07 21:32:17 ET
Table 'Aaltje III' 6-max Seat #3 is the button
Seat 1: Respad Gammeing ($246.09 in chips)
Seat 3: ishuha ($50 in chips)
Seat 4: Glushchenko ($50 in chips)
Seat 5: Clamfish0 ($68.77 in chips)
Seat 6: Galileomax ($52.40 in chips)
Glushchenko: posts small blind $0.25
Clamfish0: posts big blind $0.50
*** HOLE CARDS ***
Galileomax has timed out
Galileomax: folds
Respad Gammeing: raises $4.80 to $5.30
ishuha: folds
Glushchenko: folds
Clamfish0: raises $14.76 to $20.06
Respad Gammeing: calls $14.76
*** FLOP *** [9s 6h 2s]
Clamfish0: bets $16.12
Respad Gammeing: folds
Uncalled bet ($16.12) returned to Clamfish0
Clamfish0 collected $38.37 from pot
Clamfish0: doesn't show hand
*** SUMMARY ***
Total pot $40.37 | Rake $2
Board [9s 6h 2s]
Seat 1: Respad Gammeing folded on the Flop
Seat 3: ishuha (button) folded before Flop (didn't bet)
Seat 4: Glushchenko (small blind) folded before Flop
Seat 5: Clamfish0 (big blind) collected ($38.37)
Seat 6: Galileomax folded before Flop (didn't bet)


PokerStars Hand #208960981863:  Hold'em No Limit ($0.25/$0.50 USD) - 2020/02/07 21:34:05 ET
Table 'Aaltje III' 6-max Seat #5 is the button
Seat 1: Respad Gammeing ($233.84 in chips)
Seat 2: ArfanTariq ($26 in chips)
Seat 3: ishuha ($50 in chips)
Seat 4: Glushchenko ($50 in chips)
Seat 5: Clamfish0 ($86.83 in chips)
Seat 6: Galileomax ($51.90 in chips)
Galileomax: posts small blind $0.25
Respad Gammeing: posts big blind $0.50
*** HOLE CARDS ***
ArfanTariq: raises $1 to $1.50
ishuha: folds
Glushchenko: folds
Clamfish0: folds
Galileomax: folds
Respad Gammeing: folds
Uncalled bet ($1) returned to ArfanTariq
ArfanTariq collected $1.25 from pot
ArfanTariq: doesn't show hand
*** SUMMARY ***
Total pot $1.25 | Rake $0
Seat 1: Respad Gammeing (big blind) folded before Flop
Seat 2: ArfanTariq collected ($1.25)
Seat 3: ishuha folded before Flop (didn't bet)
Seat 4: Glushchenko folded before Flop (didn't bet)
Seat 5: Clamfish0 (button) folded before Flop (didn't bet)
Seat 6: Galileomax (small blind) folded before Flop


PokerStars Hand #208960967187:  Hold'em No Limit ($0.25/$0.50 USD) - 2020/02/07 21:33:12 ET
Table 'Aaltje III' 6-max Seat #4 is the button
Seat 1: Respad Gammeing ($226.03 in chips)
Seat 2: ArfanTariq ($26 in chips)
Seat 3: ishuha ($50 in chips)
Seat 4: Glushchenko ($50 in chips)
Seat 5: Clamfish0 ($87.08 in chips)
Seat 6: Galileomax ($52.40 in chips)
Clamfish0: posts small blind $0.25
Galileomax: posts big blind $0.50
*** HOLE CARDS ***
Respad Gammeing: calls $0.50
ArfanTariq: folds
ishuha: folds
Glushchenko: raises $1.50 to $2
Clamfish0: folds
Galileomax: folds
Respad Gammeing: calls $1.50
*** FLOP *** [3s Ks 8d]
Respad Gammeing: checks
Glushchenko: bets $1.49
Respad Gammeing: calls $1.49
*** TURN *** [3s Ks 8d] [Kc]
Respad Gammeing: checks
Glushchenko: bets $4.40
Respad Gammeing: calls $4.40
*** RIVER *** [3s Ks 8d Kc] [Ah]
Respad Gammeing: checks
Glushchenko: checks
*** SHOW DOWN ***
Respad Gammeing: shows [8s 7c] (two pair, Kings and Eights)
Glushchenko: mucks hand
Respad Gammeing collected $15.70 from pot
*** SUMMARY ***
Total pot $16.53 | Rake $0.83
Board [3s Ks 8d Kc Ah]
Seat 1: Respad Gammeing showed [8s 7c] and won ($15.70) with two pair, Kings and Eights
Seat 2: ArfanTariq folded before Flop (didn't bet)
Seat 3: ishuha folded before Flop (didn't bet)
Seat 4: Glushchenko (button) mucked
Seat 5: Clamfish0 (small blind) folded before Flop
Seat 6: Galileomax (big blind) folded before Flop


PokerStars Hand #208960985510:  Hold'em No Limit ($0.25/$0.50 USD) - 2020/02/07 21:34:18 ET
Table 'Aaltje III' 6-max Seat #6 is the button
Seat 1: Respad Gammeing ($233.34 in chips)
Seat 2: ArfanTariq ($26.75 in chips)
Seat 3: ishuha ($50 in chips)
Seat 4: Glushchenko ($50 in chips)
Seat 5: Clamfish0 ($86.83 in chips)
Seat 6: Galileomax ($51.65 in chips)
Respad Gammeing: posts small blind $0.25
ArfanTariq: posts big blind $0.50
*** HOLE CARDS ***
ishuha: raises $0.75 to $1.25
Glushchenko: calls $1.25
Clamfish0: calls $1.25
Galileomax: calls $1.25
Respad Gammeing: folds
ArfanTariq: calls $0.75
*** FLOP *** [Kc 2s Jh]
ArfanTariq: bets $2.05
ishuha: folds
Glushchenko: folds
Clamfish0: folds
Galileomax: calls $2.05
*** TURN *** [Kc 2s Jh] [5c]
ArfanTariq: bets $3.09
Galileomax: calls $3.09
*** RIVER *** [Kc 2s Jh 5c] [5d]
ArfanTariq: bets $6.14
Galileomax: calls $6.14
*** SHOW DOWN ***
ArfanTariq: shows [4c Kd] (two pair, Kings and Fives)
Galileomax: mucks hand
ArfanTariq collected $27.61 from pot
*** SUMMARY ***
Total pot $29.06 | Rake $1.45
Board [Kc 2s Jh 5c 5d]
Seat 1: Respad Gammeing (small blind) folded before Flop
Seat 2: ArfanTariq (big blind) showed [4c Kd] and won ($27.61) with two pair, Kings and Fives
Seat 3: ishuha folded on the Flop
Seat 4: Glushchenko folded on the Flop
Seat 5: Clamfish0 folded on the Flop
Seat 6: Galileomax (button) mucked


PokerStars Hand #208961010170:  Hold'em No Limit ($0.25/$0.50 USD) - 2020/02/07 21:35:33 ET
Table 'Aaltje III' 6-max Seat #1 is the button
Seat 1: Respad Gammeing ($233.09 in chips)
Seat 2: ArfanTariq ($41.83 in chips)
Seat 3: ishuha ($50 in chips)
Seat 4: Glushchenko ($50 in chips)
Seat 5: Clamfish0 ($85.58 in chips)
Seat 6: Galileomax ($39.12 in chips)
ArfanTariq: posts small blind $0.25
ishuha: posts big blind $0.50
*** HOLE CARDS ***
Glushchenko: folds
Clamfish0: folds
Galileomax: folds
Respad Gammeing: folds
ArfanTariq: folds
Uncalled bet ($0.25) returned to ishuha
ishuha collected $0.50 from pot
ishuha: doesn't show hand
*** SUMMARY ***
Total pot $0.50 | Rake $0
Seat 1: Respad Gammeing (button) folded before Flop (didn't bet)
Seat 2: ArfanTariq (small blind) folded before Flop
Seat 3: ishuha (big blind) collected ($0.50)
Seat 4: Glushchenko folded before Flop (didn't bet)
Seat 5: Clamfish0 folded before Flop (didn't bet)
Seat 6: Galileomax folded before Flop (didn't bet)


PokerStars Hand #208961013806:  Hold'em No Limit ($0.25/$0.50 USD) - 2020/02/07 21:35:46 ET
Table 'Aaltje III' 6-max Seat #2 is the button
Seat 1: Respad Gammeing ($233.09 in chips)
Seat 2: ArfanTariq ($41.58 in chips)
Seat 3: ishuha ($50.25 in chips)
Seat 4: Glushchenko ($50 in chips)
Seat 5: Clamfish0 ($85.58 in chips)
Seat 6: Galileomax ($39.12 in chips)
ishuha: posts small blind $0.25
Glushchenko: posts big blind $0.50
*** HOLE CARDS ***
Clamfish0: folds
Galileomax: folds
Respad Gammeing: calls $0.50
ArfanTariq: folds
ishuha: calls $0.25
Glushchenko: checks
*** FLOP *** [7h 4d 3s]
ishuha: checks
Glushchenko: checks
Respad Gammeing: checks
*** TURN *** [7h 4d 3s] [7s]
ishuha: checks
Glushchenko: bets $1.25
Respad Gammeing: calls $1.25
ishuha: folds
*** RIVER *** [7h 4d 3s 7s] [Ac]
Glushchenko: bets $2.85
Respad Gammeing: folds
Uncalled bet ($2.85) returned to Glushchenko
Glushchenko collected $3.80 from pot
*** SUMMARY ***
Total pot $4 | Rake $0.20
Board [7h 4d 3s 7s Ac]
Seat 1: Respad Gammeing folded on the River
Seat 2: ArfanTariq (button) folded before Flop (didn't bet)
Seat 3: ishuha (small blind) folded on the Turn
Seat 4: Glushchenko (big blind) collected ($3.80)
Seat 5: Clamfish0 folded before Flop (didn't bet)
Seat 6: Galileomax folded before Flop (didn't bet)


PokerStars Hand #208961026231:  Hold'em No Limit ($0.25/$0.50 USD) - 2020/02/07 21:36:30 ET
Table 'Aaltje III' 6-max Seat #3 is the button
Seat 1: Respad Gammeing ($231.34 in chips)
Seat 2: ArfanTariq ($41.58 in chips)
Seat 3: ishuha ($50 in chips)
Seat 4: Glushchenko ($52.05 in chips)
Seat 5: Clamfish0 ($85.58 in chips)
Seat 6: Galileomax ($39.12 in chips)
Glushchenko: posts small blind $0.25
Clamfish0: posts big blind $0.50
*** HOLE CARDS ***
Galileomax: raises $1 to $1.50
Respad Gammeing: calls $1.50
ArfanTariq: calls $1.50
ishuha: folds
Glushchenko: calls $1.25
Clamfish0: calls $1
*** FLOP *** [4s 7c 2c]
Glushchenko: checks
Clamfish0: checks
Galileomax: checks
Respad Gammeing: checks
ArfanTariq: checks
*** TURN *** [4s 7c 2c] [7h]
Glushchenko: checks
Clamfish0: bets $14.95
Galileomax: folds
Respad Gammeing: folds
ArfanTariq: folds
Glushchenko: folds
Uncalled bet ($14.95) returned to Clamfish0
Clamfish0 collected $7.12 from pot
Clamfish0: doesn't show hand
*** SUMMARY ***
Total pot $7.50 | Rake $0.38
Board [4s 7c 2c 7h]
Seat 1: Respad Gammeing folded on the Turn
Seat 2: ArfanTariq folded on the Turn
Seat 3: ishuha (button) folded before Flop (didn't bet)
Seat 4: Glushchenko (small blind) folded on the Turn
Seat 5: Clamfish0 (big blind) collected ($7.12)
Seat 6: Galileomax folded on the Turn


PokerStars Hand #208961044043:  Hold'em No Limit ($0.25/$0.50 USD) - 2020/02/07 21:37:35 ET
Table 'Aaltje III' 6-max Seat #4 is the button
Seat 1: Respad Gammeing ($229.84 in chips)
Seat 2: ArfanTariq ($40.08 in chips)
Seat 3: ishuha ($50 in chips)
Seat 4: Glushchenko ($50.55 in chips)
Seat 5: Clamfish0 ($91.20 in chips)
Seat 6: Galileomax ($37.62 in chips)
Clamfish0: posts small blind $0.25
Galileomax: posts big blind $0.50
*** HOLE CARDS ***
Respad Gammeing: calls $0.50
ArfanTariq: calls $0.50
ishuha: raises $1 to $1.50
Glushchenko: folds
Clamfish0: folds
Galileomax: calls $1
Respad Gammeing: calls $1
ArfanTariq: calls $1
*** FLOP *** [Kc 9h Qh]
Galileomax: checks
Respad Gammeing: bets $5.93
ArfanTariq: calls $5.93
ishuha: folds
Galileomax: folds
*** TURN *** [Kc 9h Qh] [7s]
Respad Gammeing: bets $5.79
ArfanTariq: calls $5.79
*** RIVER *** [Kc 9h Qh 7s] [9d]
Respad Gammeing: bets $35.70
ArfanTariq: calls $26.86 and is all-in
Uncalled bet ($8.84) returned to Respad Gammeing
*** SHOW DOWN ***
Respad Gammeing: shows [Qs 9s] (a full house, Nines full of Queens)
ArfanTariq: shows [Kh 6c] (two pair, Kings and Nines)
Respad Gammeing collected $81.41 from pot
*** SUMMARY ***
Total pot $83.41 | Rake $2
Board [Kc 9h Qh 7s 9d]
Seat 1: Respad Gammeing showed [Qs 9s] and won ($81.41) with a full house, Nines full of Queens
Seat 2: ArfanTariq showed [Kh 6c] and lost with two pair, Kings and Nines
Seat 3: ishuha folded on the Flop
Seat 4: Glushchenko (button) folded before Flop (didn't bet)
Seat 5: Clamfish0 (small blind) folded before Flop
Seat 6: Galileomax (big blind) folded on the Flop


PokerStars Hand #208961094396:  Hold'em No Limit ($0.25/$0.50 USD) - 2020/02/07 21:39:27 ET
Table 'Aaltje III' 6-max Seat #6 is the button
Seat 1: Respad Gammeing ($270.67 in chips)
Seat 3: ishuha ($50.75 in chips)
Seat 4: Glushchenko ($50.55 in chips)
Seat 5: Clamfish0 ($90.95 in chips)
Seat 6: Galileomax ($35.87 in chips)
Respad Gammeing: posts small blind $0.25
ishuha: posts big blind $0.50
*** HOLE CARDS ***
Glushchenko: folds
Clamfish0: folds
Galileomax: folds
Respad Gammeing: raises $6.25 to $6.75
ishuha: folds
Uncalled bet ($6.25) returned to Respad Gammeing
Respad Gammeing collected $1 from pot
*** SUMMARY ***
Total pot $1 | Rake $0
Seat 1: Respad Gammeing (small blind) collected ($1)
Seat 3: ishuha (big blind) folded before Flop
Seat 4: Glushchenko folded before Flop (didn't bet)
Seat 5: Clamfish0 folded before Flop (didn't bet)
Seat 6: Galileomax (button) folded before Flop (didn't bet)


PokerStars Hand #208961070121:  Hold'em No Limit ($0.25/$0.50 USD) - 2020/02/07 21:39:09 ET
Table 'Aaltje III' 6-max Seat #5 is the button
Seat 1: Respad Gammeing ($271.17 in chips)
Seat 3: ishuha ($50 in chips)
Seat 4: Glushchenko ($50.55 in chips)
Seat 5: Clamfish0 ($90.95 in chips)
Seat 6: Galileomax ($36.12 in chips)
Galileomax: posts small blind $0.25
Respad Gammeing: posts big blind $0.50
*** HOLE CARDS ***
ishuha: raises $0.50 to $1
Glushchenko: folds
Clamfish0: folds
Galileomax: folds
Respad Gammeing: folds
Uncalled bet ($0.50) returned to ishuha
ishuha collected $1.25 from pot
ishuha: doesn't show hand
*** SUMMARY ***
Total pot $1.25 | Rake $0
Seat 1: Respad Gammeing (big blind) folded before Flop
Seat 3: ishuha collected ($1.25)
Seat 4: Glushchenko folded before Flop (didn't bet)
Seat 5: Clamfish0 (button) folded before Flop (didn't bet)
Seat 6: Galileomax (small blind) folded before Flop


PokerStars Hand #208961100600:  Hold'em No Limit ($0.25/$0.50 USD) - 2020/02/07 21:39:50 ET
Table 'Aaltje III' 6-max Seat #1 is the button
Seat 1: Respad Gammeing ($271.17 in chips)
Seat 3: ishuha ($50.25 in chips)
Seat 5: Clamfish0 ($90.95 in chips)
Seat 6: Galileomax ($35.87 in chips)
ishuha: posts small blind $0.25
Clamfish0: posts big blind $0.50
*** HOLE CARDS ***
Galileomax: folds
Respad Gammeing: raises $0.50 to $1
ishuha: folds
Clamfish0: calls $0.50
*** FLOP *** [6h Js 5s]
Clamfish0: checks
Respad Gammeing: bets $0.97
Clamfish0: calls $0.97
*** TURN *** [6h Js 5s] [Kd]
Clamfish0: checks
Respad Gammeing: checks
*** RIVER *** [6h Js 5s Kd] [4h]
Clamfish0: checks
Respad Gammeing: checks
*** SHOW DOWN ***
Clamfish0: shows [8c As] (high card Ace)
Respad Gammeing: shows [6c Ad] (a pair of Sixes)
Respad Gammeing collected $3.98 from pot
*** SUMMARY ***
Total pot $4.19 | Rake $0.21
Board [6h Js 5s Kd 4h]
Seat 1: Respad Gammeing (button) showed [6c Ad] and won ($3.98) with a pair of Sixes
Seat 3: ishuha (small blind) folded before Flop
Seat 5: Clamfish0 (big blind) showed [8c As] and lost with high card Ace
Seat 6: Galileomax folded before Flop (didn't bet)


PokerStars Hand #208961129000:  Hold'em No Limit ($0.25/$0.50 USD) - 2020/02/07 21:41:31 ET
Table 'Aaltje III' 6-max Seat #6 is the button
Seat 3: ishuha ($50 in chips)
Seat 5: Clamfish0 ($90.73 in chips)
Seat 6: Galileomax ($35.12 in chips)
ishuha: posts small blind $0.25
Clamfish0: posts big blind $0.50
*** HOLE CARDS ***
Galileomax: folds
ishuha: folds
Uncalled bet ($0.25) returned to Clamfish0
Clamfish0 collected $0.50 from pot
Clamfish0: doesn't show hand
*** SUMMARY ***
Total pot $0.50 | Rake $0
Seat 3: ishuha (small blind) folded before Flop
Seat 5: Clamfish0 (big blind) collected ($0.50)
Seat 6: Galileomax (button) folded before Flop (didn't bet)


PokerStars Hand #208961124377:  Hold'em No Limit ($0.25/$0.50 USD) - 2020/02/07 21:41:15 ET
Table 'Aaltje III' 6-max Seat #5 is the button
Seat 3: ishuha ($50 in chips)
Seat 5: Clamfish0 ($89.98 in chips)
Seat 6: Galileomax ($35.37 in chips)
Galileomax: posts small blind $0.25
ishuha: posts big blind $0.50
*** HOLE CARDS ***
Respad Gammeing leaves the table
Clamfish0: raises $0.83 to $1.33
Galileomax: folds
ishuha: folds
Uncalled bet ($0.83) returned to Clamfish0
Clamfish0 collected $1.25 from pot
Clamfish0: doesn't show hand
*** SUMMARY ***
Total pot $1.25 | Rake $0
Seat 3: ishuha (big blind) folded before Flop
Seat 5: Clamfish0 (button) collected ($1.25)
Seat 6: Galileomax (small blind) folded before Flop


PokerStars Hand #208961116279:  Hold'em No Limit ($0.25/$0.50 USD) - 2020/02/07 21:40:46 ET
Table 'Aaltje III' 6-max Seat #3 is the button
Seat 1: Respad Gammeing ($273.18 in chips)
Seat 3: ishuha ($50 in chips)
Seat 5: Clamfish0 ($88.98 in chips)
Seat 6: Galileomax ($35.87 in chips)
Clamfish0: posts small blind $0.25
Galileomax: posts big blind $0.50
*** HOLE CARDS ***
Respad Gammeing: calls $0.50
ishuha: folds
Clamfish0: raises $2.04 to $2.54
Galileomax: folds
Respad Gammeing: folds
Uncalled bet ($2.04) returned to Clamfish0
Clamfish0 collected $1.50 from pot
Clamfish0: doesn't show hand
*** SUMMARY ***
Total pot $1.50 | Rake $0
Seat 1: Respad Gammeing folded before Flop
Seat 3: ishuha (button) folded before Flop (didn't bet)
Seat 5: Clamfish0 (small blind) collected ($1.50)
Seat 6: Galileomax (big blind) folded before Flop


PokerStars Hand #208961133631:  Hold'em No Limit ($0.25/$0.50 USD) - 2020/02/07 21:41:48 ET
Table 'Aaltje III' 6-max Seat #3 is the button
Seat 3: ishuha ($50 in chips)
Seat 5: Clamfish0 ($90.98 in chips)
Seat 6: Galileomax ($35.12 in chips)
Clamfish0: posts small blind $0.25
Galileomax: posts big blind $0.50
*** HOLE CARDS ***
ishuha: folds
Clamfish0: raises $0.70 to $1.20
Galileomax: folds
Uncalled bet ($0.70) returned to Clamfish0
Clamfish0 collected $1 from pot
Clamfish0: doesn't show hand
*** SUMMARY ***
Total pot $1 | Rake $0
Seat 3: ishuha (button) folded before Flop (didn't bet)
Seat 5: Clamfish0 (small blind) collected ($1)
Seat 6: Galileomax (big blind) folded before Flop


PokerStars Hand #208961137164:  Hold'em No Limit ($0.25/$0.50 USD) - 2020/02/07 21:42:01 ET
Table 'Aaltje III' 6-max Seat #5 is the button
Seat 3: ishuha ($50 in chips)
Seat 5: Clamfish0 ($91.48 in chips)
Seat 6: Galileomax ($34.62 in chips)
Galileomax: posts small blind $0.25
ishuha: posts big blind $0.50
Glushchenko: sits out
*** HOLE CARDS ***
Clamfish0: folds
Galileomax: calls $0.25
ishuha: raises $1 to $1.50
é=mc² joins the table at seat #1
é=mc² leaves the table
Galileomax: calls $1
*** FLOP *** [4d Ac 6d]
Galileomax: checks
ishuha: bets $1
Galileomax: raises $1 to $2
Meskalita joins the table at seat #1
Glushchenko leaves the table
ishuha: folds
Uncalled bet ($1) returned to Galileomax
Galileomax collected $4.75 from pot
Galileomax: doesn't show hand
*** SUMMARY ***
Total pot $5 | Rake $0.25
Board [4d Ac 6d]
Seat 3: ishuha (big blind) folded on the Flop
Seat 5: Clamfish0 (button) folded before Flop (didn't bet)
Seat 6: Galileomax (small blind) collected ($4.75)


PokerStars Hand #208961149496:  Hold'em No Limit ($0.25/$0.50 USD) - 2020/02/07 21:42:45 ET
Table 'Aaltje III' 6-max Seat #6 is the button
Seat 3: ishuha ($50 in chips)
Seat 5: Clamfish0 ($91.48 in chips)
Seat 6: Galileomax ($36.87 in chips)
ishuha: posts small blind $0.25
Clamfish0: posts big blind $0.50
*** HOLE CARDS ***
Galileomax: folds
Meskalita leaves the table
ishuha: folds
Uncalled bet ($0.25) returned to Clamfish0
Clamfish0 collected $0.50 from pot
*** SUMMARY ***
Total pot $0.50 | Rake $0
Seat 3: ishuha (small blind) folded before Flop
Seat 5: Clamfish0 (big blind) collected ($0.50)
Seat 6: Galileomax (button) folded before Flop (didn't bet)


PokerStars Hand #208961152689:  Hold'em No Limit ($0.25/$0.50 USD) - 2020/02/07 21:42:56 ET
Table 'Aaltje III' 6-max Seat #3 is the button
Seat 3: ishuha ($50 in chips)
Seat 5: Clamfish0 ($91.73 in chips)
Seat 6: Galileomax ($36.87 in chips)
Clamfish0: posts small blind $0.25
Galileomax: posts big blind $0.50
*** HOLE CARDS ***
ishuha: raises $0.75 to $1.25
Clamfish0: folds
Galileomax: calls $0.75
*** FLOP *** [5c 3d 4s]
Galileomax: checks
ishuha: checks
*** TURN *** [5c 3d 4s] [3s]
Galileomax: bets $2
ishuha: calls $2
*** RIVER *** [5c 3d 4s 3s] [Qd]
Galileomax: bets $3.62
ishuha: folds
Uncalled bet ($3.62) returned to Galileomax
Galileomax collected $6.41 from pot
Galileomax: doesn't show hand
*** SUMMARY ***
Total pot $6.75 | Rake $0.34
Board [5c 3d 4s 3s Qd]
Seat 3: ishuha (button) folded on the River
Seat 5: Clamfish0 (small blind) folded before Flop
Seat 6: Galileomax (big blind) collected ($6.41)


PokerStars Hand #208961215573:  Hold'em No Limit ($0.25/$0.50 USD) - 2020/02/07 21:46:42 ET
Table 'Aaltje III' 6-max Seat #3 is the button
Seat 1: yunteng ($47.75 in chips)
Seat 3: dragu419 ($52.88 in chips)
Seat 5: Clamfish0 ($90.98 in chips)
Seat 6: edidaz ($50 in chips)
Clamfish0: posts small blind $0.25
edidaz: posts big blind $0.50
reginaph: sits out
*** HOLE CARDS ***
yunteng: folds
dragu419: folds
Clamfish0: calls $0.25
edidaz: raises $1.75 to $2.25
Flyyguyy403 joins the table at seat #4
Clamfish0: raises $7.12 to $9.37
edidaz: folds
Uncalled bet ($7.12) returned to Clamfish0
Clamfish0 collected $4.50 from pot
Clamfish0: doesn't show hand
*** SUMMARY ***
Total pot $4.50 | Rake $0
Seat 1: yunteng folded before Flop (didn't bet)
Seat 3: dragu419 (button) folded before Flop (didn't bet)
Seat 5: Clamfish0 (small blind) collected ($4.50)
Seat 6: edidaz (big blind) folded before Flop


PokerStars Hand #208961193266:  Hold'em No Limit ($0.25/$0.50 USD) - 2020/02/07 21:45:22 ET
Table 'Aaltje III' 6-max Seat #5 is the button
Seat 1: yunteng ($50.25 in chips)
Seat 3: dragu419 ($50 in chips)
Seat 5: Clamfish0 ($91.48 in chips)
yunteng: posts small blind $0.25
dragu419: posts big blind $0.50
*** HOLE CARDS ***
Clamfish0: folds
yunteng: raises $0.75 to $1.25
dragu419: calls $0.75
*** FLOP *** [Ad 4c Jc]
yunteng: checks
dragu419: checks
*** TURN *** [Ad 4c Jc] [Ks]
yunteng: checks
dragu419: checks
*** RIVER *** [Ad 4c Jc Ks] [2d]
yunteng: checks
dragu419: checks
*** SHOW DOWN ***
yunteng: shows [8h 9c] (high card Ace)
dragu419: shows [7c 7d] (a pair of Sevens)
dragu419 collected $2.38 from pot
*** SUMMARY ***
Total pot $2.50 | Rake $0.12
Board [Ad 4c Jc Ks 2d]
Seat 1: yunteng (small blind) showed [8h 9c] and lost with high card Ace
Seat 3: dragu419 (big blind) showed [7c 7d] and won ($2.38) with a pair of Sevens
Seat 5: Clamfish0 (button) folded before Flop (didn't bet)


PokerStars Hand #208961209036:  Hold'em No Limit ($0.25/$0.50 USD) - 2020/02/07 21:46:19 ET
Table 'Aaltje III' 6-max Seat #1 is the button
Seat 1: yunteng ($49 in chips)
Seat 3: dragu419 ($51.13 in chips)
Seat 5: Clamfish0 ($91.48 in chips)
dragu419: posts small blind $0.25
Clamfish0: posts big blind $0.50
*** HOLE CARDS ***
yunteng: raises $0.75 to $1.25
dragu419: raises $3.05 to $4.30
Clamfish0: folds
reginaph joins the table at seat #2
edidaz joins the table at seat #6
yunteng: folds
Uncalled bet ($3.05) returned to dragu419
dragu419 collected $3 from pot
dragu419: doesn't show hand
*** SUMMARY ***
Total pot $3 | Rake $0
Seat 1: yunteng (button) folded before Flop
Seat 3: dragu419 (small blind) collected ($3)
Seat 5: Clamfish0 (big blind) folded before Flop


PokerStars Hand #208961223513:  Hold'em No Limit ($0.25/$0.50 USD) - 2020/02/07 21:47:11 ET
Table 'Aaltje III' 6-max Seat #5 is the button
Seat 1: yunteng ($47.75 in chips)
Seat 3: dragu419 ($52.88 in chips)
Seat 4: Flyyguyy403 ($50 in chips)
Seat 5: Clamfish0 ($93.23 in chips)
Seat 6: edidaz ($50 in chips)
edidaz: posts small blind $0.25
yunteng: posts big blind $0.50
reginaph: sits out
Flyyguyy403: posts big blind $0.50
*** HOLE CARDS ***
dragu419: folds
Flyyguyy403: checks
Clamfish0: folds
edidaz: calls $0.25
yunteng: checks
*** FLOP *** [7s 5s 2h]
edidaz: checks
yunteng: checks
Flyyguyy403: checks
*** TURN *** [7s 5s 2h] [9h]
edidaz: checks
yunteng: bets $0.78
Flyyguyy403: calls $0.78
edidaz: calls $0.78
*** RIVER *** [7s 5s 2h 9h] [Kd]
edidaz: checks
yunteng: bets $2.01
Flyyguyy403: raises $2.01 to $4.02
edidaz: folds
yunteng: calls $2.01
*** SHOW DOWN ***
Flyyguyy403: shows [Kh 9d] (two pair, Kings and Nines)
yunteng: mucks hand
Flyyguyy403 collected $11.29 from pot
*** SUMMARY ***
Total pot $11.88 | Rake $0.59
Board [7s 5s 2h 9h Kd]
Seat 1: yunteng (big blind) mucked
Seat 3: dragu419 folded before Flop (didn't bet)
Seat 4: Flyyguyy403 showed [Kh 9d] and won ($11.29) with two pair, Kings and Nines
Seat 5: Clamfish0 (button) folded before Flop (didn't bet)
Seat 6: edidaz (small blind) folded on the River


PokerStars Hand #208961239136:  Hold'em No Limit ($0.25/$0.50 USD) - 2020/02/07 21:48:08 ET
Table 'Aaltje III' 6-max Seat #6 is the button
Seat 1: yunteng ($42.45 in chips)
Seat 2: reginaph ($50 in chips)
Seat 3: dragu419 ($52.88 in chips)
Seat 4: Flyyguyy403 ($55.99 in chips)
Seat 5: Clamfish0 ($93.23 in chips)
Seat 6: edidaz ($50 in chips)
yunteng: posts small blind $0.25
reginaph: posts big blind $0.50
*** HOLE CARDS ***
dragu419: folds
Flyyguyy403: calls $0.50
dragu419 leaves the table
Clamfish0: folds
edidaz: folds
yunteng: folds
reginaph: checks
*** FLOP *** [6h 6d 4d]
reginaph: checks
Flyyguyy403: checks
*** TURN *** [6h 6d 4d] [7h]
reginaph: bets $0.74
Flyyguyy403: folds
Uncalled bet ($0.74) returned to reginaph
MARGARCIA09 joins the table at seat #3
reginaph collected $1.19 from pot
reginaph: doesn't show hand
*** SUMMARY ***
Total pot $1.25 | Rake $0.06
Board [6h 6d 4d 7h]
Seat 1: yunteng (small blind) folded before Flop
Seat 2: reginaph (big blind) collected ($1.19)
Seat 3: dragu419 folded before Flop (didn't bet)
Seat 4: Flyyguyy403 folded on the Turn
Seat 5: Clamfish0 folded before Flop (didn't bet)
Seat 6: edidaz (button) folded before Flop (didn't bet)


PokerStars Hand #208961248626:  Hold'em No Limit ($0.25/$0.50 USD) - 2020/02/07 21:48:42 ET
Table 'Aaltje III' 6-max Seat #1 is the button
Seat 1: yunteng ($50 in chips)
Seat 2: reginaph ($50.69 in chips)
Seat 3: MARGARCIA09 ($50 in chips)
Seat 4: Flyyguyy403 ($55.49 in chips)
Seat 5: Clamfish0 ($93.23 in chips)
Seat 6: edidaz ($50 in chips)
reginaph: posts small blind $0.25
MARGARCIA09: posts big blind $0.50
*** HOLE CARDS ***
Flyyguyy403: folds
Clamfish0: folds
edidaz: folds
yunteng: raises $0.75 to $1.25
reginaph: folds
MARGARCIA09: calls $0.75
*** FLOP *** [Qh 7d Ah]
MARGARCIA09: checks
yunteng: bets $1.44
MARGARCIA09: folds
Uncalled bet ($1.44) returned to yunteng
yunteng collected $2.61 from pot
yunteng: doesn't show hand
*** SUMMARY ***
Total pot $2.75 | Rake $0.14
Board [Qh 7d Ah]
Seat 1: yunteng (button) collected ($2.61)
Seat 2: reginaph (small blind) folded before Flop
Seat 3: MARGARCIA09 (big blind) folded on the Flop
Seat 4: Flyyguyy403 folded before Flop (didn't bet)
Seat 5: Clamfish0 folded before Flop (didn't bet)
Seat 6: edidaz folded before Flop (didn't bet)


PokerStars Hand #208961259763:  Hold'em No Limit ($0.25/$0.50 USD) - 2020/02/07 21:49:23 ET
Table 'Aaltje III' 6-max Seat #3 is the button
Seat 1: yunteng ($51.36 in chips)
Seat 2: reginaph ($50.44 in chips)
Seat 3: MARGARCIA09 ($50 in chips)
Seat 4: Flyyguyy403 ($55.74 in chips)
Flyyguyy403: posts small blind $0.25
Clamfish0: is sitting out
edidaz: is sitting out
yunteng: posts big blind $0.50
*** HOLE CARDS ***
edidaz leaves the table
reginaph: folds
MARGARCIA09: raises $1 to $1.50
Flyyguyy403: folds
yunteng: calls $1
*** FLOP *** [5d 4d 6c]
yunteng: checks
MARGARCIA09: bets $1.64
yunteng: folds
Uncalled bet ($1.64) returned to MARGARCIA09
MARGARCIA09 collected $3.09 from pot
MARGARCIA09: doesn't show hand
*** SUMMARY ***
Total pot $3.25 | Rake $0.16
Board [5d 4d 6c]
Seat 1: yunteng (big blind) folded on the Flop
Seat 2: reginaph folded before Flop (didn't bet)
Seat 3: MARGARCIA09 (button) collected ($3.09)
Seat 4: Flyyguyy403 (small blind) folded before Flop


PokerStars Hand #208961257132:  Hold'em No Limit ($0.25/$0.50 USD) - 2020/02/07 21:49:13 ET
Table 'Aaltje III' 6-max Seat #2 is the button
Seat 1: yunteng ($51.36 in chips)
Seat 2: reginaph ($50.44 in chips)
Seat 3: MARGARCIA09 ($50 in chips)
Seat 4: Flyyguyy403 ($55.49 in chips)
Seat 5: Clamfish0 ($93.23 in chips)
Seat 6: edidaz ($50 in chips)
MARGARCIA09: posts small blind $0.25
Flyyguyy403: posts big blind $0.50
*** HOLE CARDS ***
Clamfish0: folds
edidaz: folds
yunteng: folds
reginaph: folds
MARGARCIA09: folds
Uncalled bet ($0.25) returned to Flyyguyy403
Flyyguyy403 collected $0.50 from pot
Flyyguyy403: doesn't show hand
*** SUMMARY ***
Total pot $0.50 | Rake $0
Seat 1: yunteng folded before Flop (didn't bet)
Seat 2: reginaph (button) folded before Flop (didn't bet)
Seat 3: MARGARCIA09 (small blind) folded before Flop
Seat 4: Flyyguyy403 (big blind) collected ($0.50)
Seat 5: Clamfish0 folded before Flop (didn't bet)
Seat 6: edidaz folded before Flop (didn't bet)


PokerStars Hand #208961271389:  Hold'em No Limit ($0.25/$0.50 USD) - 2020/02/07 21:49:48 ET
Table 'Aaltje III' 6-max Seat #4 is the button
Seat 1: yunteng ($49.86 in chips)
Seat 2: reginaph ($50.44 in chips)
Seat 3: MARGARCIA09 ($51.59 in chips)
Seat 4: Flyyguyy403 ($55.49 in chips)
yunteng: posts small blind $0.25
reginaph: posts big blind $0.50
*** HOLE CARDS ***
MARGARCIA09: raises $1 to $1.50
Flyyguyy403: folds
yunteng: folds
G.Andrei95 joins the table at seat #6
reginaph: folds
Uncalled bet ($1) returned to MARGARCIA09
MARGARCIA09 collected $1.25 from pot
MARGARCIA09: doesn't show hand
*** SUMMARY ***
Total pot $1.25 | Rake $0
Seat 1: yunteng (small blind) folded before Flop
Seat 2: reginaph (big blind) folded before Flop
Seat 3: MARGARCIA09 collected ($1.25)
Seat 4: Flyyguyy403 (button) folded before Flop (didn't bet)


PokerStars Hand #208961280437:  Hold'em No Limit ($0.25/$0.50 USD) - 2020/02/07 21:50:21 ET
Table 'Aaltje III' 6-max Seat #1 is the button
Seat 1: yunteng ($49.61 in chips)
Seat 2: reginaph ($50 in chips)
Seat 3: MARGARCIA09 ($52.34 in chips)
Seat 4: Flyyguyy403 ($55.49 in chips)
reginaph: posts small blind $0.25
MARGARCIA09: posts big blind $0.50
G.Andrei95: sits out
*** HOLE CARDS ***
Flyyguyy403: folds
yunteng: raises $0.75 to $1.25
reginaph: folds
MARGARCIA09: folds
Uncalled bet ($0.75) returned to yunteng
yunteng collected $1.25 from pot
yunteng: doesn't show hand
*** SUMMARY ***
Total pot $1.25 | Rake $0
Seat 1: yunteng (button) collected ($1.25)
Seat 2: reginaph (small blind) folded before Flop
Seat 3: MARGARCIA09 (big blind) folded before Flop
Seat 4: Flyyguyy403 folded before Flop (didn't bet)


PokerStars Hand #208961297576:  Hold'em No Limit ($0.25/$0.50 USD) - 2020/02/07 21:51:24 ET
Table 'Aaltje III' 6-max Seat #3 is the button
Seat 1: yunteng ($50.36 in chips)
Seat 2: reginaph ($51.23 in chips)
Seat 3: MARGARCIA09 ($51.59 in chips)
Seat 4: Flyyguyy403 ($54.39 in chips)
Seat 5: Nacho.N.A260 ($50 in chips)
Flyyguyy403: posts small blind $0.25
Nacho.N.A260: posts big blind $0.50
G.Andrei95: sits out
*** HOLE CARDS ***
yunteng: folds
reginaph: folds
MARGARCIA09: folds
Flyyguyy403: folds
Uncalled bet ($0.25) returned to Nacho.N.A260
Nacho.N.A260 collected $0.50 from pot
Nacho.N.A260: doesn't show hand
*** SUMMARY ***
Total pot $0.50 | Rake $0
Seat 1: yunteng folded before Flop (didn't bet)
Seat 2: reginaph folded before Flop (didn't bet)
Seat 3: MARGARCIA09 (button) folded before Flop (didn't bet)
Seat 4: Flyyguyy403 (small blind) folded before Flop
Seat 5: Nacho.N.A260 (big blind) collected ($0.50)


PokerStars Hand #208961284271:  Hold'em No Limit ($0.25/$0.50 USD) - 2020/02/07 21:50:35 ET
Table 'Aaltje III' 6-max Seat #2 is the button
Seat 1: yunteng ($50.36 in chips)
Seat 2: reginaph ($50 in chips)
Seat 3: MARGARCIA09 ($51.84 in chips)
Seat 4: Flyyguyy403 ($55.49 in chips)
MARGARCIA09: posts small blind $0.25
Flyyguyy403: posts big blind $0.50
G.Andrei95: sits out
*** HOLE CARDS ***
yunteng: folds
reginaph: raises $0.60 to $1.10
MARGARCIA09: folds
Flyyguyy403: calls $0.60
*** FLOP *** [Th Ad 5d]
Flyyguyy403: checks
reginaph: bets $1.62
Clamfish0 leaves the table
Nacho.N.A260 joins the table at seat #5
Flyyguyy403: folds
Uncalled bet ($1.62) returned to reginaph
reginaph collected $2.33 from pot
reginaph: doesn't show hand
*** SUMMARY ***
Total pot $2.45 | Rake $0.12
Board [Th Ad 5d]
Seat 1: yunteng folded before Flop (didn't bet)
Seat 2: reginaph (button) collected ($2.33)
Seat 3: MARGARCIA09 (small blind) folded before Flop
Seat 4: Flyyguyy403 (big blind) folded on the Flop


PokerStars Hand #208961301524:  Hold'em No Limit ($0.25/$0.50 USD) - 2020/02/07 21:51:38 ET
Table 'Aaltje III' 6-max Seat #4 is the button
Seat 1: yunteng ($50.36 in chips)
Seat 2: reginaph ($51.23 in chips)
Seat 3: MARGARCIA09 ($51.59 in chips)
Seat 4: Flyyguyy403 ($54.14 in chips)
Seat 5: Nacho.N.A260 ($50.25 in chips)
Seat 6: G.Andrei95 ($50 in chips)
Nacho.N.A260: posts small blind $0.25
G.Andrei95: posts big blind $0.50
*** HOLE CARDS ***
yunteng: folds
reginaph: folds
MARGARCIA09: folds
Flyyguyy403: folds
Nacho.N.A260: raises $1 to $1.50
G.Andrei95: raises $3 to $4.50
Nacho.N.A260: calls $3
*** FLOP *** [Qd 7s 6d]
Nacho.N.A260: bets $3
G.Andrei95: calls $3
*** TURN *** [Qd 7s 6d] [Jd]
Nacho.N.A260: bets $7
G.Andrei95: calls $7
*** RIVER *** [Qd 7s 6d Jd] [4c]
Nacho.N.A260: bets $15
G.Andrei95: folds
Uncalled bet ($15) returned to Nacho.N.A260
Nacho.N.A260 collected $27.55 from pot
Nacho.N.A260: doesn't show hand
*** SUMMARY ***
Total pot $29 | Rake $1.45
Board [Qd 7s 6d Jd 4c]
Seat 1: yunteng folded before Flop (didn't bet)
Seat 2: reginaph folded before Flop (didn't bet)
Seat 3: MARGARCIA09 folded before Flop (didn't bet)
Seat 4: Flyyguyy403 (button) folded before Flop (didn't bet)
Seat 5: Nacho.N.A260 (small blind) collected ($27.55)
Seat 6: G.Andrei95 (big blind) folded on the River


PokerStars Hand #208961323038:  Hold'em No Limit ($0.25/$0.50 USD) - 2020/02/07 21:52:57 ET
Table 'Aaltje III' 6-max Seat #5 is the button
Seat 1: yunteng ($50.36 in chips)
Seat 2: reginaph ($51.23 in chips)
Seat 3: MARGARCIA09 ($51.59 in chips)
Seat 4: Flyyguyy403 ($54.14 in chips)
Seat 5: Nacho.N.A260 ($63.30 in chips)
Seat 6: G.Andrei95 ($50 in chips)
G.Andrei95: posts small blind $0.25
yunteng: posts big blind $0.50
*** HOLE CARDS ***
reginaph: folds
MARGARCIA09: raises $1 to $1.50
Flyyguyy403: folds
Nacho.N.A260: folds
G.Andrei95: folds
yunteng: calls $1
*** FLOP *** [4h Td 9c]
yunteng: checks
MARGARCIA09: bets $2.32
yunteng: calls $2.32
*** TURN *** [4h Td 9c] [Qd]
yunteng: checks
MARGARCIA09: bets $5.63
yunteng: raises $8.12 to $13.75
MARGARCIA09: folds
Uncalled bet ($8.12) returned to yunteng
yunteng collected $18.19 from pot
yunteng: doesn't show hand
*** SUMMARY ***
Total pot $19.15 | Rake $0.96
Board [4h Td 9c Qd]
Seat 1: yunteng (big blind) collected ($18.19)
Seat 2: reginaph folded before Flop (didn't bet)
Seat 3: MARGARCIA09 folded on the Turn
Seat 4: Flyyguyy403 folded before Flop (didn't bet)
Seat 5: Nacho.N.A260 (button) folded before Flop (didn't bet)
Seat 6: G.Andrei95 (small blind) folded before Flop


PokerStars Hand #208961368194:  Hold'em No Limit ($0.25/$0.50 USD) - 2020/02/07 21:55:24 ET
Table 'Aaltje III' 6-max Seat #1 is the button
Seat 1: yunteng ($58.85 in chips)
Seat 2: reginaph ($51.92 in chips)
Seat 3: MARGARCIA09 ($50 in chips)
Seat 4: Flyyguyy403 ($53.64 in chips)
Seat 5: Nacho.N.A260 ($63.30 in chips)
Seat 6: G.Andrei95 ($50 in chips)
reginaph: posts small blind $0.25
MARGARCIA09: posts big blind $0.50
*** HOLE CARDS ***
Flyyguyy403: calls $0.50
Nacho.N.A260: folds
G.Andrei95: folds
yunteng: folds
reginaph: folds
MARGARCIA09: checks
*** FLOP *** [Qs 7c 9c]
MARGARCIA09: checks
Flyyguyy403: checks
*** TURN *** [Qs 7c 9c] [Kh]
MARGARCIA09: checks
Flyyguyy403: checks
*** RIVER *** [Qs 7c 9c Kh] [Kd]
MARGARCIA09: bets $0.50
Flyyguyy403: folds
Uncalled bet ($0.50) returned to MARGARCIA09
MARGARCIA09 collected $1.19 from pot
MARGARCIA09: doesn't show hand
*** SUMMARY ***
Total pot $1.25 | Rake $0.06
Board [Qs 7c 9c Kh Kd]
Seat 1: yunteng (button) folded before Flop (didn't bet)
Seat 2: reginaph (small blind) folded before Flop
Seat 3: MARGARCIA09 (big blind) collected ($1.19)
Seat 4: Flyyguyy403 folded on the River
Seat 5: Nacho.N.A260 folded before Flop (didn't bet)
Seat 6: G.Andrei95 folded before Flop (didn't bet)


PokerStars Hand #208961349472:  Hold'em No Limit ($0.25/$0.50 USD) - 2020/02/07 21:54:35 ET
Table 'Aaltje III' 6-max Seat #6 is the button
Seat 1: yunteng ($59.10 in chips)
Seat 2: reginaph ($51.23 in chips)
Seat 3: MARGARCIA09 ($50 in chips)
Seat 4: Flyyguyy403 ($54.14 in chips)
Seat 5: Nacho.N.A260 ($63.30 in chips)
Seat 6: G.Andrei95 ($50 in chips)
yunteng: posts small blind $0.25
reginaph: posts big blind $0.50
*** HOLE CARDS ***
MARGARCIA09: folds
Flyyguyy403: calls $0.50
Nacho.N.A260: folds
G.Andrei95: folds
yunteng: folds
reginaph: checks
*** FLOP *** [Qs 8h Js]
reginaph: checks
Flyyguyy403: checks
*** TURN *** [Qs 8h Js] [As]
reginaph: checks
Flyyguyy403: checks
*** RIVER *** [Qs 8h Js As] [Ts]
reginaph: checks
Flyyguyy403: checks
*** SHOW DOWN ***
reginaph: shows [5s 9h] (a flush, Ace high)
Flyyguyy403: mucks hand
reginaph collected $1.19 from pot
*** SUMMARY ***
Total pot $1.25 | Rake $0.06
Board [Qs 8h Js As Ts]
Seat 1: yunteng (small blind) folded before Flop
Seat 2: reginaph (big blind) showed [5s 9h] and won ($1.19) with a flush, Ace high
Seat 3: MARGARCIA09 folded before Flop (didn't bet)
Seat 4: Flyyguyy403 mucked
Seat 5: Nacho.N.A260 folded before Flop (didn't bet)
Seat 6: G.Andrei95 (button) folded before Flop (didn't bet)


PokerStars Hand #208961376317:  Hold'em No Limit ($0.25/$0.50 USD) - 2020/02/07 21:56:00 ET
Table 'Aaltje III' 6-max Seat #2 is the button
Seat 1: yunteng ($58.85 in chips)
Seat 2: reginaph ($51.67 in chips)
Seat 3: MARGARCIA09 ($50.69 in chips)
Seat 4: Flyyguyy403 ($53.14 in chips)
Seat 5: Nacho.N.A260 ($63.30 in chips)
Seat 6: G.Andrei95 ($50 in chips)
MARGARCIA09: posts small blind $0.25
Flyyguyy403: posts big blind $0.50
*** HOLE CARDS ***
Nacho.N.A260: folds
G.Andrei95: folds
yunteng: folds
reginaph: folds
MARGARCIA09: raises $0.75 to $1.25
Flyyguyy403: calls $0.75
*** FLOP *** [Js 6h 2c]
MARGARCIA09: checks
Flyyguyy403: checks
*** TURN *** [Js 6h 2c] [Th]
MARGARCIA09: bets $3.57
Flyyguyy403: folds
Uncalled bet ($3.57) returned to MARGARCIA09
MARGARCIA09 collected $2.38 from pot
MARGARCIA09: doesn't show hand
*** SUMMARY ***
Total pot $2.50 | Rake $0.12
Board [Js 6h 2c Th]
Seat 1: yunteng folded before Flop (didn't bet)
Seat 2: reginaph (button) folded before Flop (didn't bet)
Seat 3: MARGARCIA09 (small blind) collected ($2.38)
Seat 4: Flyyguyy403 (big blind) folded on the Turn
Seat 5: Nacho.N.A260 folded before Flop (didn't bet)
Seat 6: G.Andrei95 folded before Flop (didn't bet)


PokerStars Hand #208961387050:  Hold'em No Limit ($0.25/$0.50 USD) - 2020/02/07 21:56:49 ET
Table 'Aaltje III' 6-max Seat #3 is the button
Seat 1: yunteng ($58.85 in chips)
Seat 2: reginaph ($51.67 in chips)
Seat 3: MARGARCIA09 ($51.82 in chips)
Seat 4: Flyyguyy403 ($51.89 in chips)
Seat 5: Nacho.N.A260 ($63.30 in chips)
Seat 6: G.Andrei95 ($50 in chips)
Flyyguyy403: posts small blind $0.25
Nacho.N.A260: posts big blind $0.50
*** HOLE CARDS ***
G.Andrei95: folds
yunteng: folds
reginaph: raises $0.75 to $1.25
MARGARCIA09: folds
Flyyguyy403: folds
Nacho.N.A260: calls $0.75
*** FLOP *** [4h Td Kd]
Nacho.N.A260: checks
reginaph: bets $0.78
Nacho.N.A260: calls $0.78
*** TURN *** [4h Td Kd] [Js]
Nacho.N.A260: checks
reginaph: checks
*** RIVER *** [4h Td Kd Js] [6s]
Nacho.N.A260: bets $3
reginaph: folds
Uncalled bet ($3) returned to Nacho.N.A260
Nacho.N.A260 collected $4.09 from pot
Nacho.N.A260: doesn't show hand
*** SUMMARY ***
Total pot $4.31 | Rake $0.22
Board [4h Td Kd Js 6s]
Seat 1: yunteng folded before Flop (didn't bet)
Seat 2: reginaph folded on the River
Seat 3: MARGARCIA09 (button) folded before Flop (didn't bet)
Seat 4: Flyyguyy403 (small blind) folded before Flop
Seat 5: Nacho.N.A260 (big blind) collected ($4.09)
Seat 6: G.Andrei95 folded before Flop (didn't bet)


PokerStars Hand #208961403889:  Hold'em No Limit ($0.25/$0.50 USD) - 2020/02/07 21:58:05 ET
Table 'Aaltje III' 6-max Seat #4 is the button
Seat 1: yunteng ($58.85 in chips)
Seat 2: reginaph ($50 in chips)
Seat 3: MARGARCIA09 ($51.82 in chips)
Seat 4: Flyyguyy403 ($51.64 in chips)
Seat 5: Nacho.N.A260 ($65.36 in chips)
Nacho.N.A260: posts small blind $0.25
G.Andrei95: is sitting out
yunteng: posts big blind $0.50
*** HOLE CARDS ***
reginaph: folds
MARGARCIA09: folds
Flyyguyy403: calls $0.50
Nacho.N.A260: folds
yunteng: checks
*** FLOP *** [4h Qh 5c]
yunteng: checks
Flyyguyy403: checks
*** TURN *** [4h Qh 5c] [4d]
yunteng: bets $0.89
Flyyguyy403: calls $0.89
*** RIVER *** [4h Qh 5c 4d] [6d]
yunteng: checks
Flyyguyy403: checks
*** SHOW DOWN ***
yunteng: shows [2h 5h] (two pair, Fives and Fours)
Flyyguyy403: mucks hand
yunteng collected $2.88 from pot
*** SUMMARY ***
Total pot $3.03 | Rake $0.15
Board [4h Qh 5c 4d 6d]
Seat 1: yunteng (big blind) showed [2h 5h] and won ($2.88) with two pair, Fives and Fours
Seat 2: reginaph folded before Flop (didn't bet)
Seat 3: MARGARCIA09 folded before Flop (didn't bet)
Seat 4: Flyyguyy403 (button) mucked
Seat 5: Nacho.N.A260 (small blind) folded before Flop


PokerStars Hand #208961414479:  Hold'em No Limit ($0.25/$0.50 USD) - 2020/02/07 21:58:52 ET
Table 'Aaltje III' 6-max Seat #5 is the button
Seat 1: yunteng ($60.34 in chips)
Seat 3: MARGARCIA09 ($51.82 in chips)
Seat 4: Flyyguyy403 ($50.25 in chips)
Seat 5: Nacho.N.A260 ($65.11 in chips)
yunteng: posts small blind $0.25
reginaph: is sitting out
MARGARCIA09: posts big blind $0.50
*** HOLE CARDS ***
reginaph leaves the table
Flyyguyy403: raises $0.50 to $1
Nacho.N.A260: folds
yunteng: folds
MARGARCIA09: calls $0.50
*** FLOP *** [3c 5d Ad]
MARGARCIA09: checks
Flyyguyy403: checks
*** TURN *** [3c 5d Ad] [8h]
MARGARCIA09: bets $1.61
Flyyguyy403: calls $1.61
*** RIVER *** [3c 5d Ad 8h] [2d]
MARGARCIA09: checks
Flyyguyy403: bets $2.50
MARGARCIA09: calls $2.50
*** SHOW DOWN ***
Flyyguyy403: shows [Qd Qh] (a pair of Queens)
MARGARCIA09: shows [Ac 7h] (a pair of Aces)
MARGARCIA09 collected $9.95 from pot
*** SUMMARY ***
Total pot $10.47 | Rake $0.52
Board [3c 5d Ad 8h 2d]
Seat 1: yunteng (small blind) folded before Flop
Seat 3: MARGARCIA09 (big blind) showed [Ac 7h] and won ($9.95) with a pair of Aces
Seat 4: Flyyguyy403 showed [Qd Qh] and lost with a pair of Queens
Seat 5: Nacho.N.A260 (button) folded before Flop (didn't bet)


PokerStars Hand #208961424829:  Hold'em No Limit ($0.25/$0.50 USD) - 2020/02/07 21:59:38 ET
Table 'Aaltje III' 6-max Seat #1 is the button
Seat 1: yunteng ($60.09 in chips)
Seat 3: MARGARCIA09 ($56.66 in chips)
Seat 4: Flyyguyy403 ($45.14 in chips)
Seat 5: Nacho.N.A260 ($65.11 in chips)
MARGARCIA09: posts small blind $0.25
Flyyguyy403: posts big blind $0.50
*** HOLE CARDS ***
Nacho.N.A260: folds
yunteng: folds
MARGARCIA09: folds
Uncalled bet ($0.25) returned to Flyyguyy403
Flyyguyy403 collected $0.50 from pot
Flyyguyy403: doesn't show hand
*** SUMMARY ***
Total pot $0.50 | Rake $0
Seat 1: yunteng (button) folded before Flop (didn't bet)
Seat 3: MARGARCIA09 (small blind) folded before Flop
Seat 4: Flyyguyy403 (big blind) collected ($0.50)
Seat 5: Nacho.N.A260 folded before Flop (didn't bet)


PokerStars Hand #208961427460:  Hold'em No Limit ($0.25/$0.50 USD) - 2020/02/07 21:59:49 ET
Table 'Aaltje III' 6-max Seat #3 is the button
Seat 1: yunteng ($60.09 in chips)
Seat 3: MARGARCIA09 ($56.41 in chips)
Seat 4: Flyyguyy403 ($50 in chips)
Seat 5: Nacho.N.A260 ($65.11 in chips)
Flyyguyy403: posts small blind $0.25
Nacho.N.A260: posts big blind $0.50
*** HOLE CARDS ***
yunteng: folds
MARGARCIA09: folds
Flyyguyy403: calls $0.25
Nacho.N.A260: checks
*** FLOP *** [Ac Jc Ah]
Flyyguyy403: checks
Nacho.N.A260: checks
*** TURN *** [Ac Jc Ah] [Ts]
Flyyguyy403: bets $1
Tigristen joins the table at seat #2
Nacho.N.A260: calls $1
*** RIVER *** [Ac Jc Ah Ts] [Qs]
Flyyguyy403: bets $2
Nacho.N.A260: raises $2.50 to $4.50
Flyyguyy403: calls $2.50
*** SHOW DOWN ***
Nacho.N.A260: shows [Kd 6d] (a straight, Ten to Ace)
Flyyguyy403: mucks hand
Nacho.N.A260 collected $11.40 from pot
*** SUMMARY ***
Total pot $12 | Rake $0.60
Board [Ac Jc Ah Ts Qs]
Seat 1: yunteng folded before Flop (didn't bet)
Seat 3: MARGARCIA09 (button) folded before Flop (didn't bet)
Seat 4: Flyyguyy403 (small blind) mucked
Seat 5: Nacho.N.A260 (big blind) showed [Kd 6d] and won ($11.40) with a straight, Ten to Ace


PokerStars Hand #208961456893:  Hold'em No Limit ($0.25/$0.50 USD) - 2020/02/07 22:01:48 ET
Table 'Aaltje III' 6-max Seat #2 is the button
Seat 2: Tigristen ($50 in chips)
Seat 3: MARGARCIA09 ($56.66 in chips)
Seat 4: Flyyguyy403 ($44 in chips)
Seat 5: Nacho.N.A260 ($71.01 in chips)
MARGARCIA09: posts small blind $0.25
Flyyguyy403: posts big blind $0.50
*** HOLE CARDS ***
Nacho.N.A260: folds
Tigristen: folds
MARGARCIA09: raises $1 to $1.50
Flyyguyy403: folds
Uncalled bet ($1) returned to MARGARCIA09
MARGARCIA09 collected $1 from pot
MARGARCIA09: doesn't show hand
*** SUMMARY ***
Total pot $1 | Rake $0
Seat 2: Tigristen (button) folded before Flop (didn't bet)
Seat 3: MARGARCIA09 (small blind) collected ($1)
Seat 4: Flyyguyy403 (big blind) folded before Flop
Seat 5: Nacho.N.A260 folded before Flop (didn't bet)


PokerStars Hand #208961447509:  Hold'em No Limit ($0.25/$0.50 USD) - 2020/02/07 22:01:13 ET
Table 'Aaltje III' 6-max Seat #4 is the button
Seat 2: Tigristen ($50 in chips)
Seat 3: MARGARCIA09 ($56.41 in chips)
Seat 4: Flyyguyy403 ($44 in chips)
Seat 5: Nacho.N.A260 ($70.51 in chips)
Nacho.N.A260: posts small blind $0.25
Tigristen: posts big blind $0.50
*** HOLE CARDS ***
MARGARCIA09: raises $1 to $1.50
Flyyguyy403: folds
Nacho.N.A260: folds
Tigristen: folds
Uncalled bet ($1) returned to MARGARCIA09
MARGARCIA09 collected $1.25 from pot
MARGARCIA09: doesn't show hand
*** SUMMARY ***
Total pot $1.25 | Rake $0
Seat 2: Tigristen (big blind) folded before Flop
Seat 3: MARGARCIA09 collected ($1.25)
Seat 4: Flyyguyy403 (button) folded before Flop (didn't bet)
Seat 5: Nacho.N.A260 (small blind) folded before Flop


PokerStars Hand #208961452132:  Hold'em No Limit ($0.25/$0.50 USD) - 2020/02/07 22:01:30 ET
Table 'Aaltje III' 6-max Seat #5 is the button
Seat 2: Tigristen ($50 in chips)
Seat 3: MARGARCIA09 ($57.16 in chips)
Seat 4: Flyyguyy403 ($44 in chips)
Seat 5: Nacho.N.A260 ($70.26 in chips)
Tigristen: posts small blind $0.25
MARGARCIA09: posts big blind $0.50
*** HOLE CARDS ***
Flyyguyy403: folds
Nacho.N.A260: raises $1 to $1.50
Tigristen: folds
Flyyguyy403 is disconnected
MARGARCIA09: folds
Uncalled bet ($1) returned to Nacho.N.A260
Nacho.N.A260 collected $1.25 from pot
Nacho.N.A260: doesn't show hand
*** SUMMARY ***
Total pot $1.25 | Rake $0
Seat 2: Tigristen (small blind) folded before Flop
Seat 3: MARGARCIA09 (big blind) folded before Flop
Seat 4: Flyyguyy403 folded before Flop (didn't bet)
Seat 5: Nacho.N.A260 (button) collected ($1.25)


PokerStars Hand #208961461532:  Hold'em No Limit ($0.25/$0.50 USD) - 2020/02/07 22:02:05 ET
Table 'Aaltje III' 6-max Seat #3 is the button
Seat 2: Tigristen ($50 in chips)
Seat 3: MARGARCIA09 ($57.16 in chips)
Seat 4: Flyyguyy403 ($43.50 in chips)
Seat 5: Nacho.N.A260 ($71.01 in chips)
Flyyguyy403: posts small blind $0.25
Nacho.N.A260: posts big blind $0.50
*** HOLE CARDS ***
Tigristen: raises $0.70 to $1.20
MARGARCIA09: folds
Flyyguyy403: folds
Nacho.N.A260: calls $0.70
*** FLOP *** [Ac 5s 7s]
Nacho.N.A260: bets $2
Tigristen: folds
Uncalled bet ($2) returned to Nacho.N.A260
Nacho.N.A260 collected $2.52 from pot
Nacho.N.A260: doesn't show hand
*** SUMMARY ***
Total pot $2.65 | Rake $0.13
Board [Ac 5s 7s]
Seat 2: Tigristen folded on the Flop
Seat 3: MARGARCIA09 (button) folded before Flop (didn't bet)
Seat 4: Flyyguyy403 (small blind) folded before Flop
Seat 5: Nacho.N.A260 (big blind) collected ($2.52)


PokerStars Hand #208961470566:  Hold'em No Limit ($0.25/$0.50 USD) - 2020/02/07 22:02:36 ET
Table 'Aaltje III' 6-max Seat #4 is the button
Seat 1: yunteng ($60.09 in chips)
Seat 2: Tigristen ($50 in chips)
Seat 3: MARGARCIA09 ($57.16 in chips)
Seat 4: Flyyguyy403 ($43.25 in chips)
Seat 5: Nacho.N.A260 ($72.33 in chips)
Nacho.N.A260: posts small blind $0.25
yunteng: posts big blind $0.50
*** HOLE CARDS ***
Tigristen: folds
MARGARCIA09: raises $1 to $1.50
Flyyguyy403: folds
Nacho.N.A260: folds
yunteng: calls $1
*** FLOP *** [2d Qh Qs]
yunteng: checks
MARGARCIA09: bets $1.02
yunteng: calls $1.02
*** TURN *** [2d Qh Qs] [Ac]
yunteng: checks
MARGARCIA09: bets $3.77
yunteng: calls $3.77
*** RIVER *** [2d Qh Qs Ac] [Ad]
yunteng: checks
MARGARCIA09: bets $9.14
yunteng: calls $9.14
*** SHOW DOWN ***
MARGARCIA09: shows [Ah 9d] (a full house, Aces full of Queens)
yunteng: shows [4d As] (a full house, Aces full of Queens)
yunteng collected $14.78 from pot
MARGARCIA09 collected $14.77 from pot
*** SUMMARY ***
Total pot $31.11 | Rake $1.56
Board [2d Qh Qs Ac Ad]
Seat 1: yunteng (big blind) showed [4d As] and won ($14.78) with a full house, Aces full of Queens
Seat 2: Tigristen folded before Flop (didn't bet)
Seat 3: MARGARCIA09 showed [Ah 9d] and won ($14.77) with a full house, Aces full of Queens
Seat 4: Flyyguyy403 (button) folded before Flop (didn't bet)
Seat 5: Nacho.N.A260 (small blind) folded before Flop


PokerStars Hand #208961517434:  Hold'em No Limit ($0.25/$0.50 USD) - 2020/02/07 22:05:21 ET
Table 'Aaltje III' 6-max Seat #1 is the button
Seat 1: yunteng ($59.19 in chips)
Seat 2: Tigristen ($50 in chips)
Seat 3: MARGARCIA09 ($56.50 in chips)
Seat 4: Flyyguyy403 ($43.25 in chips)
Seat 5: Nacho.N.A260 ($75.47 in chips)
Tigristen: posts small blind $0.25
MARGARCIA09: posts big blind $0.50
G.Andrei95: sits out
*** HOLE CARDS ***
Flyyguyy403 has timed out
Flyyguyy403: folds
Nacho.N.A260 has timed out
Nacho.N.A260: folds
yunteng: raises $0.75 to $1.25
Tigristen: folds
MARGARCIA09: calls $0.75
*** FLOP *** [5h 7h Js]
MARGARCIA09: checks
yunteng: bets $1.44
MARGARCIA09: folds
Uncalled bet ($1.44) returned to yunteng
yunteng collected $2.61 from pot
yunteng: doesn't show hand
*** SUMMARY ***
Total pot $2.75 | Rake $0.14
Board [5h 7h Js]
Seat 1: yunteng (button) collected ($2.61)
Seat 2: Tigristen (small blind) folded before Flop
Seat 3: MARGARCIA09 (big blind) folded on the Flop
Seat 4: Flyyguyy403 folded before Flop (didn't bet)
Seat 5: Nacho.N.A260 folded before Flop (didn't bet)


PokerStars Hand #208961492301:  Hold'em No Limit ($0.25/$0.50 USD) - 2020/02/07 22:03:46 ET
Table 'Aaltje III' 6-max Seat #5 is the button
Seat 1: yunteng ($59.44 in chips)
Seat 2: Tigristen ($50 in chips)
Seat 3: MARGARCIA09 ($56.50 in chips)
Seat 4: Flyyguyy403 ($43.25 in chips)
Seat 5: Nacho.N.A260 ($72.08 in chips)
yunteng: posts small blind $0.25
Tigristen: posts big blind $0.50
*** HOLE CARDS ***
MARGARCIA09: folds
Flyyguyy403: folds
Nacho.N.A260: raises $1 to $1.50
yunteng: folds
Tigristen: calls $1
*** FLOP *** [9c 6c Qs]
Tigristen: checks
Nacho.N.A260: bets $2
Tigristen: calls $2
*** TURN *** [9c 6c Qs] [7d]
Tigristen: checks
Nacho.N.A260: bets $4.50
Tigristen: folds
Uncalled bet ($4.50) returned to Nacho.N.A260
Nacho.N.A260 collected $6.89 from pot
Nacho.N.A260: doesn't show hand
*** SUMMARY ***
Total pot $7.25 | Rake $0.36
Board [9c 6c Qs 7d]
Seat 1: yunteng (small blind) folded before Flop
Seat 2: Tigristen (big blind) folded on the Turn
Seat 3: MARGARCIA09 folded before Flop (didn't bet)
Seat 4: Flyyguyy403 folded before Flop (didn't bet)
Seat 5: Nacho.N.A260 (button) collected ($6.89)


PokerStars Hand #208961532227:  Hold'em No Limit ($0.25/$0.50 USD) - 2020/02/07 22:06:16 ET
Table 'Aaltje III' 6-max Seat #2 is the button
Seat 1: yunteng ($60.55 in chips)
Seat 2: Tigristen ($50 in chips)
Seat 3: MARGARCIA09 ($55.25 in chips)
Seat 4: Flyyguyy403 ($43.25 in chips)
Seat 5: Nacho.N.A260 ($75.47 in chips)
MARGARCIA09: posts small blind $0.25
Flyyguyy403: posts big blind $0.50
G.Andrei95: sits out
*** HOLE CARDS ***
Nacho.N.A260: folds
yunteng: raises $0.75 to $1.25
Tigristen: folds
MARGARCIA09: calls $1
Flyyguyy403: calls $0.75
*** FLOP *** [Ks 7c 6d]
MARGARCIA09: checks
Flyyguyy403: checks
yunteng: checks
*** TURN *** [Ks 7c 6d] [7d]
MARGARCIA09: checks
Flyyguyy403: bets $2.50
yunteng: folds
MARGARCIA09: folds
Uncalled bet ($2.50) returned to Flyyguyy403
Flyyguyy403 collected $3.56 from pot
Flyyguyy403: doesn't show hand
*** SUMMARY ***
Total pot $3.75 | Rake $0.19
Board [Ks 7c 6d 7d]
Seat 1: yunteng folded on the Turn
Seat 2: Tigristen (button) folded before Flop (didn't bet)
Seat 3: MARGARCIA09 (small blind) folded on the Turn
Seat 4: Flyyguyy403 (big blind) collected ($3.56)
Seat 5: Nacho.N.A260 folded before Flop (didn't bet)


PokerStars Hand #208961555091:  Hold'em No Limit ($0.25/$0.50 USD) - 2020/02/07 22:07:22 ET
Table 'Aaltje III' 6-max Seat #4 is the button
Seat 1: yunteng ($59.30 in chips)
Seat 2: Tigristen ($50 in chips)
Seat 3: MARGARCIA09 ($54 in chips)
Seat 4: Flyyguyy403 ($45.31 in chips)
Seat 5: Nacho.N.A260 ($75.72 in chips)
Seat 6: G.Andrei95 ($50 in chips)
Nacho.N.A260: posts small blind $0.25
G.Andrei95: posts big blind $0.50
*** HOLE CARDS ***
yunteng: folds
Tigristen: folds
MARGARCIA09: folds
Flyyguyy403: calls $0.50
Nacho.N.A260: raises $1 to $1.50
G.Andrei95: folds
Flyyguyy403: calls $1
*** FLOP *** [5d Ad 5h]
Nacho.N.A260: checks
Flyyguyy403: bets $1.50
Nacho.N.A260: calls $1.50
*** TURN *** [5d Ad 5h] [8s]
Nacho.N.A260: checks
Flyyguyy403: checks
*** RIVER *** [5d Ad 5h 8s] [Jc]
Nacho.N.A260: checks
Flyyguyy403: checks
*** SHOW DOWN ***
Nacho.N.A260: shows [5c 8c] (a full house, Fives full of Eights)
Flyyguyy403: mucks hand
Nacho.N.A260 collected $6.18 from pot
*** SUMMARY ***
Total pot $6.50 | Rake $0.32
Board [5d Ad 5h 8s Jc]
Seat 1: yunteng folded before Flop (didn't bet)
Seat 2: Tigristen folded before Flop (didn't bet)
Seat 3: MARGARCIA09 folded before Flop (didn't bet)
Seat 4: Flyyguyy403 (button) mucked
Seat 5: Nacho.N.A260 (small blind) showed [5c 8c] and won ($6.18) with a full house, Fives full of Eights
Seat 6: G.Andrei95 (big blind) folded before Flop


PokerStars Hand #208961552545:  Hold'em No Limit ($0.25/$0.50 USD) - 2020/02/07 22:07:13 ET
Table 'Aaltje III' 6-max Seat #3 is the button
Seat 1: yunteng ($59.30 in chips)
Seat 2: Tigristen ($50 in chips)
Seat 3: MARGARCIA09 ($54 in chips)
Seat 4: Flyyguyy403 ($45.56 in chips)
Seat 5: Nacho.N.A260 ($75.47 in chips)
Flyyguyy403: posts small blind $0.25
Nacho.N.A260: posts big blind $0.50
G.Andrei95: sits out
*** HOLE CARDS ***
yunteng: folds
Tigristen: folds
MARGARCIA09: folds
Flyyguyy403: folds
Uncalled bet ($0.25) returned to Nacho.N.A260
Nacho.N.A260 collected $0.50 from pot
Nacho.N.A260: doesn't show hand
*** SUMMARY ***
Total pot $0.50 | Rake $0
Seat 1: yunteng folded before Flop (didn't bet)
Seat 2: Tigristen folded before Flop (didn't bet)
Seat 3: MARGARCIA09 (button) folded before Flop (didn't bet)
Seat 4: Flyyguyy403 (small blind) folded before Flop
Seat 5: Nacho.N.A260 (big blind) collected ($0.50)


PokerStars Hand #208961570083:  Hold'em No Limit ($0.25/$0.50 USD) - 2020/02/07 22:08:19 ET
Table 'Aaltje III' 6-max Seat #5 is the button
Seat 1: yunteng ($59.30 in chips)
Seat 2: Tigristen ($50 in chips)
Seat 3: MARGARCIA09 ($54 in chips)
Seat 4: Flyyguyy403 ($42.31 in chips)
Seat 5: Nacho.N.A260 ($78.90 in chips)
Seat 6: G.Andrei95 ($50 in chips)
G.Andrei95: posts small blind $0.25
yunteng: posts big blind $0.50
*** HOLE CARDS ***
Tigristen: folds
MARGARCIA09: raises $1 to $1.50
Flyyguyy403: folds
Nacho.N.A260: calls $1.50
G.Andrei95: folds
yunteng: calls $1
*** FLOP *** [8d 6d Qh]
yunteng: checks
MARGARCIA09: checks
Nacho.N.A260: bets $2
yunteng: folds
MARGARCIA09: folds
Uncalled bet ($2) returned to Nacho.N.A260
Nacho.N.A260 collected $4.51 from pot
Nacho.N.A260: doesn't show hand
*** SUMMARY ***
Total pot $4.75 | Rake $0.24
Board [8d 6d Qh]
Seat 1: yunteng (big blind) folded on the Flop
Seat 2: Tigristen folded before Flop (didn't bet)
Seat 3: MARGARCIA09 folded on the Flop
Seat 4: Flyyguyy403 folded before Flop (didn't bet)
Seat 5: Nacho.N.A260 (button) collected ($4.51)
Seat 6: G.Andrei95 (small blind) folded before Flop


PokerStars Hand #208961583746:  Hold'em No Limit ($0.25/$0.50 USD) - 2020/02/07 22:09:11 ET
Table 'Aaltje III' 6-max Seat #6 is the button
Seat 1: yunteng ($57.80 in chips)
Seat 2: Tigristen ($50 in chips)
Seat 3: MARGARCIA09 ($52.50 in chips)
Seat 4: Flyyguyy403 ($42.31 in chips)
Seat 5: Nacho.N.A260 ($81.91 in chips)
Seat 6: G.Andrei95 ($50 in chips)
yunteng: posts small blind $0.25
Tigristen: posts big blind $0.50
*** HOLE CARDS ***
MARGARCIA09: folds
Flyyguyy403: calls $0.50
Nacho.N.A260: folds
G.Andrei95: raises $1.50 to $2
yunteng: folds
Tigristen: folds
Flyyguyy403: calls $1.50
*** FLOP *** [Kd 2c 5s]
Flyyguyy403: bets $2
G.Andrei95: calls $2
*** TURN *** [Kd 2c 5s] [4h]
Flyyguyy403: bets $3.50
G.Andrei95: calls $3.50
*** RIVER *** [Kd 2c 5s 4h] [3s]
Flyyguyy403: bets $15
G.Andrei95: raises $27.50 to $42.50 and is all-in
Flyyguyy403: calls $19.81 and is all-in
Uncalled bet ($7.69) returned to G.Andrei95
*** SHOW DOWN ***
G.Andrei95: shows [6h Kh] (a straight, Deuce to Six)
Flyyguyy403: shows [Ad 4d] (a straight, Ace to Five)
G.Andrei95 collected $83.37 from pot
*** SUMMARY ***
Total pot $85.37 | Rake $2
Board [Kd 2c 5s 4h 3s]
Seat 1: yunteng (small blind) folded before Flop
Seat 2: Tigristen (big blind) folded before Flop
Seat 3: MARGARCIA09 folded before Flop (didn't bet)
Seat 4: Flyyguyy403 showed [Ad 4d] and lost with a straight, Ace to Five
Seat 5: Nacho.N.A260 folded before Flop (didn't bet)
Seat 6: G.Andrei95 (button) showed [6h Kh] and won ($83.37) with a straight, Deuce to Six


PokerStars Hand #208961601776:  Hold'em No Limit ($0.25/$0.50 USD) - 2020/02/07 22:10:20 ET
Table 'Aaltje III' 6-max Seat #1 is the button
Seat 1: yunteng ($57.55 in chips)
Seat 2: Tigristen ($50 in chips)
Seat 3: MARGARCIA09 ($52.50 in chips)
Seat 5: Nacho.N.A260 ($81.91 in chips)
Seat 6: G.Andrei95 ($91.06 in chips)
Tigristen: posts small blind $0.25
MARGARCIA09: posts big blind $0.50
*** HOLE CARDS ***
Flyyguyy403 leaves the table
Nacho.N.A260: folds
G.Andrei95: folds
yunteng: raises $0.75 to $1.25
Tigristen: folds
MARGARCIA09: calls $0.75
*** FLOP *** [Jc Qd Kc]
MARGARCIA09: checks
yunteng: bets $1.44
MARGARCIA09: calls $1.44
*** TURN *** [Jc Qd Kc] [Ts]
MARGARCIA09: checks
yunteng: bets $1.87
MARGARCIA09: calls $1.87
*** RIVER *** [Jc Qd Kc Ts] [7s]
MARGARCIA09: checks
yunteng: checks
*** SHOW DOWN ***
MARGARCIA09: shows [Qh Tc] (two pair, Queens and Tens)
yunteng: shows [9d 9s] (a straight, Nine to King)
yunteng collected $8.90 from pot
*** SUMMARY ***
Total pot $9.37 | Rake $0.47
Board [Jc Qd Kc Ts 7s]
Seat 1: yunteng (button) showed [9d 9s] and won ($8.90) with a straight, Nine to King
Seat 2: Tigristen (small blind) folded before Flop
Seat 3: MARGARCIA09 (big blind) showed [Qh Tc] and lost with two pair, Queens and Tens
Seat 5: Nacho.N.A260 folded before Flop (didn't bet)
Seat 6: G.Andrei95 folded before Flop (didn't bet)


PokerStars Hand #208961615764:  Hold'em No Limit ($0.25/$0.50 USD) - 2020/02/07 22:11:14 ET
Table 'Aaltje III' 6-max Seat #2 is the button
Seat 1: yunteng ($61.89 in chips)
Seat 2: Tigristen ($50 in chips)
Seat 3: MARGARCIA09 ($50 in chips)
Seat 5: Nacho.N.A260 ($81.91 in chips)
Seat 6: G.Andrei95 ($91.06 in chips)
MARGARCIA09: posts small blind $0.25
Nacho.N.A260: posts big blind $0.50
*** HOLE CARDS ***
G.Andrei95: folds
yunteng: folds
Tigristen: folds
MARGARCIA09: folds
Uncalled bet ($0.25) returned to Nacho.N.A260
Nacho.N.A260 collected $0.50 from pot
Nacho.N.A260: doesn't show hand
*** SUMMARY ***
Total pot $0.50 | Rake $0
Seat 1: yunteng folded before Flop (didn't bet)
Seat 2: Tigristen (button) folded before Flop (didn't bet)
Seat 3: MARGARCIA09 (small blind) folded before Flop
Seat 5: Nacho.N.A260 (big blind) collected ($0.50)
Seat 6: G.Andrei95 folded before Flop (didn't bet)


PokerStars Hand #208961618414:  Hold'em No Limit ($0.25/$0.50 USD) - 2020/02/07 22:11:24 ET
Table 'Aaltje III' 6-max Seat #3 is the button
Seat 1: yunteng ($61.89 in chips)
Seat 2: Tigristen ($50 in chips)
Seat 3: MARGARCIA09 ($50 in chips)
Seat 5: Nacho.N.A260 ($82.16 in chips)
Seat 6: G.Andrei95 ($91.06 in chips)
Nacho.N.A260: posts small blind $0.25
G.Andrei95: posts big blind $0.50
*** HOLE CARDS ***
yunteng: folds
Tigristen: folds
MARGARCIA09: folds
Nacho.N.A260: raises $1 to $1.50
G.Andrei95: calls $1
*** FLOP *** [Th 7h Js]
Nacho.N.A260: bets $2
G.Andrei95: folds
Uncalled bet ($2) returned to Nacho.N.A260
Nacho.N.A260 collected $2.85 from pot
Nacho.N.A260: doesn't show hand
*** SUMMARY ***
Total pot $3 | Rake $0.15
Board [Th 7h Js]
Seat 1: yunteng folded before Flop (didn't bet)
Seat 2: Tigristen folded before Flop (didn't bet)
Seat 3: MARGARCIA09 (button) folded before Flop (didn't bet)
Seat 5: Nacho.N.A260 (small blind) collected ($2.85)
Seat 6: G.Andrei95 (big blind) folded on the Flop


PokerStars Hand #208961626540:  Hold'em No Limit ($0.25/$0.50 USD) - 2020/02/07 22:11:55 ET
Table 'Aaltje III' 6-max Seat #5 is the button
Seat 1: yunteng ($61.89 in chips)
Seat 2: Tigristen ($50 in chips)
Seat 3: MARGARCIA09 ($50 in chips)
Seat 5: Nacho.N.A260 ($83.51 in chips)
Seat 6: G.Andrei95 ($89.56 in chips)
G.Andrei95: posts small blind $0.25
yunteng: posts big blind $0.50
*** HOLE CARDS ***
Tigristen: folds
MARGARCIA09: raises $1 to $1.50
Nacho.N.A260: folds
Kirr888 joins the table at seat #4
Kirr888 leaves the table
G.Andrei95: raises $4 to $5.50
yunteng: folds
Jaby1989 joins the table at seat #4
MARGARCIA09: folds
Uncalled bet ($4) returned to G.Andrei95
G.Andrei95 collected $3.50 from pot
G.Andrei95: doesn't show hand
*** SUMMARY ***
Total pot $3.50 | Rake $0
Seat 1: yunteng (big blind) folded before Flop
Seat 2: Tigristen folded before Flop (didn't bet)
Seat 3: MARGARCIA09 folded before Flop
Seat 5: Nacho.N.A260 (button) folded before Flop (didn't bet)
Seat 6: G.Andrei95 (small blind) collected ($3.50)


PokerStars Hand #208961635201:  Hold'em No Limit ($0.25/$0.50 USD) - 2020/02/07 22:12:29 ET
Table 'Aaltje III' 6-max Seat #6 is the button
Seat 1: yunteng ($61.39 in chips)
Seat 2: Tigristen ($50 in chips)
Seat 3: MARGARCIA09 ($50 in chips)
Seat 4: Jaby1989 ($49.03 in chips)
Seat 5: Nacho.N.A260 ($83.51 in chips)
Seat 6: G.Andrei95 ($91.56 in chips)
yunteng: posts small blind $0.25
Tigristen: posts big blind $0.50
Jaby1989: posts big blind $0.50
*** HOLE CARDS ***
MARGARCIA09: raises $2 to $2.50
Jaby1989: folds
Nacho.N.A260: calls $2.50
G.Andrei95: folds
yunteng: folds
Tigristen: folds
*** FLOP *** [8h 5s 5c]
MARGARCIA09: bets $1.96
Nacho.N.A260: calls $1.96
*** TURN *** [8h 5s 5c] [Ks]
MARGARCIA09: checks
Nacho.N.A260: bets $3.50
MARGARCIA09: calls $3.50
*** RIVER *** [8h 5s 5c Ks] [5h]
MARGARCIA09: checks
Nacho.N.A260: bets $8.50
MARGARCIA09: calls $8.50
*** SHOW DOWN ***
Nacho.N.A260: shows [6c 8c] (a full house, Fives full of Eights)
MARGARCIA09: shows [Td Kd] (a full house, Fives full of Kings)
MARGARCIA09 collected $32.46 from pot
*** SUMMARY ***
Total pot $34.17 | Rake $1.71
Board [8h 5s 5c Ks 5h]
Seat 1: yunteng (small blind) folded before Flop
Seat 2: Tigristen (big blind) folded before Flop
Seat 3: MARGARCIA09 showed [Td Kd] and won ($32.46) with a full house, Fives full of Kings
Seat 4: Jaby1989 folded before Flop (didn't bet)
Seat 5: Nacho.N.A260 showed [6c 8c] and lost with a full house, Fives full of Eights
Seat 6: G.Andrei95 (button) folded before Flop (didn't bet)


PokerStars Hand #208961676685:  Hold'em No Limit ($0.25/$0.50 USD) - 2020/02/07 22:15:00 ET
Table 'Aaltje III' 6-max Seat #3 is the button
Seat 1: yunteng ($61.89 in chips)
Seat 2: Tigristen ($50 in chips)
Seat 3: MARGARCIA09 ($65.25 in chips)
Seat 4: Jaby1989 ($48.72 in chips)
Jaby1989: posts small blind $0.25
G.Andrei95: is sitting out
yunteng: posts big blind $0.50
*** HOLE CARDS ***
Tigristen: raises $0.70 to $1.20
MARGARCIA09: folds
Jaby1989: folds
G.Andrei95 leaves the table
yunteng: folds
Uncalled bet ($0.70) returned to Tigristen
Heaton#RISES joins the table at seat #5
Tigristen collected $1.25 from pot
Tigristen: doesn't show hand
*** SUMMARY ***
Total pot $1.25 | Rake $0
Seat 1: yunteng (big blind) folded before Flop
Seat 2: Tigristen collected ($1.25)
Seat 3: MARGARCIA09 (button) folded before Flop (didn't bet)
Seat 4: Jaby1989 (small blind) folded before Flop


PokerStars Hand #208961671162:  Hold'em No Limit ($0.25/$0.50 USD) - 2020/02/07 22:14:39 ET
Table 'Aaltje III' 6-max Seat #2 is the button
Seat 1: yunteng ($61.14 in chips)
Seat 2: Tigristen ($50 in chips)
Seat 3: MARGARCIA09 ($65.50 in chips)
Seat 4: Jaby1989 ($49.22 in chips)
Seat 6: G.Andrei95 ($91.56 in chips)
MARGARCIA09: posts small blind $0.25
Jaby1989: posts big blind $0.50
*** HOLE CARDS ***
G.Andrei95: folds
yunteng: raises $0.75 to $1.25
Tigristen: folds
MARGARCIA09: folds
Jaby1989: folds
Uncalled bet ($0.75) returned to yunteng
yunteng collected $1.25 from pot
yunteng: doesn't show hand
*** SUMMARY ***
Total pot $1.25 | Rake $0
Seat 1: yunteng collected ($1.25)
Seat 2: Tigristen (button) folded before Flop (didn't bet)
Seat 3: MARGARCIA09 (small blind) folded before Flop
Seat 4: Jaby1989 (big blind) folded before Flop
Seat 6: G.Andrei95 folded before Flop (didn't bet)


PokerStars Hand #208961659054:  Hold'em No Limit ($0.25/$0.50 USD) - 2020/02/07 22:13:51 ET
Table 'Aaltje III' 6-max Seat #1 is the button
Seat 1: yunteng ($61.14 in chips)
Seat 2: Tigristen ($50 in chips)
Seat 3: MARGARCIA09 ($66 in chips)
Seat 4: Jaby1989 ($48.53 in chips)
Seat 5: Nacho.N.A260 ($67.05 in chips)
Seat 6: G.Andrei95 ($91.56 in chips)
Tigristen: posts small blind $0.25
MARGARCIA09: posts big blind $0.50
*** HOLE CARDS ***
Jaby1989: calls $0.50
Nacho.N.A260: folds
G.Andrei95: folds
yunteng: folds
Tigristen: folds
MARGARCIA09: checks
*** FLOP *** [Kc Js Qc]
MARGARCIA09: checks
Nacho.N.A260 leaves the table
Jaby1989: bets $0.59
MARGARCIA09: folds
Uncalled bet ($0.59) returned to Jaby1989
Jaby1989 collected $1.19 from pot
Jaby1989: doesn't show hand
*** SUMMARY ***
Total pot $1.25 | Rake $0.06
Board [Kc Js Qc]
Seat 1: yunteng (button) folded before Flop (didn't bet)
Seat 2: Tigristen (small blind) folded before Flop
Seat 3: MARGARCIA09 (big blind) folded on the Flop
Seat 4: Jaby1989 collected ($1.19)
Seat 5: Nacho.N.A260 folded before Flop (didn't bet)
Seat 6: G.Andrei95 folded before Flop (didn't bet)


PokerStars Hand #208961680617:  Hold'em No Limit ($0.25/$0.50 USD) - 2020/02/07 22:15:15 ET
Table 'Aaltje III' 6-max Seat #4 is the button
Seat 1: yunteng ($61.39 in chips)
Seat 2: Tigristen ($50.75 in chips)
Seat 3: MARGARCIA09 ($65.25 in chips)
Seat 4: Jaby1989 ($48.47 in chips)
yunteng: posts small blind $0.25
Tigristen: posts big blind $0.50
*** HOLE CARDS ***
MARGARCIA09: folds
Bodahir joins the table at seat #6
Jaby1989: raises $0.50 to $1
yunteng: folds
Tigristen: folds
Uncalled bet ($0.50) returned to Jaby1989
Jaby1989 collected $1.25 from pot
Jaby1989: doesn't show hand
*** SUMMARY ***
Total pot $1.25 | Rake $0
Seat 1: yunteng (small blind) folded before Flop
Seat 2: Tigristen (big blind) folded before Flop
Seat 3: MARGARCIA09 folded before Flop (didn't bet)
Seat 4: Jaby1989 (button) collected ($1.25)


PokerStars Hand #208961683880:  Hold'em No Limit ($0.25/$0.50 USD) - 2020/02/07 22:15:28 ET
Table 'Aaltje III' 6-max Seat #1 is the button
Seat 1: yunteng ($61.14 in chips)
Seat 2: Tigristen ($50.25 in chips)
Seat 3: MARGARCIA09 ($65.25 in chips)
Seat 4: Jaby1989 ($49.22 in chips)
Tigristen: posts small blind $0.25
MARGARCIA09: posts big blind $0.50
Heaton#RISES: sits out
Bodahir: sits out
*** HOLE CARDS ***
Jaby1989: folds
yunteng: folds
Tigristen: raises $0.90 to $1.40
MARGARCIA09: calls $0.90
*** FLOP *** [8h Jh Ts]
Tigristen: checks
MARGARCIA09: checks
*** TURN *** [8h Jh Ts] [Ad]
Tigristen: bets $1.41
MARGARCIA09: folds
Uncalled bet ($1.41) returned to Tigristen
Tigristen collected $2.66 from pot
Tigristen: doesn't show hand
*** SUMMARY ***
Total pot $2.80 | Rake $0.14
Board [8h Jh Ts Ad]
Seat 1: yunteng (button) folded before Flop (didn't bet)
Seat 2: Tigristen (small blind) collected ($2.66)
Seat 3: MARGARCIA09 (big blind) folded on the Turn
Seat 4: Jaby1989 folded before Flop (didn't bet)


PokerStars Hand #208961701124:  Hold'em No Limit ($0.25/$0.50 USD) - 2020/02/07 22:16:04 ET
Table 'Aaltje III' 6-max Seat #2 is the button
Seat 1: yunteng ($61.14 in chips)
Seat 2: Tigristen ($51.51 in chips)
Seat 3: MARGARCIA09 ($63.85 in chips)
Seat 4: Jaby1989 ($49.22 in chips)
MARGARCIA09: posts small blind $0.25
Jaby1989: posts big blind $0.50
Heaton#RISES: sits out
Bodahir: sits out
*** HOLE CARDS ***
yunteng: folds
Tigristen: raises $0.70 to $1.20
MARGARCIA09: folds
Jaby1989: folds
Uncalled bet ($0.70) returned to Tigristen
Tigristen collected $1.25 from pot
Tigristen: doesn't show hand
*** SUMMARY ***
Total pot $1.25 | Rake $0
Seat 1: yunteng folded before Flop (didn't bet)
Seat 2: Tigristen (button) collected ($1.25)
Seat 3: MARGARCIA09 (small blind) folded before Flop
Seat 4: Jaby1989 (big blind) folded before Flop


PokerStars Hand #208961712055:  Hold'em No Limit ($0.25/$0.50 USD) - 2020/02/07 22:16:47 ET
Table 'Aaltje III' 6-max Seat #4 is the button
Seat 1: yunteng ($61.14 in chips)
Seat 2: Tigristen ($52.26 in chips)
Seat 3: MARGARCIA09 ($63.60 in chips)
Seat 4: Jaby1989 ($48.22 in chips)
Seat 5: Heaton#RISES ($50.50 in chips)
Seat 6: Bodahir ($50 in chips)
Heaton#RISES: posts small blind $0.25
Bodahir: posts big blind $0.50
*** HOLE CARDS ***
yunteng has timed out
yunteng: folds
Tigristen: folds
MARGARCIA09: folds
Jaby1989: folds
Heaton#RISES: folds
Uncalled bet ($0.25) returned to Bodahir
Bodahir collected $0.50 from pot
Bodahir: doesn't show hand
*** SUMMARY ***
Total pot $0.50 | Rake $0
Seat 1: yunteng folded before Flop (didn't bet)
Seat 2: Tigristen folded before Flop (didn't bet)
Seat 3: MARGARCIA09 folded before Flop (didn't bet)
Seat 4: Jaby1989 (button) folded before Flop (didn't bet)
Seat 5: Heaton#RISES (small blind) folded before Flop
Seat 6: Bodahir (big blind) collected ($0.50)


PokerStars Hand #208961703793:  Hold'em No Limit ($0.25/$0.50 USD) - 2020/02/07 22:16:14 ET
Table 'Aaltje III' 6-max Seat #3 is the button
Seat 1: yunteng ($61.14 in chips)
Seat 2: Tigristen ($52.26 in chips)
Seat 3: MARGARCIA09 ($63.60 in chips)
Seat 4: Jaby1989 ($48.72 in chips)
Seat 5: Heaton#RISES ($50 in chips)
Jaby1989: posts small blind $0.25
Heaton#RISES: posts big blind $0.50
Bodahir: sits out
*** HOLE CARDS ***
yunteng: folds
Tigristen: folds
MARGARCIA09: folds
Jaby1989: calls $0.25
Heaton#RISES: raises $1.75 to $2.25
Jaby1989: folds
Uncalled bet ($1.75) returned to Heaton#RISES
Heaton#RISES collected $1 from pot
Heaton#RISES: doesn't show hand
*** SUMMARY ***
Total pot $1 | Rake $0
Seat 1: yunteng folded before Flop (didn't bet)
Seat 2: Tigristen folded before Flop (didn't bet)
Seat 3: MARGARCIA09 (button) folded before Flop (didn't bet)
Seat 4: Jaby1989 (small blind) folded before Flop
Seat 5: Heaton#RISES (big blind) collected ($1)


PokerStars Hand #208961717431:  Hold'em No Limit ($0.25/$0.50 USD) - 2020/02/07 22:17:08 ET
Table 'Aaltje III' 6-max Seat #5 is the button
Seat 1: yunteng ($61.14 in chips)
Seat 2: Tigristen ($52.26 in chips)
Seat 3: MARGARCIA09 ($63.60 in chips)
Seat 4: Jaby1989 ($48.22 in chips)
Seat 5: Heaton#RISES ($50.25 in chips)
Seat 6: Bodahir ($50.25 in chips)
Bodahir: posts small blind $0.25
yunteng: posts big blind $0.50
*** HOLE CARDS ***
Tigristen: raises $0.70 to $1.20
MARGARCIA09: folds
Jaby1989: folds
Heaton#RISES: folds
Bodahir: folds
yunteng: calls $0.70
*** FLOP *** [Qc Jh Qs]
yunteng: checks
Tigristen: checks
*** TURN *** [Qc Jh Qs] [Tc]
yunteng: checks
Tigristen: checks
*** RIVER *** [Qc Jh Qs Tc] [As]
yunteng: checks
Tigristen: checks
*** SHOW DOWN ***
yunteng: shows [5c 3c] (a pair of Queens)
Tigristen: shows [8c 7c] (a pair of Queens)
yunteng collected $1.26 from pot
Tigristen collected $1.26 from pot
*** SUMMARY ***
Total pot $2.65 | Rake $0.13
Board [Qc Jh Qs Tc As]
Seat 1: yunteng (big blind) showed [5c 3c] and won ($1.26) with a pair of Queens
Seat 2: Tigristen showed [8c 7c] and won ($1.26) with a pair of Queens
Seat 3: MARGARCIA09 folded before Flop (didn't bet)
Seat 4: Jaby1989 folded before Flop (didn't bet)
Seat 5: Heaton#RISES (button) folded before Flop (didn't bet)
Seat 6: Bodahir (small blind) folded before Flop


PokerStars Hand #208961730285:  Hold'em No Limit ($0.25/$0.50 USD) - 2020/02/07 22:17:58 ET
Table 'Aaltje III' 6-max Seat #6 is the button
Seat 1: yunteng ($61.20 in chips)
Seat 2: Tigristen ($52.32 in chips)
Seat 3: MARGARCIA09 ($63.60 in chips)
Seat 4: Jaby1989 ($48.22 in chips)
Seat 5: Heaton#RISES ($50.25 in chips)
Seat 6: Bodahir ($50 in chips)
yunteng: posts small blind $0.25
Tigristen: posts big blind $0.50
*** HOLE CARDS ***
MARGARCIA09: folds
Jaby1989: raises $0.50 to $1
Heaton#RISES: folds
Bodahir: folds
yunteng: folds
Tigristen: folds
Uncalled bet ($0.50) returned to Jaby1989
Jaby1989 collected $1.25 from pot
Jaby1989: doesn't show hand
*** SUMMARY ***
Total pot $1.25 | Rake $0
Seat 1: yunteng (small blind) folded before Flop
Seat 2: Tigristen (big blind) folded before Flop
Seat 3: MARGARCIA09 folded before Flop (didn't bet)
Seat 4: Jaby1989 collected ($1.25)
Seat 5: Heaton#RISES folded before Flop (didn't bet)
Seat 6: Bodahir (button) folded before Flop (didn't bet)


PokerStars Hand #208961735207:  Hold'em No Limit ($0.25/$0.50 USD) - 2020/02/07 22:18:18 ET
Table 'Aaltje III' 6-max Seat #1 is the button
Seat 1: yunteng ($60.95 in chips)
Seat 2: Tigristen ($51.82 in chips)
Seat 3: MARGARCIA09 ($63.60 in chips)
Seat 4: Jaby1989 ($48.97 in chips)
Seat 5: Heaton#RISES ($50.25 in chips)
Seat 6: Bodahir ($50 in chips)
Tigristen: posts small blind $0.25
MARGARCIA09: posts big blind $0.50
*** HOLE CARDS ***
Jaby1989: calls $0.50
Heaton#RISES: raises $1.75 to $2.25
Bodahir: folds
yunteng: folds
Tigristen: folds
MARGARCIA09: folds
Jaby1989: folds
Uncalled bet ($1.75) returned to Heaton#RISES
Heaton#RISES collected $1.75 from pot
Heaton#RISES: doesn't show hand
*** SUMMARY ***
Total pot $1.75 | Rake $0
Seat 1: yunteng (button) folded before Flop (didn't bet)
Seat 2: Tigristen (small blind) folded before Flop
Seat 3: MARGARCIA09 (big blind) folded before Flop
Seat 4: Jaby1989 folded before Flop
Seat 5: Heaton#RISES collected ($1.75)
Seat 6: Bodahir folded before Flop (didn't bet)


PokerStars Hand #208961742416:  Hold'em No Limit ($0.25/$0.50 USD) - 2020/02/07 22:18:45 ET
Table 'Aaltje III' 6-max Seat #2 is the button
Seat 1: yunteng ($60.95 in chips)
Seat 2: Tigristen ($51.57 in chips)
Seat 3: MARGARCIA09 ($63.10 in chips)
Seat 4: Jaby1989 ($48.47 in chips)
Seat 5: Heaton#RISES ($51.50 in chips)
Seat 6: Bodahir ($50 in chips)
MARGARCIA09: posts small blind $0.25
Jaby1989: posts big blind $0.50
*** HOLE CARDS ***
Heaton#RISES: folds
Bodahir: raises $1 to $1.50
yunteng: folds
Tigristen: folds
MARGARCIA09: raises $4.50 to $6
Jaby1989: folds
Bodahir: calls $4.50
*** FLOP *** [7s 6c Js]
MARGARCIA09: bets $6.30
Bodahir: folds
Uncalled bet ($6.30) returned to MARGARCIA09
MARGARCIA09 collected $11.88 from pot
MARGARCIA09: doesn't show hand
*** SUMMARY ***
Total pot $12.50 | Rake $0.62
Board [7s 6c Js]
Seat 1: yunteng folded before Flop (didn't bet)
Seat 2: Tigristen (button) folded before Flop (didn't bet)
Seat 3: MARGARCIA09 (small blind) collected ($11.88)
Seat 4: Jaby1989 (big blind) folded before Flop
Seat 5: Heaton#RISES folded before Flop (didn't bet)
Seat 6: Bodahir folded on the Flop


PokerStars Hand #208961757866:  Hold'em No Limit ($0.25/$0.50 USD) - 2020/02/07 22:19:45 ET
Table 'Aaltje III' 6-max Seat #3 is the button
Seat 1: yunteng ($60.95 in chips)
Seat 2: Tigristen ($51.57 in chips)
Seat 3: MARGARCIA09 ($68.98 in chips)
Seat 4: Jaby1989 ($47.97 in chips)
Seat 5: Heaton#RISES ($51.50 in chips)
Seat 6: Bodahir ($50 in chips)
Jaby1989: posts small blind $0.25
Heaton#RISES: posts big blind $0.50
*** HOLE CARDS ***
Bodahir: folds
yunteng: folds
Tigristen: folds
Tigristen leaves the table
MARGARCIA09: folds
reginaph joins the table at seat #2
Jaby1989: calls $0.25
Heaton#RISES: checks
*** FLOP *** [8c Jd 8s]
Jaby1989: bets $0.50
Heaton#RISES: folds
Uncalled bet ($0.50) returned to Jaby1989
Jaby1989 collected $0.95 from pot
Jaby1989: doesn't show hand
*** SUMMARY ***
Total pot $1 | Rake $0.05
Board [8c Jd 8s]
Seat 1: yunteng folded before Flop (didn't bet)
Seat 2: Tigristen folded before Flop (didn't bet)
Seat 3: MARGARCIA09 (button) folded before Flop (didn't bet)
Seat 4: Jaby1989 (small blind) collected ($0.95)
Seat 5: Heaton#RISES (big blind) folded on the Flop
Seat 6: Bodahir folded before Flop (didn't bet)


PokerStars Hand #208961771515:  Hold'em No Limit ($0.25/$0.50 USD) - 2020/02/07 22:20:38 ET
Table 'Aaltje III' 6-max Seat #4 is the button
Seat 1: yunteng ($60.95 in chips)
Seat 3: MARGARCIA09 ($68.98 in chips)
Seat 4: Jaby1989 ($48.42 in chips)
Seat 5: Heaton#RISES ($51 in chips)
Seat 6: Bodahir ($50 in chips)
Heaton#RISES: posts small blind $0.25
Bodahir: posts big blind $0.50
reginaph: sits out
*** HOLE CARDS ***
yunteng: folds
MARGARCIA09: folds
Jaby1989: folds
Heaton#RISES: raises $1.28 to $1.78
Bodahir: folds
Uncalled bet ($1.28) returned to Heaton#RISES
Heaton#RISES collected $1 from pot
Heaton#RISES: doesn't show hand
*** SUMMARY ***
Total pot $1 | Rake $0
Seat 1: yunteng folded before Flop (didn't bet)
Seat 3: MARGARCIA09 folded before Flop (didn't bet)
Seat 4: Jaby1989 (button) folded before Flop (didn't bet)
Seat 5: Heaton#RISES (small blind) collected ($1)
Seat 6: Bodahir (big blind) folded before Flop


PokerStars Hand #208961777995:  Hold'em No Limit ($0.25/$0.50 USD) - 2020/02/07 22:21:04 ET
Table 'Aaltje III' 6-max Seat #5 is the button
Seat 1: yunteng ($60.95 in chips)
Seat 3: MARGARCIA09 ($68.98 in chips)
Seat 4: Jaby1989 ($48.42 in chips)
Seat 5: Heaton#RISES ($51.50 in chips)
Seat 6: Bodahir ($50 in chips)
Bodahir: posts small blind $0.25
yunteng: posts big blind $0.50
reginaph: sits out
*** HOLE CARDS ***
MARGARCIA09: folds
Jaby1989: folds
Heaton#RISES: folds
Bodahir: folds
Uncalled bet ($0.25) returned to yunteng
yunteng collected $0.50 from pot
yunteng: doesn't show hand
*** SUMMARY ***
Total pot $0.50 | Rake $0
Seat 1: yunteng (big blind) collected ($0.50)
Seat 3: MARGARCIA09 folded before Flop (didn't bet)
Seat 4: Jaby1989 folded before Flop (didn't bet)
Seat 5: Heaton#RISES (button) folded before Flop (didn't bet)
Seat 6: Bodahir (small blind) folded before Flop


PokerStars Hand #208961783835:  Hold'em No Limit ($0.25/$0.50 USD) - 2020/02/07 22:21:28 ET
Table 'Aaltje III' 6-max Seat #6 is the button
Seat 1: yunteng ($61.20 in chips)
Seat 2: reginaph ($50 in chips)
Seat 3: MARGARCIA09 ($68.98 in chips)
Seat 4: Jaby1989 ($48.42 in chips)
Seat 5: Heaton#RISES ($51.50 in chips)
Seat 6: Bodahir ($50 in chips)
yunteng: posts small blind $0.25
reginaph: posts big blind $0.50
*** HOLE CARDS ***
MARGARCIA09: folds
Bodahir is disconnected
Jaby1989 has timed out
Jaby1989: folds
Heaton#RISES: folds
Bodahir: folds
yunteng: raises $0.75 to $1.25
reginaph: calls $0.75
*** FLOP *** [Kc Qc 9d]
yunteng: bets $1.25
reginaph: folds
Uncalled bet ($1.25) returned to yunteng
yunteng collected $2.38 from pot
yunteng: doesn't show hand
*** SUMMARY ***
Total pot $2.50 | Rake $0.12
Board [Kc Qc 9d]
Seat 1: yunteng (small blind) collected ($2.38)
Seat 2: reginaph (big blind) folded on the Flop
Seat 3: MARGARCIA09 folded before Flop (didn't bet)
Seat 4: Jaby1989 folded before Flop (didn't bet)
Seat 5: Heaton#RISES folded before Flop (didn't bet)
Seat 6: Bodahir (button) folded before Flop (didn't bet)


PokerStars Hand #208961814390:  Hold'em No Limit ($0.25/$0.50 USD) - 2020/02/07 22:23:29 ET
Table 'Aaltje III' 6-max Seat #2 is the button
Seat 1: yunteng ($62.33 in chips)
Seat 2: reginaph ($50 in chips)
Seat 3: MARGARCIA09 ($68.48 in chips)
Seat 4: Jaby1989 ($48.42 in chips)
Seat 5: Heaton#RISES ($50.75 in chips)
Seat 6: Bodahir ($50 in chips)
MARGARCIA09: posts small blind $0.25
Jaby1989: posts big blind $0.50
*** HOLE CARDS ***
Heaton#RISES: folds
Bodahir: folds
yunteng: raises $0.75 to $1.25
reginaph: folds
MARGARCIA09: folds
Jaby1989: calls $0.75
*** FLOP *** [5c 5d 3c]
Jaby1989: bets $0.50
yunteng: calls $0.50
*** TURN *** [5c 5d 3c] [5h]
Jaby1989: bets $1.28
yunteng: folds
Uncalled bet ($1.28) returned to Jaby1989
Jaby1989 collected $3.56 from pot
Jaby1989: doesn't show hand
*** SUMMARY ***
Total pot $3.75 | Rake $0.19
Board [5c 5d 3c 5h]
Seat 1: yunteng folded on the Turn
Seat 2: reginaph (button) folded before Flop (didn't bet)
Seat 3: MARGARCIA09 (small blind) folded before Flop
Seat 4: Jaby1989 (big blind) collected ($3.56)
Seat 5: Heaton#RISES folded before Flop (didn't bet)
Seat 6: Bodahir folded before Flop (didn't bet)


PokerStars Hand #208961798664:  Hold'em No Limit ($0.25/$0.50 USD) - 2020/02/07 22:22:26 ET
Table 'Aaltje III' 6-max Seat #1 is the button
Seat 1: yunteng ($62.33 in chips)
Seat 2: reginaph ($50 in chips)
Seat 3: MARGARCIA09 ($68.98 in chips)
Seat 4: Jaby1989 ($48.42 in chips)
Seat 5: Heaton#RISES ($51.50 in chips)
Seat 6: Bodahir ($50 in chips)
reginaph: posts small blind $0.25
MARGARCIA09: posts big blind $0.50
*** HOLE CARDS ***
Jaby1989: folds
Heaton#RISES: raises $0.73 to $1.23
Bodahir: folds
yunteng: folds
reginaph: raises $3.77 to $5
MARGARCIA09: folds
Heaton#RISES: raises $6.27 to $11.27
reginaph: raises $38.73 to $50 and is all-in
Heaton#RISES: calls $38.73
*** FIRST FLOP *** [Qs Qc 3h]
*** FIRST TURN *** [Qs Qc 3h] [4h]
*** FIRST RIVER *** [Qs Qc 3h 4h] [Ac]
*** SECOND FLOP *** [Tc Jd Qd]
*** SECOND TURN *** [Tc Jd Qd] [7s]
*** SECOND RIVER *** [Tc Jd Qd 7s] [4s]
*** FIRST SHOW DOWN ***
reginaph: shows [Ad Ks] (two pair, Aces and Queens)
Heaton#RISES: shows [Ah As] (a full house, Aces full of Queens)
Heaton#RISES collected $49.25 from pot
*** SECOND SHOW DOWN ***
reginaph: shows [Ad Ks] (a straight, Ten to Ace)
Heaton#RISES: shows [Ah As] (a pair of Aces)
reginaph collected $49.25 from pot
*** SUMMARY ***
Total pot $100.50 | Rake $2
Hand was run twice
FIRST Board [Qs Qc 3h 4h Ac]
SECOND Board [Tc Jd Qd 7s 4s]
Seat 1: yunteng (button) folded before Flop (didn't bet)
Seat 2: reginaph (small blind) showed [Ad Ks] and lost with two pair, Aces and Queens, and won ($49.25) with a straight, Ten to Ace
Seat 3: MARGARCIA09 (big blind) folded before Flop
Seat 4: Jaby1989 folded before Flop (didn't bet)
Seat 5: Heaton#RISES showed [Ah As] and won ($49.25) with a full house, Aces full of Queens, and lost with a pair of Aces
Seat 6: Bodahir folded before Flop (didn't bet)


PokerStars Hand #208961824759:  Hold'em No Limit ($0.25/$0.50 USD) - 2020/02/07 22:24:10 ET
Table 'Aaltje III' 6-max Seat #3 is the button
Seat 1: yunteng ($60.58 in chips)
Seat 2: reginaph ($50 in chips)
Seat 3: MARGARCIA09 ($68.23 in chips)
Seat 4: Jaby1989 ($50.23 in chips)
Seat 5: Heaton#RISES ($50.75 in chips)
Seat 6: Bodahir ($50 in chips)
Jaby1989: posts small blind $0.25
Heaton#RISES: posts big blind $0.50
*** HOLE CARDS ***
Bodahir: folds
yunteng: raises $0.75 to $1.25
reginaph: folds
MARGARCIA09: raises $3.50 to $4.75
Jaby1989: folds
Heaton#RISES: folds
yunteng: raises $4.25 to $9
MARGARCIA09: calls $4.25
*** FLOP *** [Ad 8s Ks]
yunteng: bets $11.75
MARGARCIA09: folds
Uncalled bet ($11.75) returned to yunteng
yunteng collected $17.81 from pot
yunteng: doesn't show hand
*** SUMMARY ***
Total pot $18.75 | Rake $0.94
Board [Ad 8s Ks]
Seat 1: yunteng collected ($17.81)
Seat 2: reginaph folded before Flop (didn't bet)
Seat 3: MARGARCIA09 (button) folded on the Flop
Seat 4: Jaby1989 (small blind) folded before Flop
Seat 5: Heaton#RISES (big blind) folded before Flop
Seat 6: Bodahir folded before Flop (didn't bet)


PokerStars Hand #208961850018:  Hold'em No Limit ($0.25/$0.50 USD) - 2020/02/07 22:25:24 ET
Table 'Aaltje III' 6-max Seat #5 is the button
Seat 1: yunteng ($69.39 in chips)
Seat 2: reginaph ($50 in chips)
Seat 3: MARGARCIA09 ($59.23 in chips)
Seat 4: Jaby1989 ($50.73 in chips)
Seat 5: Heaton#RISES ($50 in chips)
Seat 6: Bodahir ($50 in chips)
Bodahir: posts small blind $0.25
yunteng: posts big blind $0.50
*** HOLE CARDS ***
reginaph: folds
MARGARCIA09: folds
Jaby1989: folds
Heaton#RISES: folds
Bodahir: raises $0.75 to $1.25
yunteng: folds
Uncalled bet ($0.75) returned to Bodahir
Bodahir collected $1 from pot
Bodahir: doesn't show hand
*** SUMMARY ***
Total pot $1 | Rake $0
Seat 1: yunteng (big blind) folded before Flop
Seat 2: reginaph folded before Flop (didn't bet)
Seat 3: MARGARCIA09 folded before Flop (didn't bet)
Seat 4: Jaby1989 folded before Flop (didn't bet)
Seat 5: Heaton#RISES (button) folded before Flop (didn't bet)
Seat 6: Bodahir (small blind) collected ($1)


PokerStars Hand #208961837051:  Hold'em No Limit ($0.25/$0.50 USD) - 2020/02/07 22:24:59 ET
Table 'Aaltje III' 6-max Seat #4 is the button
Seat 1: yunteng ($69.39 in chips)
Seat 2: reginaph ($50 in chips)
Seat 3: MARGARCIA09 ($59.23 in chips)
Seat 4: Jaby1989 ($49.98 in chips)
Seat 5: Heaton#RISES ($50.25 in chips)
Seat 6: Bodahir ($50 in chips)
Heaton#RISES: posts small blind $0.25
Bodahir: posts big blind $0.50
*** HOLE CARDS ***
yunteng: folds
reginaph: folds
MARGARCIA09: folds
Jaby1989: raises $1 to $1.50
Heaton#RISES: folds
Bodahir: folds
Uncalled bet ($1) returned to Jaby1989
Jaby1989 collected $1.25 from pot
Jaby1989: doesn't show hand
*** SUMMARY ***
Total pot $1.25 | Rake $0
Seat 1: yunteng folded before Flop (didn't bet)
Seat 2: reginaph folded before Flop (didn't bet)
Seat 3: MARGARCIA09 folded before Flop (didn't bet)
Seat 4: Jaby1989 (button) collected ($1.25)
Seat 5: Heaton#RISES (small blind) folded before Flop
Seat 6: Bodahir (big blind) folded before Flop


PokerStars Hand #208961855482:  Hold'em No Limit ($0.25/$0.50 USD) - 2020/02/07 22:25:45 ET
Table 'Aaltje III' 6-max Seat #6 is the button
Seat 1: yunteng ($68.89 in chips)
Seat 2: reginaph ($50 in chips)
Seat 3: MARGARCIA09 ($59.23 in chips)
Seat 4: Jaby1989 ($50.73 in chips)
Seat 5: Heaton#RISES ($50 in chips)
Seat 6: Bodahir ($50.50 in chips)
yunteng: posts small blind $0.25
reginaph: posts big blind $0.50
*** HOLE CARDS ***
MARGARCIA09: folds
Jaby1989: folds
Heaton#RISES: folds
Bodahir: raises $1 to $1.50
yunteng: calls $1.25
reginaph: calls $1
*** FLOP *** [3h 5s 3d]
yunteng: checks
reginaph: checks
Bodahir: bets $3.85
yunteng: calls $3.85
reginaph: folds
*** TURN *** [3h 5s 3d] [Ah]
yunteng: checks
Bodahir: bets $5.80
yunteng: raises $8.12 to $13.92
Bodahir: folds
Uncalled bet ($8.12) returned to yunteng
yunteng collected $22.61 from pot
yunteng: doesn't show hand
*** SUMMARY ***
Total pot $23.80 | Rake $1.19
Board [3h 5s 3d Ah]
Seat 1: yunteng (small blind) collected ($22.61)
Seat 2: reginaph (big blind) folded on the Flop
Seat 3: MARGARCIA09 folded before Flop (didn't bet)
Seat 4: Jaby1989 folded before Flop (didn't bet)
Seat 5: Heaton#RISES folded before Flop (didn't bet)
Seat 6: Bodahir (button) folded on the Turn


PokerStars Hand #208961885069:  Hold'em No Limit ($0.25/$0.50 USD) - 2020/02/07 22:27:44 ET
Table 'Aaltje III' 6-max Seat #1 is the button
Seat 1: yunteng ($80.35 in chips)
Seat 2: reginaph ($50 in chips)
Seat 3: MARGARCIA09 ($59.23 in chips)
Seat 4: Jaby1989 ($50.73 in chips)
Seat 5: Heaton#RISES ($50 in chips)
Seat 6: Bodahir ($50 in chips)
reginaph: posts small blind $0.25
MARGARCIA09: posts big blind $0.50
*** HOLE CARDS ***
Jaby1989 has timed out
Jaby1989: folds
Heaton#RISES: raises $0.73 to $1.23
Bodahir: folds
yunteng: folds
reginaph: raises $3.77 to $5
MARGARCIA09: folds
Heaton#RISES: calls $3.77
*** FLOP *** [8h 9h 8s]
reginaph: bets $2.99
Heaton#RISES: folds
Uncalled bet ($2.99) returned to reginaph
reginaph collected $9.98 from pot
reginaph: doesn't show hand
*** SUMMARY ***
Total pot $10.50 | Rake $0.52
Board [8h 9h 8s]
Seat 1: yunteng (button) folded before Flop (didn't bet)
Seat 2: reginaph (small blind) collected ($9.98)
Seat 3: MARGARCIA09 (big blind) folded before Flop
Seat 4: Jaby1989 folded before Flop (didn't bet)
Seat 5: Heaton#RISES folded on the Flop
Seat 6: Bodahir folded before Flop (didn't bet)


PokerStars Hand #208961901710:  Hold'em No Limit ($0.25/$0.50 USD) - 2020/02/07 22:28:51 ET
Table 'Aaltje III' 6-max Seat #2 is the button
Seat 1: yunteng ($80.35 in chips)
Seat 2: reginaph ($54.98 in chips)
Seat 3: MARGARCIA09 ($58.73 in chips)
Seat 4: Jaby1989 ($50.73 in chips)
Seat 5: Heaton#RISES ($50 in chips)
Seat 6: Bodahir ($50 in chips)
MARGARCIA09: posts small blind $0.25
Jaby1989: posts big blind $0.50
*** HOLE CARDS ***
Heaton#RISES: folds
Bodahir: folds
yunteng: raises $0.75 to $1.25
reginaph: folds
MARGARCIA09: folds
Jaby1989: calls $0.75
*** FLOP *** [9d 2c 3c]
Jaby1989: bets $1.30
yunteng: calls $1.30
*** TURN *** [9d 2c 3c] [5c]
Jaby1989: bets $2.54
yunteng: folds
Uncalled bet ($2.54) returned to Jaby1989
Jaby1989 collected $5.08 from pot
Jaby1989: doesn't show hand
*** SUMMARY ***
Total pot $5.35 | Rake $0.27
Board [9d 2c 3c 5c]
Seat 1: yunteng folded on the Turn
Seat 2: reginaph (button) folded before Flop (didn't bet)
Seat 3: MARGARCIA09 (small blind) folded before Flop
Seat 4: Jaby1989 (big blind) collected ($5.08)
Seat 5: Heaton#RISES folded before Flop (didn't bet)
Seat 6: Bodahir folded before Flop (didn't bet)


PokerStars Hand #208961914011:  Hold'em No Limit ($0.25/$0.50 USD) - 2020/02/07 22:29:42 ET
Table 'Aaltje III' 6-max Seat #3 is the button
Seat 1: yunteng ($77.80 in chips)
Seat 2: reginaph ($54.98 in chips)
Seat 3: MARGARCIA09 ($58.48 in chips)
Seat 4: Jaby1989 ($53.26 in chips)
Seat 5: Heaton#RISES ($50 in chips)
Seat 6: Bodahir ($50 in chips)
Jaby1989: posts small blind $0.25
Heaton#RISES: posts big blind $0.50
*** HOLE CARDS ***
Bodahir: folds
yunteng has timed out
yunteng: folds
reginaph: folds
MARGARCIA09: folds
Jaby1989: calls $0.25
Heaton#RISES: raises $1.50 to $2
Jaby1989: folds
Uncalled bet ($1.50) returned to Heaton#RISES
Heaton#RISES collected $1 from pot
Heaton#RISES: doesn't show hand
*** SUMMARY ***
Total pot $1 | Rake $0
Seat 1: yunteng folded before Flop (didn't bet)
Seat 2: reginaph folded before Flop (didn't bet)
Seat 3: MARGARCIA09 (button) folded before Flop (didn't bet)
Seat 4: Jaby1989 (small blind) folded before Flop
Seat 5: Heaton#RISES (big blind) collected ($1)
Seat 6: Bodahir folded before Flop (didn't bet)


PokerStars Hand #208961923566:  Hold'em No Limit ($0.25/$0.50 USD) - 2020/02/07 22:30:21 ET
Table 'Aaltje III' 6-max Seat #4 is the button
Seat 1: yunteng ($77.80 in chips)
Seat 2: reginaph ($54.98 in chips)
Seat 3: MARGARCIA09 ($58.48 in chips)
Seat 4: Jaby1989 ($52.76 in chips)
Seat 5: Heaton#RISES ($50.50 in chips)
Seat 6: Bodahir ($50 in chips)
Heaton#RISES: posts small blind $0.25
Bodahir: posts big blind $0.50
*** HOLE CARDS ***
yunteng: folds
reginaph: folds
MARGARCIA09: folds
Jaby1989: folds
Heaton#RISES: raises $1.28 to $1.78
Bodahir: calls $1.28
*** FLOP *** [3s 2h 8d]
Heaton#RISES: bets $1.12
Bodahir: calls $1.12
*** TURN *** [3s 2h 8d] [Jd]
Heaton#RISES: bets $3.28
Bodahir: calls $3.28
*** RIVER *** [3s 2h 8d Jd] [8h]
Heaton#RISES: checks
Bodahir: checks
*** SHOW DOWN ***
Heaton#RISES: shows [Jc 9c] (two pair, Jacks and Eights)
Bodahir: mucks hand
Heaton#RISES collected $11.74 from pot
*** SUMMARY ***
Total pot $12.36 | Rake $0.62
Board [3s 2h 8d Jd 8h]
Seat 1: yunteng folded before Flop (didn't bet)
Seat 2: reginaph folded before Flop (didn't bet)
Seat 3: MARGARCIA09 folded before Flop (didn't bet)
Seat 4: Jaby1989 (button) folded before Flop (didn't bet)
Seat 5: Heaton#RISES (small blind) showed [Jc 9c] and won ($11.74) with two pair, Jacks and Eights
Seat 6: Bodahir (big blind) mucked


PokerStars Hand #208961937504:  Hold'em No Limit ($0.25/$0.50 USD) - 2020/02/07 22:31:17 ET
Table 'Aaltje III' 6-max Seat #5 is the button
Seat 1: yunteng ($77.80 in chips)
Seat 2: reginaph ($54.98 in chips)
Seat 3: MARGARCIA09 ($58.48 in chips)
Seat 4: Jaby1989 ($52.76 in chips)
Seat 5: Heaton#RISES ($56.06 in chips)
Seat 6: Bodahir ($50 in chips)
Bodahir: posts small blind $0.25
yunteng: posts big blind $0.50
*** HOLE CARDS ***
reginaph: folds
MARGARCIA09: folds
Jaby1989: calls $0.50
Heaton#RISES: folds
Bodahir: folds
yunteng: checks
*** FLOP *** [2c 3h Qh]
yunteng: checks
Jaby1989: checks
*** TURN *** [2c 3h Qh] [5h]
yunteng: checks
Jaby1989: bets $0.50
yunteng: calls $0.50
*** RIVER *** [2c 3h Qh 5h] [5s]
yunteng: checks
Jaby1989: checks
*** SHOW DOWN ***
yunteng: shows [8d Qd] (two pair, Queens and Fives)
Jaby1989: mucks hand
yunteng collected $2.14 from pot
*** SUMMARY ***
Total pot $2.25 | Rake $0.11
Board [2c 3h Qh 5h 5s]
Seat 1: yunteng (big blind) showed [8d Qd] and won ($2.14) with two pair, Queens and Fives
Seat 2: reginaph folded before Flop (didn't bet)
Seat 3: MARGARCIA09 folded before Flop (didn't bet)
Seat 4: Jaby1989 mucked
Seat 5: Heaton#RISES (button) folded before Flop (didn't bet)
Seat 6: Bodahir (small blind) folded before Flop


PokerStars Hand #208961951622:  Hold'em No Limit ($0.25/$0.50 USD) - 2020/02/07 22:32:16 ET
Table 'Aaltje III' 6-max Seat #6 is the button
Seat 1: yunteng ($78.94 in chips)
Seat 2: reginaph ($54.98 in chips)
Seat 3: MARGARCIA09 ($58.48 in chips)
Seat 4: Jaby1989 ($51.76 in chips)
Seat 5: Heaton#RISES ($56.06 in chips)
Seat 6: Bodahir ($50 in chips)
yunteng: posts small blind $0.25
reginaph: posts big blind $0.50
*** HOLE CARDS ***
MARGARCIA09: raises $1 to $1.50
Jaby1989: folds
Heaton#RISES: folds
Bodahir: folds
yunteng: folds
reginaph: folds
Uncalled bet ($1) returned to MARGARCIA09
MARGARCIA09 collected $1.25 from pot
MARGARCIA09: doesn't show hand
*** SUMMARY ***
Total pot $1.25 | Rake $0
Seat 1: yunteng (small blind) folded before Flop
Seat 2: reginaph (big blind) folded before Flop
Seat 3: MARGARCIA09 collected ($1.25)
Seat 4: Jaby1989 folded before Flop (didn't bet)
Seat 5: Heaton#RISES folded before Flop (didn't bet)
Seat 6: Bodahir (button) folded before Flop (didn't bet)


PokerStars Hand #208961957470:  Hold'em No Limit ($0.25/$0.50 USD) - 2020/02/07 22:32:39 ET
Table 'Aaltje III' 6-max Seat #1 is the button
Seat 1: yunteng ($78.69 in chips)
Seat 2: reginaph ($54.48 in chips)
Seat 3: MARGARCIA09 ($59.23 in chips)
Seat 4: Jaby1989 ($51.76 in chips)
Seat 5: Heaton#RISES ($56.06 in chips)
Seat 6: Bodahir ($50 in chips)
reginaph: posts small blind $0.25
MARGARCIA09: posts big blind $0.50
*** HOLE CARDS ***
Jaby1989 has timed out
Jaby1989: folds
Heaton#RISES: folds
Bodahir: folds
yunteng: folds
reginaph: folds
Uncalled bet ($0.25) returned to MARGARCIA09
MARGARCIA09 collected $0.50 from pot
MARGARCIA09: doesn't show hand
*** SUMMARY ***
Total pot $0.50 | Rake $0
Seat 1: yunteng (button) folded before Flop (didn't bet)
Seat 2: reginaph (small blind) folded before Flop
Seat 3: MARGARCIA09 (big blind) collected ($0.50)
Seat 4: Jaby1989 folded before Flop (didn't bet)
Seat 5: Heaton#RISES folded before Flop (didn't bet)
Seat 6: Bodahir folded before Flop (didn't bet)


PokerStars Hand #208961975693:  Hold'em No Limit ($0.25/$0.50 USD) - 2020/02/07 22:33:35 ET
Table 'Aaltje III' 6-max Seat #3 is the button
Seat 1: yunteng ($78.69 in chips)
Seat 2: reginaph ($54.23 in chips)
Seat 3: MARGARCIA09 ($59.98 in chips)
Seat 4: Jaby1989 ($51.26 in chips)
Seat 5: Heaton#RISES ($56.06 in chips)
Seat 6: Bodahir ($50 in chips)
Jaby1989: posts small blind $0.25
Heaton#RISES: posts big blind $0.50
*** HOLE CARDS ***
Bodahir: folds
yunteng: folds
reginaph: folds
MARGARCIA09: raises $1 to $1.50
Jaby1989: folds
Heaton#RISES: folds
Uncalled bet ($1) returned to MARGARCIA09
MARGARCIA09 collected $1.25 from pot
MARGARCIA09: doesn't show hand
*** SUMMARY ***
Total pot $1.25 | Rake $0
Seat 1: yunteng folded before Flop (didn't bet)
Seat 2: reginaph folded before Flop (didn't bet)
Seat 3: MARGARCIA09 (button) collected ($1.25)
Seat 4: Jaby1989 (small blind) folded before Flop
Seat 5: Heaton#RISES (big blind) folded before Flop
Seat 6: Bodahir folded before Flop (didn't bet)


PokerStars Hand #208961964747:  Hold'em No Limit ($0.25/$0.50 USD) - 2020/02/07 22:33:09 ET
Table 'Aaltje III' 6-max Seat #2 is the button
Seat 1: yunteng ($78.69 in chips)
Seat 2: reginaph ($54.23 in chips)
Seat 3: MARGARCIA09 ($59.48 in chips)
Seat 4: Jaby1989 ($51.76 in chips)
Seat 5: Heaton#RISES ($56.06 in chips)
Seat 6: Bodahir ($50 in chips)
MARGARCIA09: posts small blind $0.25
Jaby1989: posts big blind $0.50
*** HOLE CARDS ***
Heaton#RISES: folds
Bodahir: folds
yunteng: folds
reginaph: folds
MARGARCIA09: raises $1 to $1.50
Jaby1989: folds
Uncalled bet ($1) returned to MARGARCIA09
MARGARCIA09 collected $1 from pot
MARGARCIA09: doesn't show hand
*** SUMMARY ***
Total pot $1 | Rake $0
Seat 1: yunteng folded before Flop (didn't bet)
Seat 2: reginaph (button) folded before Flop (didn't bet)
Seat 3: MARGARCIA09 (small blind) collected ($1)
Seat 4: Jaby1989 (big blind) folded before Flop
Seat 5: Heaton#RISES folded before Flop (didn't bet)
Seat 6: Bodahir folded before Flop (didn't bet)


PokerStars Hand #208961982684:  Hold'em No Limit ($0.25/$0.50 USD) - 2020/02/07 22:34:04 ET
Table 'Aaltje III' 6-max Seat #4 is the button
Seat 1: yunteng ($78.69 in chips)
Seat 2: reginaph ($54.23 in chips)
Seat 3: MARGARCIA09 ($60.73 in chips)
Seat 4: Jaby1989 ($51.01 in chips)
Seat 5: Heaton#RISES ($55.56 in chips)
Seat 6: Bodahir ($50 in chips)
Heaton#RISES: posts small blind $0.25
Bodahir: posts big blind $0.50
*** HOLE CARDS ***
yunteng: folds
reginaph: folds
MARGARCIA09: folds
Jaby1989: folds
Heaton#RISES: folds
Uncalled bet ($0.25) returned to Bodahir
Bodahir collected $0.50 from pot
Bodahir: doesn't show hand
*** SUMMARY ***
Total pot $0.50 | Rake $0
Seat 1: yunteng folded before Flop (didn't bet)
Seat 2: reginaph folded before Flop (didn't bet)
Seat 3: MARGARCIA09 folded before Flop (didn't bet)
Seat 4: Jaby1989 (button) folded before Flop (didn't bet)
Seat 5: Heaton#RISES (small blind) folded before Flop
Seat 6: Bodahir (big blind) collected ($0.50)


PokerStars Hand #208961988459:  Hold'em No Limit ($0.25/$0.50 USD) - 2020/02/07 22:34:28 ET
Table 'Aaltje III' 6-max Seat #5 is the button
Seat 1: yunteng ($78.69 in chips)
Seat 2: reginaph ($54.23 in chips)
Seat 3: MARGARCIA09 ($60.73 in chips)
Seat 4: Jaby1989 ($51.01 in chips)
Seat 5: Heaton#RISES ($55.31 in chips)
Seat 6: Bodahir ($50.25 in chips)
Bodahir: posts small blind $0.25
yunteng: posts big blind $0.50
*** HOLE CARDS ***
reginaph: folds
MARGARCIA09: folds
Jaby1989: calls $0.50
Heaton#RISES: raises $1.75 to $2.25
Bodahir: folds
yunteng: folds
Jaby1989: folds
Uncalled bet ($1.75) returned to Heaton#RISES
Heaton#RISES collected $1.75 from pot
Heaton#RISES: doesn't show hand
*** SUMMARY ***
Total pot $1.75 | Rake $0
Seat 1: yunteng (big blind) folded before Flop
Seat 2: reginaph folded before Flop (didn't bet)
Seat 3: MARGARCIA09 folded before Flop (didn't bet)
Seat 4: Jaby1989 folded before Flop
Seat 5: Heaton#RISES (button) collected ($1.75)
Seat 6: Bodahir (small blind) folded before Flop


PokerStars Hand #208961996657:  Hold'em No Limit ($0.25/$0.50 USD) - 2020/02/07 22:35:02 ET
Table 'Aaltje III' 6-max Seat #6 is the button
Seat 1: yunteng ($78.19 in chips)
Seat 2: reginaph ($54.23 in chips)
Seat 3: MARGARCIA09 ($60.73 in chips)
Seat 4: Jaby1989 ($50.51 in chips)
Seat 5: Heaton#RISES ($56.56 in chips)
Seat 6: Bodahir ($50 in chips)
yunteng: posts small blind $0.25
reginaph: posts big blind $0.50
*** HOLE CARDS ***
MARGARCIA09: folds
Jaby1989: raises $0.50 to $1
Heaton#RISES: folds
Bodahir: folds
yunteng: folds
reginaph: folds
Uncalled bet ($0.50) returned to Jaby1989
Jaby1989 collected $1.25 from pot
Jaby1989: doesn't show hand
*** SUMMARY ***
Total pot $1.25 | Rake $0
Seat 1: yunteng (small blind) folded before Flop
Seat 2: reginaph (big blind) folded before Flop
Seat 3: MARGARCIA09 folded before Flop (didn't bet)
Seat 4: Jaby1989 collected ($1.25)
Seat 5: Heaton#RISES folded before Flop (didn't bet)
Seat 6: Bodahir (button) folded before Flop (didn't bet)


PokerStars Hand #208962016096:  Hold'em No Limit ($0.25/$0.50 USD) - 2020/02/07 22:36:24 ET
Table 'Aaltje III' 6-max Seat #2 is the button
Seat 1: yunteng ($79.92 in chips)
Seat 2: reginaph ($53.48 in chips)
Seat 3: MARGARCIA09 ($60.23 in chips)
Seat 5: Heaton#RISES ($55.33 in chips)
Seat 6: Bodahir ($50 in chips)
MARGARCIA09: posts small blind $0.25
Jaby1989 has timed out
Jaby1989: is sitting out
Heaton#RISES: posts big blind $0.50
*** HOLE CARDS ***
Bodahir: raises $1 to $1.50
yunteng: folds
Jaby1989 is disconnected
reginaph: folds
MARGARCIA09: folds
Heaton#RISES: folds
Uncalled bet ($1) returned to Bodahir
Bodahir collected $1.25 from pot
Bodahir: doesn't show hand
*** SUMMARY ***
Total pot $1.25 | Rake $0
Seat 1: yunteng folded before Flop (didn't bet)
Seat 2: reginaph (button) folded before Flop (didn't bet)
Seat 3: MARGARCIA09 (small blind) folded before Flop
Seat 5: Heaton#RISES (big blind) folded before Flop
Seat 6: Bodahir collected ($1.25)


PokerStars Hand #208962004417:  Hold'em No Limit ($0.25/$0.50 USD) - 2020/02/07 22:35:35 ET
Table 'Aaltje III' 6-max Seat #1 is the button
Seat 1: yunteng ($77.94 in chips)
Seat 2: reginaph ($53.73 in chips)
Seat 3: MARGARCIA09 ($60.73 in chips)
Seat 4: Jaby1989 ($51.26 in chips)
Seat 5: Heaton#RISES ($56.56 in chips)
Seat 6: Bodahir ($50 in chips)
reginaph: posts small blind $0.25
MARGARCIA09: posts big blind $0.50
*** HOLE CARDS ***
Jaby1989: folds
Heaton#RISES: raises $0.73 to $1.23
Bodahir: folds
yunteng: raises $3.21 to $4.44
reginaph: folds
MARGARCIA09: folds
Heaton#RISES: folds
Uncalled bet ($3.21) returned to yunteng
yunteng collected $3.21 from pot
yunteng: doesn't show hand
*** SUMMARY ***
Total pot $3.21 | Rake $0
Seat 1: yunteng (button) collected ($3.21)
Seat 2: reginaph (small blind) folded before Flop
Seat 3: MARGARCIA09 (big blind) folded before Flop
Seat 4: Jaby1989 folded before Flop (didn't bet)
Seat 5: Heaton#RISES folded before Flop
Seat 6: Bodahir folded before Flop (didn't bet)


PokerStars Hand #208962039456:  Hold'em No Limit ($0.25/$0.50 USD) - 2020/02/07 22:37:24 ET
Table 'Aaltje III' 6-max Seat #5 is the button
Seat 1: yunteng ($79.92 in chips)
Seat 2: reginaph ($53.48 in chips)
Seat 3: MARGARCIA09 ($59.98 in chips)
Seat 4: Jaby1989 ($51.26 in chips)
Seat 5: Heaton#RISES ($54.58 in chips)
Seat 6: Bodahir ($51 in chips)
Bodahir: posts small blind $0.25
yunteng: posts big blind $0.50
Jaby1989: posts small & big blinds $0.75
*** HOLE CARDS ***
reginaph: folds
MARGARCIA09: folds
Jaby1989: checks
Heaton#RISES: folds
Bodahir: calls $0.25
yunteng: checks
*** FLOP *** [4c Qc Tc]
Bodahir: checks
yunteng: checks
Jaby1989: bets $0.83
Bodahir: folds
yunteng: folds
Uncalled bet ($0.83) returned to Jaby1989
Jaby1989 collected $1.66 from pot
Jaby1989: doesn't show hand
*** SUMMARY ***
Total pot $1.75 | Rake $0.09
Board [4c Qc Tc]
Seat 1: yunteng (big blind) folded on the Flop
Seat 2: reginaph folded before Flop (didn't bet)
Seat 3: MARGARCIA09 folded before Flop (didn't bet)
Seat 4: Jaby1989 collected ($1.66)
Seat 5: Heaton#RISES (button) folded before Flop (didn't bet)
Seat 6: Bodahir (small blind) folded on the Flop


PokerStars Hand #208962034237:  Hold'em No Limit ($0.25/$0.50 USD) - 2020/02/07 22:37:02 ET
Table 'Aaltje III' 6-max Seat #3 is the button
Seat 1: yunteng ($79.92 in chips)
Seat 2: reginaph ($53.48 in chips)
Seat 3: MARGARCIA09 ($59.98 in chips)
Seat 5: Heaton#RISES ($54.83 in chips)
Seat 6: Bodahir ($50.75 in chips)
Heaton#RISES: posts small blind $0.25
Bodahir: posts big blind $0.50
*** HOLE CARDS ***
yunteng: folds
reginaph: folds
MARGARCIA09: folds
Heaton#RISES: folds
Uncalled bet ($0.25) returned to Bodahir
Bodahir collected $0.50 from pot
Bodahir: doesn't show hand
*** SUMMARY ***
Total pot $0.50 | Rake $0
Seat 1: yunteng folded before Flop (didn't bet)
Seat 2: reginaph folded before Flop (didn't bet)
Seat 3: MARGARCIA09 (button) folded before Flop (didn't bet)
Seat 5: Heaton#RISES (small blind) folded before Flop
Seat 6: Bodahir (big blind) collected ($0.50)


PokerStars Hand #208962050516:  Hold'em No Limit ($0.25/$0.50 USD) - 2020/02/07 22:38:10 ET
Table 'Aaltje III' 6-max Seat #6 is the button
Seat 1: yunteng ($79.42 in chips)
Seat 3: MARGARCIA09 ($59.98 in chips)
Seat 4: Jaby1989 ($52.17 in chips)
Seat 5: Heaton#RISES ($54.58 in chips)
Seat 6: Bodahir ($50.50 in chips)
yunteng: posts small blind $0.25
reginaph: is sitting out
MARGARCIA09: posts big blind $0.50
*** HOLE CARDS ***
reginaph leaves the table
Jaby1989: folds
Heaton#RISES: folds
Bodahir: folds
yunteng: folds
Uncalled bet ($0.25) returned to MARGARCIA09
MARGARCIA09 collected $0.50 from pot
MARGARCIA09: doesn't show hand
*** SUMMARY ***
Total pot $0.50 | Rake $0
Seat 1: yunteng (small blind) folded before Flop
Seat 3: MARGARCIA09 (big blind) collected ($0.50)
Seat 4: Jaby1989 folded before Flop (didn't bet)
Seat 5: Heaton#RISES folded before Flop (didn't bet)
Seat 6: Bodahir (button) folded before Flop (didn't bet)


PokerStars Hand #208962053577:  Hold'em No Limit ($0.25/$0.50 USD) - 2020/02/07 22:38:23 ET
Table 'Aaltje III' 6-max Seat #1 is the button
Seat 1: yunteng ($79.17 in chips)
Seat 3: MARGARCIA09 ($60.23 in chips)
Seat 5: Heaton#RISES ($54.58 in chips)
Seat 6: Bodahir ($50.50 in chips)
MARGARCIA09: posts small blind $0.25
Jaby1989 has timed out
Jaby1989: is sitting out
Heaton#RISES: posts big blind $0.50
*** HOLE CARDS ***
Bodahir: raises $1 to $1.50
yunteng: folds
MARGARCIA09: folds
Jaby1989 is disconnected
Heaton#RISES: folds
Uncalled bet ($1) returned to Bodahir
Bodahir collected $1.25 from pot
Bodahir: doesn't show hand
*** SUMMARY ***
Total pot $1.25 | Rake $0
Seat 1: yunteng (button) folded before Flop (didn't bet)
Seat 3: MARGARCIA09 (small blind) folded before Flop
Seat 5: Heaton#RISES (big blind) folded before Flop
Seat 6: Bodahir collected ($1.25)


PokerStars Hand #208962071999:  Hold'em No Limit ($0.25/$0.50 USD) - 2020/02/07 22:39:24 ET
Table 'Aaltje III' 6-max Seat #5 is the button
Seat 1: yunteng ($79.92 in chips)
Seat 3: MARGARCIA09 ($59.98 in chips)
Seat 5: Heaton#RISES ($53.83 in chips)
Seat 6: Bodahir ($50.75 in chips)
Bodahir: posts small blind $0.25
yunteng: posts big blind $0.50
*** HOLE CARDS ***
MARGARCIA09: folds
Heaton#RISES: folds
Bodahir: raises $0.75 to $1.25
yunteng: calls $0.75
*** FLOP *** [Kc 5d 4s]
Bodahir: checks
yunteng: bets $0.83
Bodahir: folds
Uncalled bet ($0.83) returned to yunteng
yunteng collected $2.38 from pot
yunteng: doesn't show hand
*** SUMMARY ***
Total pot $2.50 | Rake $0.12
Board [Kc 5d 4s]
Seat 1: yunteng (big blind) collected ($2.38)
Seat 3: MARGARCIA09 folded before Flop (didn't bet)
Seat 5: Heaton#RISES (button) folded before Flop (didn't bet)
Seat 6: Bodahir (small blind) folded on the Flop


PokerStars Hand #208962066141:  Hold'em No Limit ($0.25/$0.50 USD) - 2020/02/07 22:38:59 ET
Table 'Aaltje III' 6-max Seat #3 is the button
Seat 1: yunteng ($79.17 in chips)
Seat 3: MARGARCIA09 ($59.98 in chips)
Seat 5: Heaton#RISES ($54.08 in chips)
Seat 6: Bodahir ($51.25 in chips)
Heaton#RISES: posts small blind $0.25
Bodahir: posts big blind $0.50
*** HOLE CARDS ***
yunteng: raises $1 to $1.50
MARGARCIA09: folds
Heaton#RISES: folds
Bodahir: folds
Uncalled bet ($1) returned to yunteng
yunteng collected $1.25 from pot
yunteng: doesn't show hand
*** SUMMARY ***
Total pot $1.25 | Rake $0
Seat 1: yunteng collected ($1.25)
Seat 3: MARGARCIA09 (button) folded before Flop (didn't bet)
Seat 5: Heaton#RISES (small blind) folded before Flop
Seat 6: Bodahir (big blind) folded before Flop


PokerStars Hand #208962077121:  Hold'em No Limit ($0.25/$0.50 USD) - 2020/02/07 22:39:45 ET
Table 'Aaltje III' 6-max Seat #6 is the button
Seat 1: yunteng ($81.05 in chips)
Seat 5: Heaton#RISES ($53.83 in chips)
Seat 6: Bodahir ($50 in chips)
yunteng: posts small blind $0.25
MARGARCIA09: is sitting out
Heaton#RISES: posts big blind $0.50
*** HOLE CARDS ***
MARGARCIA09 leaves the table
Bodahir: folds
yunteng: calls $0.25
Heaton#RISES: checks
*** FLOP *** [Kd 7h 3h]
yunteng: checks
Heaton#RISES: checks
*** TURN *** [Kd 7h 3h] [5c]
yunteng: bets $0.52
Heaton#RISES: calls $0.52
*** RIVER *** [Kd 7h 3h 5c] [4h]
yunteng: bets $1.07
Heaton#RISES: folds
Uncalled bet ($1.07) returned to yunteng
yunteng collected $1.94 from pot
yunteng: doesn't show hand
*** SUMMARY ***
Total pot $2.04 | Rake $0.10
Board [Kd 7h 3h 5c 4h]
Seat 1: yunteng (small blind) collected ($1.94)
Seat 5: Heaton#RISES (big blind) folded on the River
Seat 6: Bodahir (button) folded before Flop (didn't bet)


PokerStars Hand #208962090090:  Hold'em No Limit ($0.25/$0.50 USD) - 2020/02/07 22:40:40 ET
Table 'Aaltje III' 6-max Seat #1 is the button
Seat 1: yunteng ($81.97 in chips)
Seat 5: Heaton#RISES ($52.81 in chips)
Seat 6: Bodahir ($50 in chips)
Heaton#RISES: posts small blind $0.25
Bodahir: posts big blind $0.50
*** HOLE CARDS ***
yunteng: raises $0.75 to $1.25
Heaton#RISES: raises $4.50 to $5.75
Bodahir: folds
yunteng: folds
Uncalled bet ($4.50) returned to Heaton#RISES
Heaton#RISES collected $3 from pot
Heaton#RISES: doesn't show hand
*** SUMMARY ***
Total pot $3 | Rake $0
Seat 1: yunteng (button) folded before Flop
Seat 5: Heaton#RISES (small blind) collected ($3)
Seat 6: Bodahir (big blind) folded before Flop


PokerStars Hand #208962103409:  Hold'em No Limit ($0.25/$0.50 USD) - 2020/02/07 22:41:36 ET
Table 'Aaltje III' 6-max Seat #6 is the button
Seat 1: yunteng ($79.47 in chips)
Seat 5: Heaton#RISES ($54.56 in chips)
Seat 6: Bodahir ($51.13 in chips)
yunteng: posts small blind $0.25
Jaby1989 has timed out
Jaby1989: is sitting out
Heaton#RISES: posts big blind $0.50
*** HOLE CARDS ***
Bodahir: raises $1 to $1.50
yunteng: folds
Heaton#RISES: folds
Uncalled bet ($1) returned to Bodahir
yunteng leaves the table
Bodahir collected $1.25 from pot
Bodahir: doesn't show hand
*** SUMMARY ***
Total pot $1.25 | Rake $0
Seat 1: yunteng (small blind) folded before Flop
Seat 5: Heaton#RISES (big blind) folded before Flop
Seat 6: Bodahir (button) collected ($1.25)


PokerStars Hand #208962097463:  Hold'em No Limit ($0.25/$0.50 USD) - 2020/02/07 22:41:11 ET
Table 'Aaltje III' 6-max Seat #5 is the button
Seat 1: yunteng ($80.72 in chips)
Seat 5: Heaton#RISES ($54.56 in chips)
Seat 6: Bodahir ($50 in chips)
Bodahir: posts small blind $0.25
yunteng: posts big blind $0.50
*** HOLE CARDS ***
Heaton#RISES: folds
Bodahir: raises $0.75 to $1.25
yunteng: calls $0.75
*** FLOP *** [8s 5c 9h]
Bodahir: bets $1
yunteng: folds
Uncalled bet ($1) returned to Bodahir
Bodahir collected $2.38 from pot
Bodahir: doesn't show hand
*** SUMMARY ***
Total pot $2.50 | Rake $0.12
Board [8s 5c 9h]
Seat 1: yunteng (big blind) folded on the Flop
Seat 5: Heaton#RISES (button) folded before Flop (didn't bet)
Seat 6: Bodahir (small blind) collected ($2.38)


