PokerStars Hand #227182329888:  Hold'em No Limit ($0.25/$0.50 USD) - 2021/05/30 5:18:25 ET
Table 'Cogshall III' 6-max Seat #2 is the button
Seat 1: RuNoDel ($50 in chips)
Seat 2: voromire ($50 in chips)
Seat 3: donvictor84 ($20 in chips)
donvictor84: posts small blind $0.25
RuNoDel: posts big blind $0.50
*** HOLE CARDS ***
voromire: folds
donvictor84: raises $0.50 to $1
RuNoDel: calls $0.50
*** FLOP *** [3c Kh 5d]
donvictor84: bets $0.75
Barry2103 joins the table at seat #4
blistein joins the table at seat #5
spr1teg joins the table at seat #6
RuNoDel: calls $0.75
*** TURN *** [3c Kh 5d] [4d]
donvictor84: bets $1
RuNoDel: raises $3.75 to $4.75
donvictor84: raises $13.50 to $18.25 and is all-in
RuNoDel: calls $13.50
*** RIVER *** [3c Kh 5d 4d] [Ah]
*** SHOW DOWN ***
donvictor84: shows [7c 6s] (a straight, Three to Seven)
RuNoDel: shows [2c As] (a straight, Ace to Five)
donvictor84 collected $39.25 from pot
*** SUMMARY ***
Total pot $40 | Rake $0.75
Board [3c Kh 5d 4d Ah]
Seat 1: RuNoDel (big blind) showed [2c As] and lost with a straight, Ace to Five
Seat 2: voromire (button) folded before Flop (didn't bet)
Seat 3: donvictor84 (small blind) showed [7c 6s] and won ($39.25) with a straight, Three to Seven


PokerStars Hand #227182392294:  Hold'em No Limit ($0.25/$0.50 USD) - 2021/05/30 5:22:38 ET
Table 'Cogshall III' 6-max Seat #2 is the button
Seat 1: RuNoDel ($50.75 in chips)
Seat 2: voromire ($50 in chips)
Seat 4: Barry2103 ($46.86 in chips)
Seat 5: blistein ($50 in chips)
Barry2103: posts small blind $0.25
blistein: posts big blind $0.50
spr1teg: sits out
*** HOLE CARDS ***
RuNoDel: folds
voromire: folds
Barry2103: calls $0.25
blistein: checks
*** FLOP *** [3c 5s 8s]
Barry2103: checks
blistein: bets $0.52
Barry2103: calls $0.52
*** TURN *** [3c 5s 8s] [4c]
Barry2103: checks
blistein: bets $1.73
Barry2103: calls $1.73
*** RIVER *** [3c 5s 8s 4c] [4h]
Barry2103: checks
blistein: bets $3.75
Barry2103: calls $3.75
*** SHOW DOWN ***
blistein: shows [6c 7s] (a straight, Four to Eight)
Barry2103: mucks hand
blistein collected $12.35 from pot
*** SUMMARY ***
Total pot $13 | Rake $0.65
Board [3c 5s 8s 4c 4h]
Seat 1: RuNoDel folded before Flop (didn't bet)
Seat 2: voromire (button) folded before Flop (didn't bet)
Seat 4: Barry2103 (small blind) mucked
Seat 5: blistein (big blind) showed [6c 7s] and won ($12.35) with a straight, Four to Eight


PokerStars Hand #226512651539:  Hold'em No Limit ($0.25/$0.50 USD) - 2021/05/06 12:26:22 ET
Table 'Toliman' 6-max Seat #6 is the button
Seat 1: xAwwyAx ($24.82 in chips)
Seat 2: ckriszee ($52.29 in chips)
Seat 3: spr1teg ($62.12 in chips)
Seat 4: LuckyJO777 ($50 in chips)
Seat 5: tweeK1001 ($51.50 in chips)
Seat 6: blistein ($50 in chips)
xAwwyAx: posts small blind $0.25
ckriszee: posts big blind $0.50
*** HOLE CARDS ***
spr1teg: folds
LuckyJO777: folds
tweeK1001: folds
blistein: folds
xAwwyAx: calls $0.25
ckriszee: checks
*** FLOP *** [5h 7s Td]
xAwwyAx: checks
ckriszee: checks
*** TURN *** [5h 7s Td] [4c]
xAwwyAx: checks
ckriszee: checks
*** RIVER *** [5h 7s Td 4c] [4s]
xAwwyAx: checks
ckriszee: checks
*** SHOW DOWN ***
xAwwyAx: shows [Qh Ks] (a pair of Fours)
ckriszee: mucks hand
xAwwyAx collected $0.95 from pot
*** SUMMARY ***
Total pot $1 | Rake $0.05
Board [5h 7s Td 4c 4s]
Seat 1: xAwwyAx (small blind) showed [Qh Ks] and won ($0.95) with a pair of Fours
Seat 2: ckriszee (big blind) mucked
Seat 3: spr1teg folded before Flop (didn't bet)
Seat 4: LuckyJO777 folded before Flop (didn't bet)
Seat 5: tweeK1001 folded before Flop (didn't bet)
Seat 6: blistein (button) folded before Flop (didn't bet)


PokerStars Hand #226512685783:  Hold'em No Limit ($0.25/$0.50 USD) - 2021/05/06 12:27:17 ET
Table 'Toliman' 6-max Seat #1 is the button
Seat 1: xAwwyAx ($25.27 in chips)
Seat 2: ckriszee ($51.79 in chips)
Seat 3: spr1teg ($62.12 in chips)
Seat 4: LuckyJO777 ($50 in chips)
Seat 5: tweeK1001 ($51.50 in chips)
Seat 6: blistein ($50 in chips)
ckriszee: posts small blind $0.25
spr1teg: posts big blind $0.50
*** HOLE CARDS ***
LuckyJO777: raises $1 to $1.50
tweeK1001: folds
blistein: folds
xAwwyAx: calls $1.50
ckriszee: folds
spr1teg: calls $1
*** FLOP *** [Tc 4c Ah]
spr1teg: checks
LuckyJO777: checks
xAwwyAx: checks
*** TURN *** [Tc 4c Ah] [Qs]
spr1teg: checks
LuckyJO777: checks
xAwwyAx: checks
*** RIVER *** [Tc 4c Ah Qs] [Td]
spr1teg: checks
LuckyJO777: checks
xAwwyAx: checks
*** SHOW DOWN ***
spr1teg: shows [6h 4h] (two pair, Tens and Fours)
LuckyJO777: shows [8c 8h] (two pair, Tens and Eights)
xAwwyAx: mucks hand
LuckyJO777 collected $4.51 from pot
*** SUMMARY ***
Total pot $4.75 | Rake $0.24
Board [Tc 4c Ah Qs Td]
Seat 1: xAwwyAx (button) mucked
Seat 2: ckriszee (small blind) folded before Flop
Seat 3: spr1teg (big blind) showed [6h 4h] and lost with two pair, Tens and Fours
Seat 4: LuckyJO777 showed [8c 8h] and won ($4.51) with two pair, Tens and Eights
Seat 5: tweeK1001 folded before Flop (didn't bet)
Seat 6: blistein folded before Flop (didn't bet)


PokerStars Hand #226512785894:  Hold'em No Limit ($0.25/$0.50 USD) - 2021/05/06 12:30:54 ET
Table 'Toliman' 6-max Seat #2 is the button
Seat 1: xAwwyAx ($29.53 in chips)
Seat 2: ckriszee ($50.79 in chips)
Seat 3: spr1teg ($60.12 in chips)
Seat 5: tweeK1001 ($50 in chips)
Seat 6: blistein ($54.54 in chips)
spr1teg: posts small blind $0.25
tweeK1001: posts big blind $0.50
*** HOLE CARDS ***
blistein: raises $1 to $1.50
xAwwyAx: calls $1.50
ckriszee: raises $4.50 to $6
spr1teg: folds
tweeK1001: folds
blistein: calls $4.50
xAwwyAx: folds
*** FLOP *** [2c 2s 6h]
blistein: checks
ckriszee: bets $6.77
blistein: calls $6.77
*** TURN *** [2c 2s 6h] [3h]
blistein: checks
ckriszee: checks
*** RIVER *** [2c 2s 6h 3h] [Ah]
blistein: checks
ckriszee: checks
*** SHOW DOWN ***
blistein: shows [8s 8h] (two pair, Eights and Deuces)
ckriszee: shows [Qs Ac] (two pair, Aces and Deuces)
ckriszee collected $26.40 from pot
*** SUMMARY ***
Total pot $27.79 | Rake $1.39
Board [2c 2s 6h 3h Ah]
Seat 1: xAwwyAx folded before Flop
Seat 2: ckriszee (button) showed [Qs Ac] and won ($26.40) with two pair, Aces and Deuces
Seat 3: spr1teg (small blind) folded before Flop
Seat 5: tweeK1001 (big blind) folded before Flop
Seat 6: blistein showed [8s 8h] and lost with two pair, Eights and Deuces


PokerStars Hand #233115952585:  Hold'em No Limit ($0.25/$0.50 USD) - 2022/01/14 2:15:51 ET
Table 'Ostara' 6-max Seat #3 is the button
Seat 1: carson.payner ($36.91 in chips)
Seat 2: blistein ($50 in chips)
Seat 3: ilaviiitech ($51.25 in chips)
Seat 4: Poker9803 ($51.64 in chips)
Seat 5: OccuLtiQ ($50 in chips)
Seat 6: vbnote ($51.80 in chips)
Poker9803: posts small blind $0.25
OccuLtiQ: posts big blind $0.50
*** HOLE CARDS ***
vbnote: folds
carson.payner: calls $0.50
blistein: raises $1.25 to $1.75
ilaviiitech: folds
Poker9803: folds
OccuLtiQ: calls $1.25
carson.payner: calls $1.25
*** FLOP *** [9c 7d 2h]
OccuLtiQ: checks
carson.payner: checks
blistein: bets $1.74
OccuLtiQ: folds
carson.payner: calls $1.74
*** TURN *** [9c 7d 2h] [Qs]
carson.payner: checks
blistein: checks
*** RIVER *** [9c 7d 2h Qs] [Ks]
carson.payner: bets $1
blistein: calls $1
*** SHOW DOWN ***
carson.payner: shows [Kc 8c] (a pair of Kings)
blistein: mucks hand
carson.payner collected $10.43 from pot
*** SUMMARY ***
Total pot $10.98 | Rake $0.55
Board [9c 7d 2h Qs Ks]
Seat 1: carson.payner showed [Kc 8c] and won ($10.43) with a pair of Kings
Seat 2: blistein mucked
Seat 3: ilaviiitech (button) folded before Flop (didn't bet)
Seat 4: Poker9803 (small blind) folded before Flop
Seat 5: OccuLtiQ (big blind) folded on the Flop
Seat 6: vbnote folded before Flop (didn't bet)


PokerStars Hand #233116003522:  Hold'em No Limit ($0.25/$0.50 USD) - 2022/01/14 2:21:24 ET
Table 'Ostara' 6-max Seat #1 is the button
Seat 1: carson.payner ($41.10 in chips)
Seat 2: blistein ($50.25 in chips)
Seat 3: ilaviiitech ($50.75 in chips)
Seat 4: Poker9803 ($51.60 in chips)
Seat 5: OccuLtiQ ($59.40 in chips)
Seat 6: vbnote ($54 in chips)
blistein: posts small blind $0.25
ilaviiitech: posts big blind $0.50
*** HOLE CARDS ***
Poker9803: raises $0.75 to $1.25
OccuLtiQ: folds
vbnote: folds
carson.payner: calls $1.25
blistein: folds
ilaviiitech: folds
*** FLOP *** [2s 7h Tc]
Poker9803: checks
carson.payner: checks
*** TURN *** [2s 7h Tc] [Qc]
Poker9803: checks
carson.payner: bets $1.50
Poker9803: raises $4.50 to $6
carson.payner: calls $4.50
*** RIVER *** [2s 7h Tc Qc] [Ks]
Poker9803: bets $10.87
carson.payner: calls $10.87
*** SHOW DOWN ***
Poker9803: shows [7d 7c] (three of a kind, Sevens)
carson.payner: mucks hand
Poker9803 collected $35.14 from pot
*** SUMMARY ***
Total pot $36.99 | Rake $1.85
Board [2s 7h Tc Qc Ks]
Seat 1: carson.payner (button) mucked
Seat 2: blistein (small blind) folded before Flop
Seat 3: ilaviiitech (big blind) folded before Flop
Seat 4: Poker9803 showed [7d 7c] and won ($35.14) with three of a kind, Sevens
Seat 5: OccuLtiQ folded before Flop (didn't bet)
Seat 6: vbnote folded before Flop (didn't bet)


PokerStars Hand #233116010609:  Hold'em No Limit ($0.25/$0.50 USD) - 2022/01/14 2:22:10 ET
Table 'Ostara' 6-max Seat #2 is the button
Seat 1: carson.payner ($22.98 in chips)
Seat 2: blistein ($50 in chips)
Seat 3: ilaviiitech ($50.25 in chips)
Seat 4: Poker9803 ($68.62 in chips)
Seat 5: OccuLtiQ ($59.40 in chips)
Seat 6: vbnote ($54 in chips)
ilaviiitech: posts small blind $0.25
Poker9803: posts big blind $0.50
*** HOLE CARDS ***
OccuLtiQ: folds
vbnote: folds
carson.payner: calls $0.50
blistein: folds
ilaviiitech: raises $1 to $1.50
Poker9803: calls $1
carson.payner: calls $1
*** FLOP *** [Kh Jc 7d]
ilaviiitech: checks
Poker9803: checks
carson.payner: checks
*** TURN *** [Kh Jc 7d] [6d]
ilaviiitech: checks
Poker9803: checks
carson.payner: checks
*** RIVER *** [Kh Jc 7d 6d] [9s]
ilaviiitech: checks
Poker9803: checks
carson.payner: checks
*** SHOW DOWN ***
ilaviiitech: shows [Tc Jd] (a pair of Jacks)
Poker9803: mucks hand
carson.payner: mucks hand
ilaviiitech collected $4.28 from pot
*** SUMMARY ***
Total pot $4.50 | Rake $0.22
Board [Kh Jc 7d 6d 9s]
Seat 1: carson.payner mucked
Seat 2: blistein (button) folded before Flop (didn't bet)
Seat 3: ilaviiitech (small blind) showed [Tc Jd] and won ($4.28) with a pair of Jacks
Seat 4: Poker9803 (big blind) mucked
Seat 5: OccuLtiQ folded before Flop (didn't bet)
Seat 6: vbnote folded before Flop (didn't bet)


PokerStars Hand #233116040975:  Hold'em No Limit ($0.25/$0.50 USD) - 2022/01/14 2:24:24 ET
Table 'Ostara' 6-max Seat #6 is the button
Seat 1: carson.payner ($22.84 in chips)
Seat 2: blistein ($51.27 in chips)
Seat 3: ilaviiitech ($58.19 in chips)
Seat 4: Poker9803 ($61.21 in chips)
Seat 5: OccuLtiQ ($58.65 in chips)
Seat 6: vbnote ($52.60 in chips)
carson.payner: posts small blind $0.25
blistein: posts big blind $0.50
*** HOLE CARDS ***
ilaviiitech: raises $0.61 to $1.11
Poker9803: folds
OccuLtiQ: calls $1.11
vbnote: calls $1.11
carson.payner: folds
blistein: folds
*** FLOP *** [4c Qc 4s]
ilaviiitech: checks
OccuLtiQ: checks
vbnote: bets $2.33
ilaviiitech: folds
OccuLtiQ: calls $2.33
*** TURN *** [4c Qc 4s] [9d]
OccuLtiQ: checks
vbnote: checks
*** RIVER *** [4c Qc 4s 9d] [6d]
OccuLtiQ: checks
vbnote: checks
*** SHOW DOWN ***
OccuLtiQ: shows [8h 8d] (two pair, Eights and Fours)
vbnote: mucks hand
OccuLtiQ collected $8.30 from pot
*** SUMMARY ***
Total pot $8.74 | Rake $0.44
Board [4c Qc 4s 9d 6d]
Seat 1: carson.payner (small blind) folded before Flop
Seat 2: blistein (big blind) folded before Flop
Seat 3: ilaviiitech folded on the Flop
Seat 4: Poker9803 folded before Flop (didn't bet)
Seat 5: OccuLtiQ showed [8h 8d] and won ($8.30) with two pair, Eights and Fours
Seat 6: vbnote (button) mucked


PokerStars Hand #233116070624:  Hold'em No Limit ($0.25/$0.50 USD) - 2022/01/14 2:27:35 ET
Table 'Ostara' 6-max Seat #6 is the button
Seat 1: carson.payner ($21.95 in chips)
Seat 2: blistein ($55.77 in chips)
Seat 4: Poker9803 ($58.66 in chips)
Seat 5: OccuLtiQ ($61.26 in chips)
Seat 6: vbnote ($50 in chips)
carson.payner: posts small blind $0.25
blistein: posts big blind $0.50
narushev1984: sits out
*** HOLE CARDS ***
Poker9803: folds
OccuLtiQ: folds
vbnote: raises $1 to $1.50
carson.payner: calls $1.25
blistein: folds
*** FLOP *** [Ks 8c Th]
carson.payner: checks
vbnote: checks
*** TURN *** [Ks 8c Th] [4s]
carson.payner: bets $0.50
vbnote: calls $0.50
*** RIVER *** [Ks 8c Th 4s] [9c]
carson.payner: bets $1
vbnote: calls $1
*** SHOW DOWN ***
carson.payner: shows [Qs 5s] (high card King)
vbnote: shows [Kd 2d] (a pair of Kings)
vbnote collected $6.18 from pot
*** SUMMARY ***
Total pot $6.50 | Rake $0.32
Board [Ks 8c Th 4s 9c]
Seat 1: carson.payner (small blind) showed [Qs 5s] and lost with high card King
Seat 2: blistein (big blind) folded before Flop
Seat 4: Poker9803 folded before Flop (didn't bet)
Seat 5: OccuLtiQ folded before Flop (didn't bet)
Seat 6: vbnote (button) showed [Kd 2d] and won ($6.18) with a pair of Kings


PokerStars Hand #233116077014:  Hold'em No Limit ($0.25/$0.50 USD) - 2022/01/14 2:28:16 ET
Table 'Ostara' 6-max Seat #1 is the button
Seat 1: carson.payner ($18.95 in chips)
Seat 2: blistein ($55.27 in chips)
Seat 3: narushev1984 ($50 in chips)
Seat 4: Poker9803 ($58.66 in chips)
Seat 5: OccuLtiQ ($61.26 in chips)
Seat 6: vbnote ($53.18 in chips)
blistein: posts small blind $0.25
narushev1984: posts big blind $0.50
*** HOLE CARDS ***
Poker9803: raises $0.75 to $1.25
OccuLtiQ: folds
vbnote: folds
carson.payner: calls $1.25
blistein: folds
narushev1984: folds
*** FLOP *** [Ts 9d 3c]
Poker9803: bets $1.61
carson.payner: raises $1.61 to $3.22
Poker9803: raises $5.78 to $9
carson.payner: calls $5.78
*** TURN *** [Ts 9d 3c] [Th]
Poker9803: bets $10.50
carson.payner: calls $8.70 and is all-in
Uncalled bet ($1.80) returned to Poker9803
*** RIVER *** [Ts 9d 3c Th] [As]
*** SHOW DOWN ***
Poker9803: shows [Jh Jd] (two pair, Jacks and Tens)
carson.payner: shows [5d Td] (three of a kind, Tens)
carson.payner collected $36.72 from pot
*** SUMMARY ***
Total pot $38.65 | Rake $1.93
Board [Ts 9d 3c Th As]
Seat 1: carson.payner (button) showed [5d Td] and won ($36.72) with three of a kind, Tens
Seat 2: blistein (small blind) folded before Flop
Seat 3: narushev1984 (big blind) folded before Flop
Seat 4: Poker9803 showed [Jh Jd] and lost with two pair, Jacks and Tens
Seat 5: OccuLtiQ folded before Flop (didn't bet)
Seat 6: vbnote folded before Flop (didn't bet)


PokerStars Hand #233116146374:  Hold'em No Limit ($0.25/$0.50 USD) - 2022/01/14 2:35:38 ET
Table 'Ostara' 6-max Seat #2 is the button
Seat 1: carson.payner ($33.43 in chips)
Seat 2: blistein ($50 in chips)
Seat 3: narushev1984 ($61.40 in chips)
Seat 4: Poker9803 ($53.03 in chips)
Seat 5: OccuLtiQ ($61.08 in chips)
Seat 6: vbnote ($50 in chips)
narushev1984: posts small blind $0.25
Poker9803: posts big blind $0.50
*** HOLE CARDS ***
OccuLtiQ: folds
vbnote: folds
carson.payner: calls $0.50
blistein: folds
narushev1984: folds
Poker9803: raises $1.60 to $2.10
carson.payner: calls $1.60
*** FLOP *** [Tc 3h 8h]
Poker9803: checks
carson.payner: bets $1
Poker9803: calls $1
*** TURN *** [Tc 3h 8h] [6h]
Poker9803: checks
carson.payner: checks
*** RIVER *** [Tc 3h 8h 6h] [Qd]
Poker9803: checks
carson.payner: checks
*** SHOW DOWN ***
Poker9803: shows [8s As] (a pair of Eights)
carson.payner: mucks hand
Poker9803 collected $6.13 from pot
*** SUMMARY ***
Total pot $6.45 | Rake $0.32
Board [Tc 3h 8h 6h Qd]
Seat 1: carson.payner mucked
Seat 2: blistein (button) folded before Flop (didn't bet)
Seat 3: narushev1984 (small blind) folded before Flop
Seat 4: Poker9803 (big blind) showed [8s As] and won ($6.13) with a pair of Eights
Seat 5: OccuLtiQ folded before Flop (didn't bet)
Seat 6: vbnote folded before Flop (didn't bet)


PokerStars Hand #233116190097:  Hold'em No Limit ($0.25/$0.50 USD) - 2022/01/14 2:40:12 ET
Table 'Ostara' 6-max Seat #1 is the button
Seat 1: carson.payner ($29.89 in chips)
Seat 2: blistein ($50 in chips)
Seat 3: narushev1984 ($60.50 in chips)
Seat 4: Poker9803 ($76.01 in chips)
Seat 5: OccuLtiQ ($63.55 in chips)
Seat 6: vbnote ($50 in chips)
blistein: posts small blind $0.25
narushev1984: posts big blind $0.50
*** HOLE CARDS ***
Poker9803: folds
OccuLtiQ: folds
vbnote: folds
carson.payner: calls $0.50
blistein: folds
narushev1984: checks
*** FLOP *** [As 6s 7h]
narushev1984: checks
carson.payner: checks
*** TURN *** [As 6s 7h] [Kd]
narushev1984: checks
carson.payner: checks
*** RIVER *** [As 6s 7h Kd] [Qd]
narushev1984: checks
carson.payner: checks
*** SHOW DOWN ***
narushev1984: shows [7c 3c] (a pair of Sevens)
carson.payner: mucks hand
narushev1984 collected $1.19 from pot
*** SUMMARY ***
Total pot $1.25 | Rake $0.06
Board [As 6s 7h Kd Qd]
Seat 1: carson.payner (button) mucked
Seat 2: blistein (small blind) folded before Flop
Seat 3: narushev1984 (big blind) showed [7c 3c] and won ($1.19) with a pair of Sevens
Seat 4: Poker9803 folded before Flop (didn't bet)
Seat 5: OccuLtiQ folded before Flop (didn't bet)
Seat 6: vbnote folded before Flop (didn't bet)


PokerStars Hand #233116194558:  Hold'em No Limit ($0.25/$0.50 USD) - 2022/01/14 2:40:38 ET
Table 'Ostara' 6-max Seat #2 is the button
Seat 1: carson.payner ($29.39 in chips)
Seat 2: blistein ($50 in chips)
Seat 3: narushev1984 ($61.19 in chips)
Seat 4: Poker9803 ($76.01 in chips)
Seat 5: OccuLtiQ ($63.55 in chips)
Seat 6: vbnote ($50 in chips)
narushev1984: posts small blind $0.25
Poker9803: posts big blind $0.50
*** HOLE CARDS ***
OccuLtiQ: folds
vbnote: raises $1 to $1.50
carson.payner: raises $1 to $2.50
blistein: folds
narushev1984: folds
Poker9803: folds
vbnote: calls $1
*** FLOP *** [6s Tc 8d]
vbnote: checks
carson.payner: checks
*** TURN *** [6s Tc 8d] [5s]
vbnote: checks
carson.payner: checks
*** RIVER *** [6s Tc 8d 5s] [7s]
vbnote: checks
carson.payner: checks
*** SHOW DOWN ***
vbnote: shows [4d 4h] (a straight, Four to Eight)
carson.payner: mucks hand
vbnote collected $5.46 from pot
*** SUMMARY ***
Total pot $5.75 | Rake $0.29
Board [6s Tc 8d 5s 7s]
Seat 1: carson.payner mucked
Seat 2: blistein (button) folded before Flop (didn't bet)
Seat 3: narushev1984 (small blind) folded before Flop
Seat 4: Poker9803 (big blind) folded before Flop
Seat 5: OccuLtiQ folded before Flop (didn't bet)
Seat 6: vbnote showed [4d 4h] and won ($5.46) with a straight, Four to Eight


PokerStars Hand #233116213197:  Hold'em No Limit ($0.25/$0.50 USD) - 2022/01/14 2:42:30 ET
Table 'Ostara' 6-max Seat #6 is the button
Seat 1: carson.payner ($26.33 in chips)
Seat 2: blistein ($50.75 in chips)
Seat 3: narushev1984 ($62.30 in chips)
Seat 4: Poker9803 ($75.26 in chips)
Seat 5: OccuLtiQ ($62.80 in chips)
Seat 6: vbnote ($52.21 in chips)
carson.payner: posts small blind $0.25
blistein: posts big blind $0.50
*** HOLE CARDS ***
narushev1984: raises $1 to $1.50
Poker9803: folds
OccuLtiQ: raises $3 to $4.50
vbnote: folds
carson.payner: folds
blistein: folds
narushev1984: calls $3
*** FLOP *** [4s 8d 4h]
narushev1984: checks
OccuLtiQ: bets $4.72
narushev1984: calls $4.72
*** TURN *** [4s 8d 4h] [Kd]
narushev1984: checks
OccuLtiQ: bets $4.38
narushev1984: calls $4.38
*** RIVER *** [4s 8d 4h Kd] [Jd]
narushev1984: checks
OccuLtiQ: checks
*** SHOW DOWN ***
narushev1984: shows [9d 9s] (two pair, Nines and Fours)
OccuLtiQ: mucks hand
narushev1984 collected $26.55 from pot
*** SUMMARY ***
Total pot $27.95 | Rake $1.40
Board [4s 8d 4h Kd Jd]
Seat 1: carson.payner (small blind) folded before Flop
Seat 2: blistein (big blind) folded before Flop
Seat 3: narushev1984 showed [9d 9s] and won ($26.55) with two pair, Nines and Fours
Seat 4: Poker9803 folded before Flop (didn't bet)
Seat 5: OccuLtiQ mucked
Seat 6: vbnote (button) folded before Flop (didn't bet)


PokerStars Hand #233116260961:  Hold'em No Limit ($0.25/$0.50 USD) - 2022/01/14 2:47:26 ET
Table 'Ostara' 6-max Seat #4 is the button
Seat 1: carson.payner ($33.93 in chips)
Seat 2: blistein ($50.75 in chips)
Seat 3: narushev1984 ($74.50 in chips)
Seat 4: Poker9803 ($73.96 in chips)
Seat 5: OccuLtiQ ($50.68 in chips)
Seat 6: vbnote ($52.21 in chips)
OccuLtiQ: posts small blind $0.25
vbnote: posts big blind $0.50
*** HOLE CARDS ***
carson.payner: calls $0.50
blistein: folds
narushev1984: folds
Poker9803: folds
OccuLtiQ: folds
vbnote: checks
*** FLOP *** [7d 4h 2c]
vbnote: checks
carson.payner: checks
*** TURN *** [7d 4h 2c] [Ts]
vbnote: bets $0.71
carson.payner: calls $0.71
*** RIVER *** [7d 4h 2c Ts] [Ks]
vbnote: checks
carson.payner: checks
*** SHOW DOWN ***
vbnote: shows [6s Th] (a pair of Tens)
carson.payner: mucks hand
vbnote collected $2.54 from pot
*** SUMMARY ***
Total pot $2.67 | Rake $0.13
Board [7d 4h 2c Ts Ks]
Seat 1: carson.payner mucked
Seat 2: blistein folded before Flop (didn't bet)
Seat 3: narushev1984 folded before Flop (didn't bet)
Seat 4: Poker9803 (button) folded before Flop (didn't bet)
Seat 5: OccuLtiQ (small blind) folded before Flop
Seat 6: vbnote (big blind) showed [6s Th] and won ($2.54) with a pair of Tens


PokerStars Hand #233116266081:  Hold'em No Limit ($0.25/$0.50 USD) - 2022/01/14 2:47:57 ET
Table 'Ostara' 6-max Seat #5 is the button
Seat 1: carson.payner ($32.72 in chips)
Seat 2: blistein ($50.75 in chips)
Seat 3: narushev1984 ($74.50 in chips)
Seat 4: Poker9803 ($73.96 in chips)
Seat 5: OccuLtiQ ($50.43 in chips)
Seat 6: vbnote ($53.54 in chips)
vbnote: posts small blind $0.25
carson.payner: posts big blind $0.50
*** HOLE CARDS ***
blistein: folds
narushev1984: folds
Poker9803: raises $0.75 to $1.25
OccuLtiQ: folds
vbnote: folds
carson.payner: calls $0.75
*** FLOP *** [9c Th 4s]
carson.payner: checks
Poker9803: bets $0.86
carson.payner: calls $0.86
*** TURN *** [9c Th 4s] [6h]
carson.payner: checks
Poker9803: checks
*** RIVER *** [9c Th 4s 6h] [Ac]
carson.payner: checks
Poker9803: bets $2.21
carson.payner: calls $2.21
*** SHOW DOWN ***
Poker9803: shows [Jd Kc] (high card Ace)
carson.payner: shows [7s 6s] (a pair of Sixes)
carson.payner collected $8.45 from pot
*** SUMMARY ***
Total pot $8.89 | Rake $0.44
Board [9c Th 4s 6h Ac]
Seat 1: carson.payner (big blind) showed [7s 6s] and won ($8.45) with a pair of Sixes
Seat 2: blistein folded before Flop (didn't bet)
Seat 3: narushev1984 folded before Flop (didn't bet)
Seat 4: Poker9803 showed [Jd Kc] and lost with high card Ace
Seat 5: OccuLtiQ (button) folded before Flop (didn't bet)
Seat 6: vbnote (small blind) folded before Flop


PokerStars Hand #233116280897:  Hold'em No Limit ($0.25/$0.50 USD) - 2022/01/14 2:49:28 ET
Table 'Ostara' 6-max Seat #1 is the button
Seat 1: carson.payner ($40.45 in chips)
Seat 2: blistein ($50 in chips)
Seat 3: narushev1984 ($74.50 in chips)
Seat 4: Poker9803 ($69.64 in chips)
Seat 5: OccuLtiQ ($50.43 in chips)
Seat 6: vbnote ($53.29 in chips)
blistein: posts small blind $0.25
narushev1984: posts big blind $0.50
*** HOLE CARDS ***
Poker9803: folds
OccuLtiQ: folds
vbnote: folds
carson.payner: calls $0.50
blistein: folds
narushev1984: checks
*** FLOP *** [Jd 9c Qd]
narushev1984: bets $0.89
carson.payner: calls $0.89
*** TURN *** [Jd 9c Qd] [6s]
narushev1984: checks
carson.payner: checks
*** RIVER *** [Jd 9c Qd 6s] [8d]
narushev1984: checks
carson.payner: bets $1.50
narushev1984: raises $6 to $7.50
carson.payner: calls $6
*** SHOW DOWN ***
narushev1984: shows [Kc 6d] (a pair of Sixes)
carson.payner: shows [Jc 8h] (two pair, Jacks and Eights)
carson.payner collected $17.13 from pot
*** SUMMARY ***
Total pot $18.03 | Rake $0.90
Board [Jd 9c Qd 6s 8d]
Seat 1: carson.payner (button) showed [Jc 8h] and won ($17.13) with two pair, Jacks and Eights
Seat 2: blistein (small blind) folded before Flop
Seat 3: narushev1984 (big blind) showed [Kc 6d] and lost with a pair of Sixes
Seat 4: Poker9803 folded before Flop (didn't bet)
Seat 5: OccuLtiQ folded before Flop (didn't bet)
Seat 6: vbnote folded before Flop (didn't bet)


PokerStars Hand #233116326365:  Hold'em No Limit ($0.25/$0.50 USD) - 2022/01/14 2:53:10 ET
Table 'Ostara' 6-max Seat #5 is the button
Seat 1: carson.payner ($40.28 in chips)
Seat 2: blistein ($62.04 in chips)
Seat 3: narushev1984 ($60.11 in chips)
Seat 4: Poker9803 ($68.89 in chips)
Seat 5: OccuLtiQ ($50 in chips)
Seat 6: vbnote ($54.69 in chips)
vbnote: posts small blind $0.25
carson.payner: posts big blind $0.50
*** HOLE CARDS ***
blistein: folds
narushev1984: raises $1 to $1.50
Poker9803: folds
OccuLtiQ: folds
vbnote: folds
carson.payner: calls $1
*** FLOP *** [2s 7d Kd]
carson.payner: checks
narushev1984: bets $1.55
carson.payner: calls $1.55
*** TURN *** [2s 7d Kd] [6c]
carson.payner: checks
narushev1984: bets $2.50
carson.payner: calls $2.50
*** RIVER *** [2s 7d Kd 6c] [4s]
carson.payner: checks
narushev1984: checks
*** SHOW DOWN ***
carson.payner: shows [3h 7h] (a pair of Sevens)
narushev1984: mucks hand
carson.payner collected $10.78 from pot
*** SUMMARY ***
Total pot $11.35 | Rake $0.57
Board [2s 7d Kd 6c 4s]
Seat 1: carson.payner (big blind) showed [3h 7h] and won ($10.78) with a pair of Sevens
Seat 2: blistein folded before Flop (didn't bet)
Seat 3: narushev1984 mucked
Seat 4: Poker9803 folded before Flop (didn't bet)
Seat 5: OccuLtiQ (button) folded before Flop (didn't bet)
Seat 6: vbnote (small blind) folded before Flop


PokerStars Hand #233116364108:  Hold'em No Limit ($0.25/$0.50 USD) - 2022/01/14 2:57:17 ET
Table 'Ostara' 6-max Seat #5 is the button
Seat 1: carson.payner ($55.52 in chips)
Seat 2: blistein ($55.29 in chips)
Seat 3: narushev1984 ($50 in chips)
Seat 4: Poker9803 ($76.14 in chips)
Seat 5: OccuLtiQ ($50 in chips)
Seat 6: vbnote ($51.94 in chips)
vbnote: posts small blind $0.25
carson.payner: posts big blind $0.50
*** HOLE CARDS ***
blistein: folds
narushev1984: folds
Poker9803: raises $0.75 to $1.25
OccuLtiQ: folds
vbnote: folds
carson.payner: raises $0.75 to $2
Poker9803: calls $0.75
*** FLOP *** [7c 9s Js]
carson.payner: checks
Poker9803: bets $1.33
carson.payner: calls $1.33
*** TURN *** [7c 9s Js] [3c]
carson.payner: checks
Poker9803: bets $4.92
carson.payner: calls $4.92
*** RIVER *** [7c 9s Js 3c] [7d]
carson.payner: checks
Poker9803: checks
*** SHOW DOWN ***
carson.payner: shows [Kd Qc] (a pair of Sevens)
Poker9803: shows [8c 8d] (two pair, Eights and Sevens)
Poker9803 collected $15.91 from pot
*** SUMMARY ***
Total pot $16.75 | Rake $0.84
Board [7c 9s Js 3c 7d]
Seat 1: carson.payner (big blind) showed [Kd Qc] and lost with a pair of Sevens
Seat 2: blistein folded before Flop (didn't bet)
Seat 3: narushev1984 folded before Flop (didn't bet)
Seat 4: Poker9803 showed [8c 8d] and won ($15.91) with two pair, Eights and Sevens
Seat 5: OccuLtiQ (button) folded before Flop (didn't bet)
Seat 6: vbnote (small blind) folded before Flop


PokerStars Hand #233116382212:  Hold'em No Limit ($0.25/$0.50 USD) - 2022/01/14 2:59:03 ET
Table 'Ostara' 6-max Seat #3 is the button
Seat 1: carson.payner ($41.91 in chips)
Seat 2: blistein ($54.54 in chips)
Seat 3: narushev1984 ($55.07 in chips)
Seat 4: Poker9803 ($83.30 in chips)
Seat 5: OccuLtiQ ($50 in chips)
Seat 6: vbnote ($53.19 in chips)
Poker9803: posts small blind $0.25
OccuLtiQ: posts big blind $0.50
*** HOLE CARDS ***
vbnote: folds
carson.payner: calls $0.50
blistein: folds
narushev1984: raises $1.50 to $2
Poker9803: folds
OccuLtiQ: folds
carson.payner: calls $1.50
*** FLOP *** [Kh Qc Qh]
carson.payner: bets $1.50
narushev1984: calls $1.50
*** TURN *** [Kh Qc Qh] [2s]
carson.payner: bets $7.36
narushev1984: raises $44.21 to $51.57 and is all-in
carson.payner: calls $31.05 and is all-in
Uncalled bet ($13.16) returned to narushev1984
*** RIVER *** [Kh Qc Qh 2s] [5h]
*** SHOW DOWN ***
carson.payner: shows [7c Kd] (two pair, Kings and Queens)
narushev1984: shows [8d Qd] (three of a kind, Queens)
narushev1984 collected $82.57 from pot
*** SUMMARY ***
Total pot $84.57 | Rake $2
Board [Kh Qc Qh 2s 5h]
Seat 1: carson.payner showed [7c Kd] and lost with two pair, Kings and Queens
Seat 2: blistein folded before Flop (didn't bet)
Seat 3: narushev1984 (button) showed [8d Qd] and won ($82.57) with three of a kind, Queens
Seat 4: Poker9803 (small blind) folded before Flop
Seat 5: OccuLtiQ (big blind) folded before Flop
Seat 6: vbnote folded before Flop (didn't bet)


PokerStars Hand #233116395698:  Hold'em No Limit ($0.25/$0.50 USD) - 2022/01/14 3:00:36 ET
Table 'Ostara' 6-max Seat #6 is the button
Seat 2: blistein ($54.04 in chips)
Seat 3: narushev1984 ($95.73 in chips)
Seat 4: Poker9803 ($77.55 in chips)
Seat 5: OccuLtiQ ($50.50 in chips)
Seat 6: vbnote ($58.11 in chips)
blistein: posts small blind $0.25
narushev1984: posts big blind $0.50
*** HOLE CARDS ***
Poker9803: folds
OccuLtiQ: raises $0.55 to $1.05
vbnote: folds
blistein: folds
narushev1984: calls $0.55
*** FLOP *** [Qh 2s 9d]
narushev1984: checks
OccuLtiQ: bets $0.54
narushev1984: calls $0.54
*** TURN *** [Qh 2s 9d] [9c]
narushev1984: checks
OccuLtiQ: checks
*** RIVER *** [Qh 2s 9d 9c] [Kh]
narushev1984: checks
BiggAntonio joins the table at seat #1
OccuLtiQ: bets $2.44
narushev1984: calls $2.44
*** SHOW DOWN ***
OccuLtiQ: shows [Js Ah] (a pair of Nines)
narushev1984: shows [3s 3h] (two pair, Nines and Threes)
narushev1984 collected $7.89 from pot
*** SUMMARY ***
Total pot $8.31 | Rake $0.42
Board [Qh 2s 9d 9c Kh]
Seat 2: blistein (small blind) folded before Flop
Seat 3: narushev1984 (big blind) showed [3s 3h] and won ($7.89) with two pair, Nines and Threes
Seat 4: Poker9803 folded before Flop (didn't bet)
Seat 5: OccuLtiQ showed [Js Ah] and lost with a pair of Nines
Seat 6: vbnote (button) folded before Flop (didn't bet)


PokerStars Hand #233116435698:  Hold'em No Limit ($0.25/$0.50 USD) - 2022/01/14 3:04:40 ET
Table 'Ostara' 6-max Seat #2 is the button
Seat 1: BiggAntonio ($43.40 in chips)
Seat 2: blistein ($53.04 in chips)
Seat 3: MaxVedernikov ($55.25 in chips)
Seat 4: Gerafont ($50 in chips)
Seat 5: Ninjamorfar ($45.25 in chips)
Seat 6: vbnote ($57.36 in chips)
MaxVedernikov: posts small blind $0.25
Gerafont: posts big blind $0.50
*** HOLE CARDS ***
Ninjamorfar: folds
vbnote: folds
BiggAntonio: folds
blistein: raises $0.75 to $1.25
MaxVedernikov: folds
Gerafont: calls $0.75
*** FLOP *** [4h Jh 4d]
Gerafont: checks
blistein: bets $0.87
Gerafont: raises $1.63 to $2.50
blistein: calls $1.63
*** TURN *** [4h Jh 4d] [Ah]
Gerafont: checks
blistein: bets $2.50
Gerafont: calls $2.50
*** RIVER *** [4h Jh 4d Ah] [5s]
Gerafont: checks
blistein: checks
*** SHOW DOWN ***
Gerafont: shows [8h Ac] (two pair, Aces and Fours)
blistein: mucks hand
Gerafont collected $12.11 from pot
*** SUMMARY ***
Total pot $12.75 | Rake $0.64
Board [4h Jh 4d Ah 5s]
Seat 1: BiggAntonio folded before Flop (didn't bet)
Seat 2: blistein (button) mucked
Seat 3: MaxVedernikov (small blind) folded before Flop
Seat 4: Gerafont (big blind) showed [8h Ac] and won ($12.11) with two pair, Aces and Fours
Seat 5: Ninjamorfar folded before Flop (didn't bet)
Seat 6: vbnote folded before Flop (didn't bet)


PokerStars Hand #233116455740:  Hold'em No Limit ($0.25/$0.50 USD) - 2022/01/14 3:06:40 ET
Table 'Ostara' 6-max Seat #5 is the button
Seat 1: BiggAntonio ($42.90 in chips)
Seat 2: blistein ($50 in chips)
Seat 3: MaxVedernikov ($55 in chips)
Seat 4: Gerafont ($58.87 in chips)
Seat 5: Ninjamorfar ($49.25 in chips)
Seat 6: vbnote ($55.36 in chips)
vbnote: posts small blind $0.25
BiggAntonio: posts big blind $0.50
*** HOLE CARDS ***
blistein: folds
MaxVedernikov: folds
Gerafont: folds
Ninjamorfar: raises $1 to $1.50
vbnote: raises $4.25 to $5.75
BiggAntonio: folds
Ninjamorfar: calls $4.25
*** FLOP *** [As 7d 2c]
vbnote: bets $6.84
Ninjamorfar: calls $6.84
*** TURN *** [As 7d 2c] [9c]
vbnote: bets $13.42
Ninjamorfar: calls $13.42
*** RIVER *** [As 7d 2c 9c] [6d]
vbnote: bets $29.35 and is all-in
Ninjamorfar: calls $23.24 and is all-in
Uncalled bet ($6.11) returned to vbnote
*** SHOW DOWN ***
vbnote: shows [Qc Ac] (a pair of Aces)
Ninjamorfar: shows [Ad 4d] (a pair of Aces - lower kicker)
vbnote collected $97 from pot
*** SUMMARY ***
Total pot $99 | Rake $2
Board [As 7d 2c 9c 6d]
Seat 1: BiggAntonio (big blind) folded before Flop
Seat 2: blistein folded before Flop (didn't bet)
Seat 3: MaxVedernikov folded before Flop (didn't bet)
Seat 4: Gerafont folded before Flop (didn't bet)
Seat 5: Ninjamorfar (button) showed [Ad 4d] and lost with a pair of Aces
Seat 6: vbnote (small blind) showed [Qc Ac] and won ($97) with a pair of Aces


PokerStars Hand #233116474821:  Hold'em No Limit ($0.25/$0.50 USD) - 2022/01/14 3:08:34 ET
Table 'Ostara' 6-max Seat #3 is the button
Seat 1: BiggAntonio ($42.85 in chips)
Seat 2: blistein ($50 in chips)
Seat 3: MaxVedernikov ($55 in chips)
Seat 4: Gerafont ($59.12 in chips)
Seat 5: Ninjamorfar ($50 in chips)
Seat 6: vbnote ($103.11 in chips)
Gerafont: posts small blind $0.25
Ninjamorfar: posts big blind $0.50
*** HOLE CARDS ***
vbnote: folds
BiggAntonio: folds
blistein: folds
MaxVedernikov: folds
Gerafont: raises $1 to $1.50
Ninjamorfar: calls $1
*** FLOP *** [Ks 2h Js]
Gerafont: checks
Ninjamorfar: checks
*** TURN *** [Ks 2h Js] [2c]
Gerafont: checks
Ninjamorfar: checks
*** RIVER *** [Ks 2h Js 2c] [Kh]
Gerafont: checks
Ninjamorfar: checks
*** SHOW DOWN ***
Gerafont: shows [Th Ah] (two pair, Kings and Deuces)
Ninjamorfar: shows [Ac 8s] (two pair, Kings and Deuces)
Gerafont collected $1.43 from pot
Ninjamorfar collected $1.42 from pot
*** SUMMARY ***
Total pot $3 | Rake $0.15
Board [Ks 2h Js 2c Kh]
Seat 1: BiggAntonio folded before Flop (didn't bet)
Seat 2: blistein folded before Flop (didn't bet)
Seat 3: MaxVedernikov (button) folded before Flop (didn't bet)
Seat 4: Gerafont (small blind) showed [Th Ah] and won ($1.43) with two pair, Kings and Deuces
Seat 5: Ninjamorfar (big blind) showed [Ac 8s] and won ($1.42) with two pair, Kings and Deuces
Seat 6: vbnote folded before Flop (didn't bet)


PokerStars Hand #233116481113:  Hold'em No Limit ($0.25/$0.50 USD) - 2022/01/14 3:09:11 ET
Table 'Ostara' 6-max Seat #4 is the button
Seat 1: BiggAntonio ($42.85 in chips)
Seat 2: blistein ($50 in chips)
Seat 3: MaxVedernikov ($55 in chips)
Seat 4: Gerafont ($59.05 in chips)
Seat 5: Ninjamorfar ($49.92 in chips)
Seat 6: vbnote ($103.11 in chips)
Ninjamorfar: posts small blind $0.25
vbnote: posts big blind $0.50
*** HOLE CARDS ***
BiggAntonio: calls $0.50
blistein: folds
MaxVedernikov: folds
Gerafont: folds
Ninjamorfar: folds
vbnote: checks
*** FLOP *** [Js Jc Th]
vbnote: checks
BiggAntonio: bets $1
vbnote: calls $1
*** TURN *** [Js Jc Th] [6d]
vbnote: checks
BiggAntonio: bets $1.50
vbnote: calls $1.50
*** RIVER *** [Js Jc Th 6d] [Kd]
vbnote: checks
BiggAntonio: checks
*** SHOW DOWN ***
vbnote: shows [Td 7d] (two pair, Jacks and Tens)
BiggAntonio: mucks hand
vbnote collected $5.94 from pot
*** SUMMARY ***
Total pot $6.25 | Rake $0.31
Board [Js Jc Th 6d Kd]
Seat 1: BiggAntonio mucked
Seat 2: blistein folded before Flop (didn't bet)
Seat 3: MaxVedernikov folded before Flop (didn't bet)
Seat 4: Gerafont (button) folded before Flop (didn't bet)
Seat 5: Ninjamorfar (small blind) folded before Flop
Seat 6: vbnote (big blind) showed [Td 7d] and won ($5.94) with two pair, Jacks and Tens


PokerStars Hand #233116488593:  Hold'em No Limit ($0.25/$0.50 USD) - 2022/01/14 3:09:55 ET
Table 'Ostara' 6-max Seat #5 is the button
Seat 1: BiggAntonio ($39.85 in chips)
Seat 2: blistein ($50 in chips)
Seat 3: MaxVedernikov ($55 in chips)
Seat 4: Gerafont ($59.05 in chips)
Seat 5: Ninjamorfar ($49.67 in chips)
Seat 6: vbnote ($106.05 in chips)
vbnote: posts small blind $0.25
BiggAntonio: posts big blind $0.50
*** HOLE CARDS ***
blistein: raises $0.65 to $1.15
MaxVedernikov: folds
Gerafont: raises $2.35 to $3.50
Ninjamorfar: folds
vbnote: folds
BiggAntonio: calls $3
blistein: raises $9.50 to $13
Gerafont: calls $9.50
BiggAntonio: calls $9.50
*** FLOP *** [6h Ah 8d]
BiggAntonio: checks
blistein: checks
Gerafont: bets $46.05 and is all-in
BiggAntonio: calls $26.85 and is all-in
blistein: folds
Uncalled bet ($19.20) returned to Gerafont
*** TURN *** [6h Ah 8d] [Kc]
*** RIVER *** [6h Ah 8d Kc] [6c]
*** SHOW DOWN ***
BiggAntonio: shows [9h 8s] (two pair, Eights and Sixes)
Gerafont: shows [As Ad] (a full house, Aces full of Sixes)
Gerafont collected $90.95 from pot
*** SUMMARY ***
Total pot $92.95 | Rake $2
Board [6h Ah 8d Kc 6c]
Seat 1: BiggAntonio (big blind) showed [9h 8s] and lost with two pair, Eights and Sixes
Seat 2: blistein folded on the Flop
Seat 3: MaxVedernikov folded before Flop (didn't bet)
Seat 4: Gerafont showed [As Ad] and won ($90.95) with a full house, Aces full of Sixes
Seat 5: Ninjamorfar (button) folded before Flop (didn't bet)
Seat 6: vbnote (small blind) folded before Flop


PokerStars Hand #233116503498:  Hold'em No Limit ($0.25/$0.50 USD) - 2022/01/14 3:11:21 ET
Table 'Ostara' 6-max Seat #2 is the button
Seat 2: blistein ($50 in chips)
Seat 3: MaxVedernikov ($55.25 in chips)
Seat 5: Ninjamorfar ($49.67 in chips)
Seat 6: vbnote ($105.80 in chips)
MaxVedernikov: posts small blind $0.25
Ninjamorfar: posts big blind $0.50
*** HOLE CARDS ***
vbnote: folds
blistein: raises $0.75 to $1.25
MaxVedernikov: folds
Ninjamorfar: calls $0.75
*** FLOP *** [7s 4d 9s]
Ninjamorfar: checks
blistein: bets $1.96
Ninjamorfar: calls $1.96
*** TURN *** [7s 4d 9s] [3c]
Ninjamorfar: checks
blistein: bets $4.76
Ninjamorfar: calls $4.76
*** RIVER *** [7s 4d 9s 3c] [Tc]
Ninjamorfar: checks
blistein: checks
*** SHOW DOWN ***
Ninjamorfar: shows [3s 8s] (a pair of Threes)
blistein: shows [Kd 9c] (a pair of Nines)
blistein collected $15.44 from pot
*** SUMMARY ***
Total pot $16.19 | Rake $0.75
Board [7s 4d 9s 3c Tc]
Seat 2: blistein (button) showed [Kd 9c] and won ($15.44) with a pair of Nines
Seat 3: MaxVedernikov (small blind) folded before Flop
Seat 5: Ninjamorfar (big blind) showed [3s 8s] and lost with a pair of Threes
Seat 6: vbnote folded before Flop (didn't bet)


PokerStars Hand #222469886417:  Hold'em No Limit ($0.25/$0.50 USD) - 2021/01/10 13:12:21 ET
Table 'Taygeta III' 6-max Seat #1 is the button
Seat 1: FoKuZ81 ($45.85 in chips)
Seat 2: 7bekon7 ($53.50 in chips)
Seat 3: coolisses111 ($50 in chips)
7bekon7: posts small blind $0.25
coolisses111: posts big blind $0.50
cjerrett: sits out
Punzzzer: sits out
*** HOLE CARDS ***
FoKuZ81: raises $0.50 to $1
7bekon7: calls $0.75
coolisses111: folds
*** FLOP *** [8c 3s 5s]
7bekon7: checks
FoKuZ81: checks
*** TURN *** [8c 3s 5s] [9c]
blistein joins the table at seat #5
Punzzzer leaves the table
7bekon7: bets $1.31
Katerina_xx joins the table at seat #6
FoKuZ81: calls $1.31
*** RIVER *** [8c 3s 5s 9c] [Jc]
7bekon7: checks
FoKuZ81: checks
*** SHOW DOWN ***
7bekon7: shows [8s 7s] (a pair of Eights)
FoKuZ81: shows [Td Jh] (a pair of Jacks)
FoKuZ81 collected $4.86 from pot
*** SUMMARY ***
Total pot $5.12 | Rake $0.26
Board [8c 3s 5s 9c Jc]
Seat 1: FoKuZ81 (button) showed [Td Jh] and won ($4.86) with a pair of Jacks
Seat 2: 7bekon7 (small blind) showed [8s 7s] and lost with a pair of Eights
Seat 3: coolisses111 (big blind) folded before Flop


PokerStars Hand #222469915182:  Hold'em No Limit ($0.25/$0.50 USD) - 2021/01/10 13:12:55 ET
Table 'Taygeta III' 6-max Seat #2 is the button
Seat 1: FoKuZ81 ($48.40 in chips)
Seat 2: 7bekon7 ($51.19 in chips)
Seat 3: coolisses111 ($50 in chips)
Seat 4: cjerrett ($50 in chips)
coolisses111: posts small blind $0.25
cjerrett: posts big blind $0.50
blistein: sits out
Katerina_xx: sits out
*** HOLE CARDS ***
FoKuZ81: raises $0.50 to $1
7bekon7: folds
coolisses111: folds
cjerrett: calls $0.50
*** FLOP *** [4c Th Ac]
cjerrett: checks
FoKuZ81: bets $1.50
cjerrett: calls $1.50
*** TURN *** [4c Th Ac] [3d]
cjerrett: checks
FoKuZ81: bets $3
blistein leaves the table
Philio610 joins the table at seat #5
cjerrett: raises $4 to $7
FoKuZ81: calls $4
*** RIVER *** [4c Th Ac 3d] [As]
cjerrett: bets $13.50
FoKuZ81: calls $13.50
*** SHOW DOWN ***
cjerrett: shows [Ts Ah] (a full house, Aces full of Tens)
FoKuZ81: mucks hand
cjerrett collected $45.50 from pot
*** SUMMARY ***
Total pot $46.25 | Rake $0.75
Board [4c Th Ac 3d As]
Seat 1: FoKuZ81 mucked
Seat 2: 7bekon7 (button) folded before Flop (didn't bet)
Seat 3: coolisses111 (small blind) folded before Flop
Seat 4: cjerrett (big blind) showed [Ts Ah] and won ($45.50) with a full house, Aces full of Tens


PokerStars Hand #220208140672:  Hold'em No Limit ($0.25/$0.50 USD) - 2020/11/09 7:39:32 ET
Table 'Haidea II' 6-max Seat #6 is the button
Seat 1: Adam900000 ($63.96 in chips)
Seat 2: blistein ($50 in chips)
Seat 3: allObar ($56.36 in chips)
Seat 4: ibaCker ($56.49 in chips)
Seat 5: Sakhacop ($50 in chips)
Seat 6: grebenac72 ($22.12 in chips)
Adam900000: posts small blind $0.25
blistein: posts big blind $0.50
*** HOLE CARDS ***
allObar: raises $0.75 to $1.25
ibaCker: folds
Sakhacop: folds
grebenac72: calls $1.25
Adam900000: folds
blistein: folds
*** FLOP *** [4h Tc 6d]
allObar: bets $1.54
grebenac72: calls $1.54
*** TURN *** [4h Tc 6d] [7h]
allObar: bets $6.01
grebenac72: calls $6.01
*** RIVER *** [4h Tc 6d 7h] [Kd]
allObar: bets $47.56 and is all-in
grebenac72: calls $13.32 and is all-in
Uncalled bet ($34.24) returned to allObar
*** SHOW DOWN ***
allObar: shows [Ks Ts] (two pair, Kings and Tens)
grebenac72: shows [Kh Jc] (a pair of Kings)
allObar collected $42.99 from pot
*** SUMMARY ***
Total pot $44.99 | Rake $2
Board [4h Tc 6d 7h Kd]
Seat 1: Adam900000 (small blind) folded before Flop
Seat 2: blistein (big blind) folded before Flop
Seat 3: allObar showed [Ks Ts] and won ($42.99) with two pair, Kings and Tens
Seat 4: ibaCker folded before Flop (didn't bet)
Seat 5: Sakhacop folded before Flop (didn't bet)
Seat 6: grebenac72 (button) showed [Kh Jc] and lost with a pair of Kings


PokerStars Hand #220208163655:  Hold'em No Limit ($0.25/$0.50 USD) - 2020/11/09 7:40:47 ET
Table 'Haidea II' 6-max Seat #3 is the button
Seat 1: Adam900000 ($64.46 in chips)
Seat 2: blistein ($50 in chips)
Seat 3: allObar ($81.54 in chips)
Seat 4: ibaCker ($55.99 in chips)
Seat 5: Sakhacop ($50 in chips)
Seat 6: grebenac72 ($15.18 in chips)
ibaCker: posts small blind $0.25
Sakhacop: posts big blind $0.50
*** HOLE CARDS ***
grebenac72: calls $0.50
Adam900000: folds
blistein: calls $0.50
allObar: folds
ibaCker: calls $0.25
Sakhacop: checks
*** FLOP *** [4d Ts 9s]
ibaCker: checks
Sakhacop: checks
grebenac72: checks
blistein: checks
*** TURN *** [4d Ts 9s] [Th]
ibaCker: bets $0.70
Sakhacop: calls $0.70
grebenac72: folds
blistein: folds
*** RIVER *** [4d Ts 9s Th] [6d]
ibaCker: checks
Sakhacop: checks
*** SHOW DOWN ***
ibaCker: shows [3s 3c] (two pair, Tens and Threes)
Sakhacop: shows [Ad 4s] (two pair, Tens and Fours)
Sakhacop collected $3.23 from pot
*** SUMMARY ***
Total pot $3.40 | Rake $0.17
Board [4d Ts 9s Th 6d]
Seat 1: Adam900000 folded before Flop (didn't bet)
Seat 2: blistein folded on the Turn
Seat 3: allObar (button) folded before Flop (didn't bet)
Seat 4: ibaCker (small blind) showed [3s 3c] and lost with two pair, Tens and Threes
Seat 5: Sakhacop (big blind) showed [Ad 4s] and won ($3.23) with two pair, Tens and Fours
Seat 6: grebenac72 folded on the Turn


PokerStars Hand #226769515871:  Hold'em No Limit ($0.25/$0.50 USD) - 2021/05/15 3:16:50 ET
Table 'Acrab II' 6-max Seat #6 is the button
Seat 1: bogdanesq ($50 in chips)
Seat 2: S`KCEB tm ($50 in chips)
Seat 3: blistein ($50 in chips)
Seat 4: poker4o157 ($59.97 in chips)
Seat 5: eraser2308 ($64.37 in chips)
Seat 6: LarsVegas4994 ($23.89 in chips)
bogdanesq: posts small blind $0.25
S`KCEB tm: posts big blind $0.50
*** HOLE CARDS ***
blistein: folds
poker4o157: folds
eraser2308: folds
LarsVegas4994: calls $0.50
bogdanesq: raises $1.50 to $2
S`KCEB tm: raises $5.25 to $7.25
LarsVegas4994: raises $16.64 to $23.89 and is all-in
bogdanesq: folds
S`KCEB tm: calls $16.64
*** FLOP *** [3h 6s Ac]
*** TURN *** [3h 6s Ac] [8s]
*** RIVER *** [3h 6s Ac 8s] [4h]
*** SHOW DOWN ***
S`KCEB tm: shows [Jd Jh] (a pair of Jacks)
LarsVegas4994: shows [Qs Qc] (a pair of Queens)
LarsVegas4994 collected $47.78 from pot
*** SUMMARY ***
Total pot $49.78 | Rake $2
Board [3h 6s Ac 8s 4h]
Seat 1: bogdanesq (small blind) folded before Flop
Seat 2: S`KCEB tm (big blind) showed [Jd Jh] and lost with a pair of Jacks
Seat 3: blistein folded before Flop (didn't bet)
Seat 4: poker4o157 folded before Flop (didn't bet)
Seat 5: eraser2308 folded before Flop (didn't bet)
Seat 6: LarsVegas4994 (button) showed [Qs Qc] and won ($47.78) with a pair of Queens


PokerStars Hand #226769528986:  Hold'em No Limit ($0.25/$0.50 USD) - 2021/05/15 3:18:01 ET
Table 'Acrab II' 6-max Seat #3 is the button
Seat 1: bogdanesq ($50 in chips)
Seat 2: S`KCEB tm ($50 in chips)
Seat 3: blistein ($50 in chips)
Seat 4: poker4o157 ($60.22 in chips)
Seat 5: eraser2308 ($65.12 in chips)
Seat 6: LarsVegas4994 ($47.78 in chips)
poker4o157: posts small blind $0.25
eraser2308: posts big blind $0.50
*** HOLE CARDS ***
LarsVegas4994: folds
bogdanesq: raises $0.60 to $1.10
S`KCEB tm: raises $2.52 to $3.62
blistein: folds
poker4o157: folds
eraser2308: folds
bogdanesq: calls $2.52
*** FLOP *** [Ad 3s 9h]
bogdanesq: checks
S`KCEB tm: bets $2.50
bogdanesq: calls $2.50
*** TURN *** [Ad 3s 9h] [4h]
bogdanesq: checks
S`KCEB tm: checks
*** RIVER *** [Ad 3s 9h 4h] [Ah]
bogdanesq: checks
S`KCEB tm: checks
*** SHOW DOWN ***
bogdanesq: shows [As 2s] (three of a kind, Aces)
S`KCEB tm: mucks hand
bogdanesq collected $12.34 from pot
*** SUMMARY ***
Total pot $12.99 | Rake $0.65
Board [Ad 3s 9h 4h Ah]
Seat 1: bogdanesq showed [As 2s] and won ($12.34) with three of a kind, Aces
Seat 2: S`KCEB tm mucked
Seat 3: blistein (button) folded before Flop (didn't bet)
Seat 4: poker4o157 (small blind) folded before Flop
Seat 5: eraser2308 (big blind) folded before Flop
Seat 6: LarsVegas4994 folded before Flop (didn't bet)


PokerStars Hand #226769576828:  Hold'em No Limit ($0.25/$0.50 USD) - 2021/05/15 3:22:24 ET
Table 'Acrab II' 6-max Seat #4 is the button
Seat 1: bogdanesq ($56.51 in chips)
Seat 2: S`KCEB tm ($57.07 in chips)
Seat 3: blistein ($50 in chips)
Seat 4: poker4o157 ($59.78 in chips)
Seat 5: eraser2308 ($61.42 in chips)
Seat 6: LarsVegas4994 ($43.29 in chips)
eraser2308: posts small blind $0.25
LarsVegas4994: posts big blind $0.50
*** HOLE CARDS ***
bogdanesq: folds
S`KCEB tm: folds
blistein: folds
poker4o157: folds
eraser2308: calls $0.25
LarsVegas4994: raises $0.50 to $1
eraser2308: calls $0.50
*** FLOP *** [Qh Js Qd]
eraser2308: checks
LarsVegas4994: bets $1
eraser2308: calls $1
*** TURN *** [Qh Js Qd] [2d]
eraser2308: checks
LarsVegas4994: checks
*** RIVER *** [Qh Js Qd 2d] [Ac]
eraser2308: bets $0.50
LarsVegas4994: calls $0.50
*** SHOW DOWN ***
eraser2308: shows [9h Jc] (two pair, Queens and Jacks)
LarsVegas4994: mucks hand
eraser2308 collected $4.75 from pot
*** SUMMARY ***
Total pot $5 | Rake $0.25
Board [Qh Js Qd 2d Ac]
Seat 1: bogdanesq folded before Flop (didn't bet)
Seat 2: S`KCEB tm folded before Flop (didn't bet)
Seat 3: blistein folded before Flop (didn't bet)
Seat 4: poker4o157 (button) folded before Flop (didn't bet)
Seat 5: eraser2308 (small blind) showed [9h Jc] and won ($4.75) with two pair, Queens and Jacks
Seat 6: LarsVegas4994 (big blind) mucked


PokerStars Hand #226769596582:  Hold'em No Limit ($0.25/$0.50 USD) - 2021/05/15 3:24:11 ET
Table 'Acrab II' 6-max Seat #1 is the button
Seat 1: bogdanesq ($53.95 in chips)
Seat 2: S`KCEB tm ($56.57 in chips)
Seat 3: blistein ($50 in chips)
Seat 4: poker4o157 ($60.53 in chips)
Seat 5: eraser2308 ($65.99 in chips)
Seat 6: LarsVegas4994 ($40.54 in chips)
S`KCEB tm: posts small blind $0.25
blistein: posts big blind $0.50
*** HOLE CARDS ***
poker4o157: raises $0.70 to $1.20
eraser2308: folds
LarsVegas4994: calls $1.20
bogdanesq: folds
S`KCEB tm: raises $5.80 to $7
blistein: folds
poker4o157: folds
LarsVegas4994: raises $8.80 to $15.80
S`KCEB tm: raises $23.80 to $39.60
LarsVegas4994: raises $0.94 to $40.54 and is all-in
S`KCEB tm: calls $0.94
*** FLOP *** [4s 2s 9c]
*** TURN *** [4s 2s 9c] [5s]
*** RIVER *** [4s 2s 9c 5s] [7c]
*** SHOW DOWN ***
S`KCEB tm: shows [Jd Jh] (a pair of Jacks)
LarsVegas4994: shows [Kd Ks] (a pair of Kings)
LarsVegas4994 collected $80.78 from pot
*** SUMMARY ***
Total pot $82.78 | Rake $2
Board [4s 2s 9c 5s 7c]
Seat 1: bogdanesq (button) folded before Flop (didn't bet)
Seat 2: S`KCEB tm (small blind) showed [Jd Jh] and lost with a pair of Jacks
Seat 3: blistein (big blind) folded before Flop
Seat 4: poker4o157 folded before Flop
Seat 5: eraser2308 folded before Flop (didn't bet)
Seat 6: LarsVegas4994 showed [Kd Ks] and won ($80.78) with a pair of Kings


PokerStars Hand #226769635896:  Hold'em No Limit ($0.25/$0.50 USD) - 2021/05/15 3:27:18 ET
Table 'Acrab II' 6-max Seat #3 is the button
Seat 1: bogdanesq ($53.20 in chips)
Seat 2: S`KCEB tm ($51.19 in chips)
Seat 3: blistein ($53.30 in chips)
Seat 4: poker4o157 ($56.83 in chips)
Seat 5: eraser2308 ($66.99 in chips)
Seat 6: LarsVegas4994 ($80.34 in chips)
poker4o157: posts small blind $0.25
eraser2308: posts big blind $0.50
*** HOLE CARDS ***
LarsVegas4994: folds
bogdanesq: raises $0.60 to $1.10
S`KCEB tm: raises $2.52 to $3.62
blistein: folds
poker4o157: folds
eraser2308: folds
bogdanesq: calls $2.52
*** FLOP *** [As Kd Jh]
bogdanesq: checks
S`KCEB tm: bets $2.50
bogdanesq: calls $2.50
*** TURN *** [As Kd Jh] [Td]
bogdanesq: checks
S`KCEB tm: checks
*** RIVER *** [As Kd Jh Td] [4h]
bogdanesq: checks
S`KCEB tm: checks
*** SHOW DOWN ***
bogdanesq: shows [Ah 8h] (a pair of Aces)
S`KCEB tm: mucks hand
bogdanesq collected $12.34 from pot
*** SUMMARY ***
Total pot $12.99 | Rake $0.65
Board [As Kd Jh Td 4h]
Seat 1: bogdanesq showed [Ah 8h] and won ($12.34) with a pair of Aces
Seat 2: S`KCEB tm mucked
Seat 3: blistein (button) folded before Flop (didn't bet)
Seat 4: poker4o157 (small blind) folded before Flop
Seat 5: eraser2308 (big blind) folded before Flop
Seat 6: LarsVegas4994 folded before Flop (didn't bet)


PokerStars Hand #226769688548:  Hold'em No Limit ($0.25/$0.50 USD) - 2021/05/15 3:32:05 ET
Table 'Acrab II' 6-max Seat #4 is the button
Seat 1: bogdanesq ($51.73 in chips)
Seat 2: S`KCEB tm ($50 in chips)
Seat 3: blistein ($55.02 in chips)
Seat 4: poker4o157 ($58.22 in chips)
Seat 5: eraser2308 ($72.55 in chips)
Seat 6: LarsVegas4994 ($78.28 in chips)
eraser2308: posts small blind $0.25
LarsVegas4994: posts big blind $0.50
*** HOLE CARDS ***
bogdanesq: folds
S`KCEB tm: raises $0.62 to $1.12
blistein: folds
poker4o157: folds
eraser2308: folds
LarsVegas4994: raises $2.12 to $3.24
S`KCEB tm: calls $2.12
*** FLOP *** [5c 9c Th]
LarsVegas4994: checks
S`KCEB tm: bets $4
LarsVegas4994: raises $7.75 to $11.75
S`KCEB tm: raises $35.01 to $46.76 and is all-in
LarsVegas4994: calls $35.01
*** TURN *** [5c 9c Th] [5d]
*** RIVER *** [5c 9c Th 5d] [Js]
*** SHOW DOWN ***
LarsVegas4994: shows [Ah As] (two pair, Aces and Fives)
S`KCEB tm: shows [Kc Jc] (two pair, Jacks and Fives)
LarsVegas4994 collected $98.25 from pot
*** SUMMARY ***
Total pot $100.25 | Rake $2
Board [5c 9c Th 5d Js]
Seat 1: bogdanesq folded before Flop (didn't bet)
Seat 2: S`KCEB tm showed [Kc Jc] and lost with two pair, Jacks and Fives
Seat 3: blistein folded before Flop (didn't bet)
Seat 4: poker4o157 (button) folded before Flop (didn't bet)
Seat 5: eraser2308 (small blind) folded before Flop
Seat 6: LarsVegas4994 (big blind) showed [Ah As] and won ($98.25) with two pair, Aces and Fives


PokerStars Hand #226769696951:  Hold'em No Limit ($0.25/$0.50 USD) - 2021/05/15 3:32:52 ET
Table 'Acrab II' 6-max Seat #5 is the button
Seat 1: bogdanesq ($51.73 in chips)
Seat 2: S`KCEB tm ($50 in chips)
Seat 3: blistein ($55.02 in chips)
Seat 4: poker4o157 ($58.22 in chips)
Seat 5: eraser2308 ($72.30 in chips)
Seat 6: LarsVegas4994 ($126.53 in chips)
LarsVegas4994: posts small blind $0.25
bogdanesq: posts big blind $0.50
*** HOLE CARDS ***
S`KCEB tm: folds
blistein: folds
poker4o157 has timed out
poker4o157: folds
eraser2308: raises $0.75 to $1.25
LarsVegas4994: calls $1
bogdanesq: calls $0.75
*** FLOP *** [Td 6c Qs]
LarsVegas4994: checks
bogdanesq: checks
eraser2308: checks
*** TURN *** [Td 6c Qs] [Kh]
LarsVegas4994: checks
bogdanesq: bets $1.50
eraser2308: calls $1.50
LarsVegas4994: calls $1.50
*** RIVER *** [Td 6c Qs Kh] [6s]
LarsVegas4994: checks
bogdanesq: checks
eraser2308: checks
*** SHOW DOWN ***
LarsVegas4994: shows [Ac 6h] (three of a kind, Sixes)
bogdanesq: mucks hand
eraser2308: mucks hand
LarsVegas4994 collected $7.84 from pot
*** SUMMARY ***
Total pot $8.25 | Rake $0.41
Board [Td 6c Qs Kh 6s]
Seat 1: bogdanesq (big blind) mucked
Seat 2: S`KCEB tm folded before Flop (didn't bet)
Seat 3: blistein folded before Flop (didn't bet)
Seat 4: poker4o157 folded before Flop (didn't bet)
Seat 5: eraser2308 (button) mucked
Seat 6: LarsVegas4994 (small blind) showed [Ac 6h] and won ($7.84) with three of a kind, Sixes


PokerStars Hand #226769726160:  Hold'em No Limit ($0.25/$0.50 USD) - 2021/05/15 3:35:30 ET
Table 'Acrab II' 6-max Seat #4 is the button
Seat 1: bogdanesq ($51.78 in chips)
Seat 2: S`KCEB tm ($50 in chips)
Seat 3: blistein ($56.62 in chips)
Seat 4: poker4o157 ($56.47 in chips)
bogdanesq: posts small blind $0.25
S`KCEB tm: posts big blind $0.50
*** HOLE CARDS ***
blistein: folds
poker4o157: folds
bogdanesq: raises $0.75 to $1.25
S`KCEB tm: calls $0.75
*** FLOP *** [8h 4h 2s]
bogdanesq: checks
poker4o157 leaves the table
S`KCEB tm: bets $1.75
bogdanesq: calls $1.75
*** TURN *** [8h 4h 2s] [Ah]
bogdanesq: checks
S`KCEB tm: checks
*** RIVER *** [8h 4h 2s Ah] [Jh]
bogdanesq: checks
S`KCEB tm: checks
*** SHOW DOWN ***
bogdanesq: shows [Qd 8d] (a pair of Eights)
S`KCEB tm: shows [9c Jc] (a pair of Jacks)
S`KCEB tm collected $5.70 from pot
*** SUMMARY ***
Total pot $6 | Rake $0.30
Board [8h 4h 2s Ah Jh]
Seat 1: bogdanesq (small blind) showed [Qd 8d] and lost with a pair of Eights
Seat 2: S`KCEB tm (big blind) showed [9c Jc] and won ($5.70) with a pair of Jacks
Seat 3: blistein folded before Flop (didn't bet)
Seat 4: poker4o157 (button) folded before Flop (didn't bet)


PokerStars Hand #228033922182:  Hold'em No Limit ($0.25/$0.50 USD) - 2021/07/03 18:30:42 ET
Table 'Shenzhen IV' 6-max Seat #4 is the button
Seat 2: kaiaman ($61.64 in chips)
Seat 3: Arlongur ($50 in chips)
Seat 4: fohreal ($103.83 in chips)
Seat 6: santamariya89 ($197.57 in chips)
santamariya89: posts small blind $0.25
kaiaman: posts big blind $0.50
*** HOLE CARDS ***
Arlongur: raises $0.75 to $1.25
Velocity15 joins the table at seat #5
fohreal: raises $2.50 to $3.75
santamariya89: folds
kaiaman: folds
Arlongur: calls $2.50
*** FLOP *** [Js 8d Tc]
Arlongur: checks
fohreal: bets $2.59
Velocity15 leaves the table
Arlongur: calls $2.59
*** TURN *** [Js 8d Tc] [Qd]
Arlongur: checks
fohreal: checks
*** RIVER *** [Js 8d Tc Qd] [2h]
blistein joins the table at seat #1
Arlongur: bets $4.21
fohreal: calls $4.21
*** SHOW DOWN ***
Arlongur: shows [Kc Qs] (a pair of Queens)
fohreal: shows [As Ac] (a pair of Aces)
fohreal collected $21.10 from pot
*** SUMMARY ***
Total pot $21.85 | Rake $0.75
Board [Js 8d Tc Qd 2h]
Seat 2: kaiaman (big blind) folded before Flop
Seat 3: Arlongur showed [Kc Qs] and lost with a pair of Queens
Seat 4: fohreal (button) showed [As Ac] and won ($21.10) with a pair of Aces
Seat 6: santamariya89 (small blind) folded before Flop


PokerStars Hand #228033987174:  Hold'em No Limit ($0.25/$0.50 USD) - 2021/07/03 18:33:42 ET
Table 'Shenzhen IV' 6-max Seat #1 is the button
Seat 1: blistein ($50 in chips)
Seat 3: Hercules NL ($25.50 in chips)
Seat 4: fohreal ($115.98 in chips)
Seat 6: santamariya89 ($196.93 in chips)
Hercules NL: posts small blind $0.25
fohreal: posts big blind $0.50
Bu11iT: sits out
*** HOLE CARDS ***
santamariya89: raises $0.75 to $1.25
blistein: folds
Hercules NL: calls $1
fohreal: folds
*** FLOP *** [2d 8h 6d]
Hercules NL: checks
santamariya89: bets $0.95
Hercules NL: calls $0.95
*** TURN *** [2d 8h 6d] [Tc]
Hercules NL: checks
santamariya89: checks
*** RIVER *** [2d 8h 6d Tc] [Ad]
Hercules NL: bets $2.33
santamariya89: calls $2.33
*** SHOW DOWN ***
Hercules NL: shows [Ks Jh] (high card Ace)
santamariya89: shows [Ah Qc] (a pair of Aces)
santamariya89 collected $9.08 from pot
*** SUMMARY ***
Total pot $9.56 | Rake $0.48
Board [2d 8h 6d Tc Ad]
Seat 1: blistein (button) folded before Flop (didn't bet)
Seat 3: Hercules NL (small blind) showed [Ks Jh] and lost with high card Ace
Seat 4: fohreal (big blind) folded before Flop
Seat 6: santamariya89 showed [Ah Qc] and won ($9.08) with a pair of Aces


PokerStars Hand #228034021149:  Hold'em No Limit ($0.25/$0.50 USD) - 2021/07/03 18:35:16 ET
Table 'Shenzhen IV' 6-max Seat #5 is the button
Seat 2: kaiaman ($60.89 in chips)
Seat 3: Hercules NL ($21.66 in chips)
Seat 4: fohreal ($115.23 in chips)
Seat 5: Bu11iT ($50 in chips)
Seat 6: santamariya89 ($200.98 in chips)
santamariya89: posts small blind $0.25
blistein: is sitting out
kaiaman: posts big blind $0.50
*** HOLE CARDS ***
blistein leaves the table
Hercules NL: calls $0.50
fohreal: folds
Bu11iT: folds
santamariya89: calls $0.25
kaiaman: checks
*** FLOP *** [2d Qd 9c]
santamariya89: bets $0.50
vampire131313 joins the table at seat #1
kaiaman: folds
Hercules NL: calls $0.50
*** TURN *** [2d Qd 9c] [3h]
santamariya89: bets $0.79
Hercules NL: calls $0.79
*** RIVER *** [2d Qd 9c 3h] [Tc]
santamariya89: checks
Hercules NL: bets $1.50
santamariya89: calls $1.50
*** SHOW DOWN ***
Hercules NL: shows [Ah 8h] (high card Ace)
santamariya89: shows [Jh 9h] (a pair of Nines)
santamariya89 collected $6.73 from pot
*** SUMMARY ***
Total pot $7.08 | Rake $0.35
Board [2d Qd 9c 3h Tc]
Seat 2: kaiaman (big blind) folded on the Flop
Seat 3: Hercules NL showed [Ah 8h] and lost with high card Ace
Seat 4: fohreal folded before Flop (didn't bet)
Seat 5: Bu11iT (button) folded before Flop (didn't bet)
Seat 6: santamariya89 (small blind) showed [Jh 9h] and won ($6.73) with a pair of Nines


PokerStars Hand #231290600162:  Hold'em No Limit ($0.25/$0.50 USD) - 2021/11/10 10:47:17 ET
Table 'Isa II' 6-max Seat #3 is the button
Seat 1: One23drumm ($52 in chips)
Seat 2: Gatyer14 ($50 in chips)
Seat 3: aqet ($72.74 in chips)
Seat 4: bboywattsy ($52.09 in chips)
Seat 6: Burzum21 ($67.39 in chips)
bboywattsy: posts small blind $0.25
zuzz351: is sitting out
Burzum21: posts big blind $0.50
*** HOLE CARDS ***
One23drumm: folds
One23drumm leaves the table
zuzz351 leaves the table
Gatyer14: folds
aqet: raises $0.75 to $1.25
blistein joins the table at seat #5
bboywattsy: folds
77GEC joins the table at seat #1
Burzum21: calls $0.75
*** FLOP *** [2s 3s 5c]
Burzum21: checks
aqet: bets $0.91
blistein leaves the table
Burzum21: calls $0.91
*** TURN *** [2s 3s 5c] [Qc]
Burzum21: checks
Sanctigallus joins the table at seat #5
aqet: bets $1.52
Burzum21: calls $1.52
*** RIVER *** [2s 3s 5c Qc] [2c]
Burzum21: checks
aqet: bets $3.98
Burzum21: calls $3.98
*** SHOW DOWN ***
aqet: shows [Js Ts] (a pair of Deuces)
Burzum21: shows [8h Qh] (two pair, Queens and Deuces)
Burzum21 collected $14.79 from pot
*** SUMMARY ***
Total pot $15.57 | Rake $0.78
Board [2s 3s 5c Qc 2c]
Seat 1: One23drumm folded before Flop (didn't bet)
Seat 2: Gatyer14 folded before Flop (didn't bet)
Seat 3: aqet (button) showed [Js Ts] and lost with a pair of Deuces
Seat 4: bboywattsy (small blind) folded before Flop
Seat 6: Burzum21 (big blind) showed [8h Qh] and won ($14.79) with two pair, Queens and Deuces


PokerStars Hand #231292252696:  Hold'em No Limit ($0.25/$0.50 USD) - 2021/11/10 12:01:01 ET
Table 'Isa II' 6-max Seat #3 is the button
Seat 1: Collaxd ($52.11 in chips)
Seat 2: xxxZeka ($50 in chips)
Seat 3: blistein ($50 in chips)
Seat 4: GabOo175 ($110.39 in chips)
Seat 5: bronbeek ($42.86 in chips)
Seat 6: TrOtPhoenix ($67.02 in chips)
GabOo175: posts small blind $0.25
bronbeek: posts big blind $0.50
*** HOLE CARDS ***
TrOtPhoenix: folds
Collaxd: folds
xxxZeka: folds
blistein: raises $0.75 to $1.25
GabOo175: folds
bronbeek: calls $0.75
*** FLOP *** [4h Qd 7s]
bronbeek: checks
blistein: bets $0.87
bronbeek: calls $0.87
*** TURN *** [4h Qd 7s] [3c]
bronbeek: checks
blistein: bets $3
bronbeek: calls $3
*** RIVER *** [4h Qd 7s 3c] [7c]
bronbeek: checks
blistein: checks
*** SHOW DOWN ***
bronbeek: shows [Qh 7h] (a full house, Sevens full of Queens)
blistein: mucks hand
bronbeek collected $9.84 from pot
*** SUMMARY ***
Total pot $10.49 | Rake $0.65
Board [4h Qd 7s 3c 7c]
Seat 1: Collaxd folded before Flop (didn't bet)
Seat 2: xxxZeka folded before Flop (didn't bet)
Seat 3: blistein (button) mucked
Seat 4: GabOo175 (small blind) folded before Flop
Seat 5: bronbeek (big blind) showed [Qh 7h] and won ($9.84) with a full house, Sevens full of Queens
Seat 6: TrOtPhoenix folded before Flop (didn't bet)


PokerStars Hand #231292286968:  Hold'em No Limit ($0.25/$0.50 USD) - 2021/11/10 12:02:30 ET
Table 'Isa II' 6-max Seat #1 is the button
Seat 1: Collaxd ($52.11 in chips)
Seat 2: xxxZeka ($51.75 in chips)
Seat 4: GabOo175 ($110.14 in chips)
Seat 5: bronbeek ($48.02 in chips)
Seat 6: TrOtPhoenix ($64.77 in chips)
xxxZeka: posts small blind $0.25
blistein: is sitting out
blistein leaves the table
GabOo175: posts big blind $0.50
*** HOLE CARDS ***
bronbeek: calls $0.50
Tondoplayer joins the table at seat #3
TrOtPhoenix: raises $1.50 to $2
Collaxd: folds
xxxZeka: folds
GabOo175: folds
bronbeek: calls $1.50
*** FLOP *** [7d 6d 5d]
bronbeek: checks
TrOtPhoenix: checks
*** TURN *** [7d 6d 5d] [9c]
bronbeek: checks
TrOtPhoenix: checks
*** RIVER *** [7d 6d 5d 9c] [Td]
bronbeek: checks
TrOtPhoenix: checks
*** SHOW DOWN ***
bronbeek: shows [Qs Ac] (high card Ace)
TrOtPhoenix: shows [Tc Ah] (a pair of Tens)
TrOtPhoenix collected $4.51 from pot
*** SUMMARY ***
Total pot $4.75 | Rake $0.24
Board [7d 6d 5d 9c Td]
Seat 1: Collaxd (button) folded before Flop (didn't bet)
Seat 2: xxxZeka (small blind) folded before Flop
Seat 4: GabOo175 (big blind) folded before Flop
Seat 5: bronbeek showed [Qs Ac] and lost with high card Ace
Seat 6: TrOtPhoenix showed [Tc Ah] and won ($4.51) with a pair of Tens


PokerStars Hand #230475694836:  Hold'em No Limit ($0.25/$0.50 USD) - 2021/10/09 13:11:44 ET
Table 'Kniertje III' 6-max Seat #4 is the button
Seat 2: Serjk1N ($56.49 in chips)
Seat 3: krizz777 ($99.98 in chips)
Seat 4: IamUrlaw ($50.50 in chips)
Seat 5: chechoraiser ($58.43 in chips)
Seat 6: kwazer7 ($50 in chips)
chechoraiser: posts small blind $0.25
kwazer7: posts big blind $0.50
*** HOLE CARDS ***
Serjk1N: folds
Serjk1N leaves the table
krizz777: raises $1 to $1.50
IamUrlaw: raises $3.50 to $5
chechoraiser: folds
kwazer7: folds
krizz777: calls $3.50
*** FLOP *** [Kh 2d Ad]
krizz777: checks
blistein joins the table at seat #2
IamUrlaw: checks
*** TURN *** [Kh 2d Ad] [8h]
krizz777: checks
IamUrlaw: checks
*** RIVER *** [Kh 2d Ad 8h] [Jh]
krizz777: checks
delale77 joins the table at seat #1
IamUrlaw: checks
*** SHOW DOWN ***
krizz777: shows [8s Ts] (a pair of Eights)
IamUrlaw: shows [Qh Qc] (a pair of Queens)
IamUrlaw collected $10.21 from pot
*** SUMMARY ***
Total pot $10.75 | Rake $0.54
Board [Kh 2d Ad 8h Jh]
Seat 2: Serjk1N folded before Flop (didn't bet)
Seat 3: krizz777 showed [8s Ts] and lost with a pair of Eights
Seat 4: IamUrlaw (button) showed [Qh Qc] and won ($10.21) with a pair of Queens
Seat 5: chechoraiser (small blind) folded before Flop
Seat 6: kwazer7 (big blind) folded before Flop


PokerStars Hand #230475788760:  Hold'em No Limit ($0.25/$0.50 USD) - 2021/10/09 13:15:26 ET
Table 'Kniertje III' 6-max Seat #2 is the button
Seat 1: delale77 ($33.03 in chips)
Seat 2: blistein ($50 in chips)
Seat 3: krizz777 ($94.48 in chips)
Seat 4: IamUrlaw ($55.71 in chips)
Seat 5: chechoraiser ($56.93 in chips)
Seat 6: kwazer7 ($53.81 in chips)
krizz777: posts small blind $0.25
IamUrlaw: posts big blind $0.50
*** HOLE CARDS ***
chechoraiser: folds
kwazer7: folds
delale77: raises $1.25 to $1.75
blistein: folds
krizz777: folds
IamUrlaw: calls $1.25
*** FLOP *** [8s 9s 5c]
IamUrlaw: checks
delale77: checks
*** TURN *** [8s 9s 5c] [4s]
IamUrlaw: checks
delale77: bets $3.56
IamUrlaw: calls $3.56
*** RIVER *** [8s 9s 5c 4s] [6h]
IamUrlaw: checks
delale77: checks
*** SHOW DOWN ***
IamUrlaw: shows [Th Qh] (high card Queen)
delale77: shows [5h Kh] (a pair of Fives)
delale77 collected $10.19 from pot
*** SUMMARY ***
Total pot $10.87 | Rake $0.68
Board [8s 9s 5c 4s 6h]
Seat 1: delale77 showed [5h Kh] and won ($10.19) with a pair of Fives
Seat 2: blistein (button) folded before Flop (didn't bet)
Seat 3: krizz777 (small blind) folded before Flop
Seat 4: IamUrlaw (big blind) showed [Th Qh] and lost with high card Queen
Seat 5: chechoraiser folded before Flop (didn't bet)
Seat 6: kwazer7 folded before Flop (didn't bet)


PokerStars Hand #214853879605:  Hold'em No Limit ($0.25/$0.50 USD) - 2020/06/03 11:32:54 ET
Table 'Walkure VI' 6-max Seat #3 is the button
Seat 1: zjuakub ($20 in chips)
Seat 3: zubo636 ($50.25 in chips)
Seat 4: poseidon4546 ($50.50 in chips)
poseidon4546: posts small blind $0.25
zjuakub: posts big blind $0.50
malabar357: sits out
*** HOLE CARDS ***
blistein joins the table at seat #6
zubo636: raises $0.75 to $1.25
poseidon4546: calls $1
zjuakub: calls $0.75
*** FLOP *** [3d Ac Qd]
poseidon4546: checks
zjuakub: checks
zubo636: checks
*** TURN *** [3d Ac Qd] [7d]
poseidon4546: checks
zjuakub: checks
zubo636: bets $1.78
poseidon4546: calls $1.78
zjuakub: folds
*** RIVER *** [3d Ac Qd 7d] [Ts]
poseidon4546: checks
zubo636: checks
*** SHOW DOWN ***
poseidon4546: shows [9h Qc] (a pair of Queens)
zubo636: mucks hand
poseidon4546 collected $6.94 from pot
*** SUMMARY ***
Total pot $7.31 | Rake $0.37
Board [3d Ac Qd 7d Ts]
Seat 1: zjuakub (big blind) folded on the Turn
Seat 3: zubo636 (button) mucked
Seat 4: poseidon4546 (small blind) showed [9h Qc] and won ($6.94) with a pair of Queens


PokerStars Hand #214853987962:  Hold'em No Limit ($0.25/$0.50 USD) - 2020/06/03 11:36:03 ET
Table 'Walkure VI' 6-max Seat #2 is the button
Seat 1: zjuakub ($19.05 in chips)
Seat 2: malabar357 ($50 in chips)
Seat 4: poseidon4546 ($57.42 in chips)
Seat 5: ratmirptbl ($55.55 in chips)
poseidon4546: posts small blind $0.25
zubo636 leaves the table
ratmirptbl: posts big blind $0.50
blistein: sits out
*** HOLE CARDS ***
Iuckyfluke joins the table at seat #3
zjuakub: calls $0.50
malabar357: raises $1.50 to $2
Iuckyfluke leaves the table
poseidon4546: folds
ratmirptbl: folds
zjuakub: calls $1.50
*** FLOP *** [6c Qh 4d]
zjuakub: checks
malabar357: bets $1.49
zjuakub: calls $1.49
*** TURN *** [6c Qh 4d] [3d]
zjuakub: checks
malabar357: checks
*** RIVER *** [6c Qh 4d 3d] [9d]
zjuakub: checks
malabar357: checks
*** SHOW DOWN ***
zjuakub: shows [4c Jh] (a pair of Fours)
malabar357: mucks hand
zjuakub collected $7.34 from pot
*** SUMMARY ***
Total pot $7.73 | Rake $0.39
Board [6c Qh 4d 3d 9d]
Seat 1: zjuakub showed [4c Jh] and won ($7.34) with a pair of Fours
Seat 2: malabar357 (button) mucked
Seat 4: poseidon4546 (small blind) folded before Flop
Seat 5: ratmirptbl (big blind) folded before Flop


PokerStars Hand #214854038671:  Hold'em No Limit ($0.25/$0.50 USD) - 2020/06/03 11:37:31 ET
Table 'Walkure VI' 6-max Seat #5 is the button
Seat 1: zjuakub ($22.40 in chips)
Seat 2: malabar357 ($51.25 in chips)
Seat 4: poseidon4546 ($57.17 in chips)
Seat 5: ratmirptbl ($54.80 in chips)
Seat 6: blistein ($50 in chips)
blistein: posts small blind $0.25
zjuakub: posts big blind $0.50
apdsn: sits out
*** HOLE CARDS ***
malabar357: folds
poseidon4546: folds
ratmirptbl: raises $0.50 to $1
blistein: folds
zjuakub: calls $0.50
*** FLOP *** [2h Ts Jh]
zjuakub: checks
ratmirptbl: bets $1.61
zjuakub: calls $1.61
*** TURN *** [2h Ts Jh] [Ah]
zjuakub: bets $1.50
ratmirptbl: calls $1.50
*** RIVER *** [2h Ts Jh Ah] [7h]
zjuakub: checks
ratmirptbl: bets $4.75
zjuakub: calls $4.75
*** SHOW DOWN ***
ratmirptbl: shows [Jd Kh] (a flush, Ace high)
zjuakub: mucks hand
ratmirptbl collected $17.07 from pot
*** SUMMARY ***
Total pot $17.97 | Rake $0.90
Board [2h Ts Jh Ah 7h]
Seat 1: zjuakub (big blind) mucked
Seat 2: malabar357 folded before Flop (didn't bet)
Seat 4: poseidon4546 folded before Flop (didn't bet)
Seat 5: ratmirptbl (button) showed [Jd Kh] and won ($17.07) with a flush, Ace high
Seat 6: blistein (small blind) folded before Flop


PokerStars Hand #214854071760:  Hold'em No Limit ($0.25/$0.50 USD) - 2020/06/03 11:38:27 ET
Table 'Walkure VI' 6-max Seat #6 is the button
Seat 1: zjuakub ($13.54 in chips)
Seat 2: malabar357 ($51.25 in chips)
Seat 4: poseidon4546 ($57.17 in chips)
Seat 5: ratmirptbl ($63.01 in chips)
Seat 6: blistein ($50 in chips)
zjuakub: posts small blind $0.25
malabar357: posts big blind $0.50
apdsn: sits out
*** HOLE CARDS ***
poseidon4546: folds
ratmirptbl: folds
blistein: folds
zjuakub: calls $0.25
malabar357: checks
*** FLOP *** [4s 4h Jh]
zjuakub: bets $1
malabar357: raises $1.50 to $2.50
zjuakub: raises $1.50 to $4
malabar357: raises $15 to $19
zjuakub: calls $9.04 and is all-in
Uncalled bet ($5.96) returned to malabar357
apdsn leaves the table
*** TURN *** [4s 4h Jh] [2d]
Redman3008 joins the table at seat #3
*** RIVER *** [4s 4h Jh 2d] [Jc]
*** SHOW DOWN ***
zjuakub: shows [Jd 5s] (a full house, Jacks full of Fours)
malabar357: shows [Ac 4d] (a full house, Fours full of Jacks)
Redman3008 leaves the table
zjuakub cashed out the hand for $2.27 | Cash Out Fee $0.02
*** SUMMARY ***
Total pot $27.08 | Rake $1.35
Board [4s 4h Jh 2d Jc]
Seat 1: zjuakub (small blind) showed [Jd 5s] and won ($25.73) with a full house, Jacks full of Fours (pot not awarded as player cashed out)
Seat 2: malabar357 (big blind) showed [Ac 4d] and lost with a full house, Fours full of Jacks
Seat 4: poseidon4546 folded before Flop (didn't bet)
Seat 5: ratmirptbl folded before Flop (didn't bet)
Seat 6: blistein (button) folded before Flop (didn't bet)


PokerStars Hand #214854102301:  Hold'em No Limit ($0.25/$0.50 USD) - 2020/06/03 11:39:09 ET
Table 'Walkure VI' 6-max Seat #1 is the button
Seat 1: zjuakub ($2.27 in chips)
Seat 2: malabar357 ($50 in chips)
Seat 4: poseidon4546 ($57.17 in chips)
Seat 5: ratmirptbl ($63.01 in chips)
Seat 6: blistein ($50 in chips)
malabar357: posts small blind $0.25
poseidon4546: posts big blind $0.50
*** HOLE CARDS ***
Freshf1$h joins the table at seat #3
ratmirptbl: raises $0.75 to $1.25
blistein: folds
zjuakub: calls $1.25
malabar357: folds
poseidon4546: calls $0.75
*** FLOP *** [8d 9d 8s]
poseidon4546: checks
ratmirptbl: checks
zjuakub: bets $0.50
poseidon4546: calls $0.50
ratmirptbl: calls $0.50
*** TURN *** [8d 9d 8s] [6s]
poseidon4546: bets $2.71
ratmirptbl: folds
zjuakub: calls $0.52 and is all-in
Uncalled bet ($2.19) returned to poseidon4546
*** RIVER *** [8d 9d 8s 6s] [5h]
*** SHOW DOWN ***
poseidon4546: shows [Th 7s] (a straight, Six to Ten)
zjuakub: shows [9s 7d] (a straight, Five to Nine)
poseidon4546 collected $6.21 from pot
*** SUMMARY ***
Total pot $6.54 | Rake $0.33
Board [8d 9d 8s 6s 5h]
Seat 1: zjuakub (button) showed [9s 7d] and lost with a straight, Five to Nine
Seat 2: malabar357 (small blind) folded before Flop
Seat 4: poseidon4546 (big blind) showed [Th 7s] and won ($6.21) with a straight, Six to Ten
Seat 5: ratmirptbl folded on the Turn
Seat 6: blistein folded before Flop (didn't bet)


PokerStars Hand #232285602345:  Hold'em No Limit ($0.25/$0.50 USD) - 2021/12/17 6:42:32 ET
Table 'Ceplecha II' 6-max Seat #6 is the button
Seat 1: johammer10 ($25.25 in chips)
Seat 2: blistein ($50 in chips)
Seat 3: LuckyJO777 ($101.75 in chips)
Seat 5: zmakers ($50 in chips)
Seat 6: manuz888 ($74.63 in chips)
johammer10: posts small blind $0.25
blistein: posts big blind $0.50
nastja336: sits out
*** HOLE CARDS ***
LuckyJO777: folds
zmakers: folds
manuz888: folds
johammer10: calls $0.25
blistein: checks
*** FLOP *** [Qh Ah 9h]
johammer10: checks
blistein: bets $0.50
johammer10: calls $0.50
*** TURN *** [Qh Ah 9h] [Jh]
johammer10: checks
blistein: checks
*** RIVER *** [Qh Ah 9h Jh] [Js]
johammer10: checks
blistein: checks
*** SHOW DOWN ***
johammer10: shows [8h Kc] (a flush, Ace high)
blistein: mucks hand
johammer10 collected $1.88 from pot
*** SUMMARY ***
Total pot $2 | Rake $0.12
Board [Qh Ah 9h Jh Js]
Seat 1: johammer10 (small blind) showed [8h Kc] and won ($1.88) with a flush, Ace high
Seat 2: blistein (big blind) mucked
Seat 3: LuckyJO777 folded before Flop (didn't bet)
Seat 5: zmakers folded before Flop (didn't bet)
Seat 6: manuz888 (button) folded before Flop (didn't bet)


PokerStars Hand #232285637622:  Hold'em No Limit ($0.25/$0.50 USD) - 2021/12/17 6:45:05 ET
Table 'Ceplecha II' 6-max Seat #3 is the button
Seat 1: johammer10 ($16.33 in chips)
Seat 2: blistein ($63.15 in chips)
Seat 3: LuckyJO777 ($101 in chips)
Seat 4: nastja336 ($57.27 in chips)
Seat 6: manuz888 ($72.36 in chips)
nastja336: posts small blind $0.25
zmakers: is sitting out
manuz888: posts big blind $0.50
*** HOLE CARDS ***
johammer10: calls $0.50
zmakers leaves the table
blistein: folds
LuckyJO777: folds
nastja336: folds
manuz888: checks
*** FLOP *** [Jc 5c 6d]
manuz888: checks
johammer10: checks
*** TURN *** [Jc 5c 6d] [Jd]
patriot424 joins the table at seat #5
manuz888: checks
johammer10: checks
*** RIVER *** [Jc 5c 6d Jd] [Ad]
manuz888: checks
johammer10: checks
*** SHOW DOWN ***
manuz888: shows [Qs 9h] (a pair of Jacks)
johammer10: shows [Qd Kc] (a pair of Jacks - Ace+King kicker)
johammer10 collected $1.17 from pot
*** SUMMARY ***
Total pot $1.25 | Rake $0.08
Board [Jc 5c 6d Jd Ad]
Seat 1: johammer10 showed [Qd Kc] and won ($1.17) with a pair of Jacks
Seat 2: blistein folded before Flop (didn't bet)
Seat 3: LuckyJO777 (button) folded before Flop (didn't bet)
Seat 4: nastja336 (small blind) folded before Flop
Seat 6: manuz888 (big blind) showed [Qs 9h] and lost with a pair of Jacks


PokerStars Hand #216097256783:  Hold'em No Limit ($0.25/$0.50 USD) - 2020/07/05 8:40:29 ET
Table 'Thyestes V' 6-max Seat #1 is the button
Seat 1: eeeLOVEnkov ($55.31 in chips)
Seat 4: danufcs ($50 in chips)
Seat 6: Robairto ($63.03 in chips)
danufcs: posts small blind $0.25
sHn0bel: is sitting out
Robairto: posts big blind $0.50
*** HOLE CARDS ***
eeeLOVEnkov: raises $0.75 to $1.25
danufcs: folds
sHn0bel leaves the table
blistein joins the table at seat #3
Robairto: raises $2.50 to $3.75
FamousJMAC joins the table at seat #2
realphenom joins the table at seat #5
eeeLOVEnkov: calls $2.50
*** FLOP *** [8d 4s Kh]
Robairto: bets $4.50
blistein leaves the table
eeeLOVEnkov: calls $4.50
*** TURN *** [8d 4s Kh] [5c]
Lakaem45 joins the table at seat #3
Robairto: bets $8
eeeLOVEnkov: calls $8
*** RIVER *** [8d 4s Kh 5c] [9c]
Robairto: checks
eeeLOVEnkov: checks
*** SHOW DOWN ***
Robairto: shows [Qh Ad] (high card Ace)
eeeLOVEnkov: shows [Jc Kc] (a pair of Kings)
eeeLOVEnkov collected $32 from pot
*** SUMMARY ***
Total pot $32.75 | Rake $0.75
Board [8d 4s Kh 5c 9c]
Seat 1: eeeLOVEnkov (button) showed [Jc Kc] and won ($32) with a pair of Kings
Seat 4: danufcs (small blind) folded before Flop
Seat 6: Robairto (big blind) showed [Qh Ad] and lost with high card Ace


PokerStars Hand #228961469370:  Hold'em No Limit ($0.25/$0.50 USD) - 2021/08/10 16:31:00 ET
Table 'Hertha IV' 6-max Seat #3 is the button
Seat 1: $iganov1 ($53.20 in chips)
Seat 2: Mr.Lancer1 ($14.35 in chips)
Seat 3: davie2k ($36.92 in chips)
Seat 4: blistein ($50 in chips)
Seat 5: vampire131313 ($53.93 in chips)
Seat 6: PleBeY95 ($50 in chips)
blistein: posts small blind $0.25
vampire131313: posts big blind $0.50
*** HOLE CARDS ***
PleBeY95: folds
$iganov1: folds
Mr.Lancer1: calls $0.50
davie2k: calls $0.50
blistein: calls $0.25
vampire131313: checks
*** FLOP *** [5d Jc Ac]
blistein: checks
vampire131313: checks
Mr.Lancer1: bets $1
davie2k: folds
blistein: raises $3.10 to $4.10
vampire131313: folds
Mr.Lancer1: raises $9.75 to $13.85 and is all-in
blistein: calls $9.75
*** TURN *** [5d Jc Ac] [6d]
*** RIVER *** [5d Jc Ac 6d] [4d]
*** SHOW DOWN ***
blistein: shows [Js 5s] (two pair, Jacks and Fives)
Mr.Lancer1: shows [6h Ah] (two pair, Aces and Sixes)
Mr.Lancer1 collected $28.22 from pot
*** SUMMARY ***
Total pot $29.70 | Rake $1.48
Board [5d Jc Ac 6d 4d]
Seat 1: $iganov1 folded before Flop (didn't bet)
Seat 2: Mr.Lancer1 showed [6h Ah] and won ($28.22) with two pair, Aces and Sixes
Seat 3: davie2k (button) folded on the Flop
Seat 4: blistein (small blind) showed [Js 5s] and lost with two pair, Jacks and Fives
Seat 5: vampire131313 (big blind) folded on the Flop
Seat 6: PleBeY95 folded before Flop (didn't bet)


PokerStars Hand #228961486158:  Hold'em No Limit ($0.25/$0.50 USD) - 2021/08/10 16:31:37 ET
Table 'Hertha IV' 6-max Seat #4 is the button
Seat 1: $iganov1 ($53.20 in chips)
Seat 2: Mr.Lancer1 ($28.22 in chips)
Seat 3: davie2k ($36.42 in chips)
Seat 4: blistein ($50 in chips)
Seat 5: vampire131313 ($53.43 in chips)
Seat 6: PleBeY95 ($50 in chips)
vampire131313: posts small blind $0.25
PleBeY95: posts big blind $0.50
*** HOLE CARDS ***
$iganov1: raises $0.65 to $1.15
Mr.Lancer1: calls $1.15
davie2k: folds
blistein: folds
vampire131313: folds
PleBeY95: folds
*** FLOP *** [8c 5c 6s]
$iganov1: bets $0.96
Mr.Lancer1: calls $0.96
*** TURN *** [8c 5c 6s] [8h]
$iganov1: bets $0.75
Mr.Lancer1: calls $0.75
*** RIVER *** [8c 5c 6s 8h] [9h]
$iganov1: bets $0.50
Mr.Lancer1: calls $0.50
*** SHOW DOWN ***
$iganov1: shows [9s Js] (two pair, Nines and Eights)
Mr.Lancer1: mucks hand
$iganov1 collected $7.10 from pot
*** SUMMARY ***
Total pot $7.47 | Rake $0.37
Board [8c 5c 6s 8h 9h]
Seat 1: $iganov1 showed [9s Js] and won ($7.10) with two pair, Nines and Eights
Seat 2: Mr.Lancer1 mucked
Seat 3: davie2k folded before Flop (didn't bet)
Seat 4: blistein (button) folded before Flop (didn't bet)
Seat 5: vampire131313 (small blind) folded before Flop
Seat 6: PleBeY95 (big blind) folded before Flop


PokerStars Hand #228961627148:  Hold'em No Limit ($0.25/$0.50 USD) - 2021/08/10 16:36:39 ET
Table 'Hertha IV' 6-max Seat #1 is the button
Seat 1: $iganov1 ($54.74 in chips)
Seat 2: Mr.Lancer1 ($20.94 in chips)
Seat 3: davie2k ($40.66 in chips)
Seat 4: blistein ($55.35 in chips)
Seat 5: vampire131313 ($52.43 in chips)
Seat 6: PleBeY95 ($50 in chips)
Mr.Lancer1: posts small blind $0.25
davie2k: posts big blind $0.50
*** HOLE CARDS ***
blistein: folds
vampire131313: raises $0.75 to $1.25
PleBeY95: folds
$iganov1: folds
Mr.Lancer1: calls $1
davie2k: folds
*** FLOP *** [5d Ad 4c]
Mr.Lancer1: checks
vampire131313: bets $0.94
Mr.Lancer1: raises $1.44 to $2.38
vampire131313: calls $1.44
*** TURN *** [5d Ad 4c] [8h]
Mr.Lancer1: bets $4.18
vampire131313: calls $4.18
*** RIVER *** [5d Ad 4c 8h] [Ah]
Mr.Lancer1: bets $13.13 and is all-in
vampire131313: calls $13.13
*** SHOW DOWN ***
Mr.Lancer1: shows [As 5h] (a full house, Aces full of Fives)
vampire131313: shows [Js Jc] (two pair, Aces and Jacks)
Mr.Lancer1 collected $40.38 from pot
*** SUMMARY ***
Total pot $42.38 | Rake $2
Board [5d Ad 4c 8h Ah]
Seat 1: $iganov1 (button) folded before Flop (didn't bet)
Seat 2: Mr.Lancer1 (small blind) showed [As 5h] and won ($40.38) with a full house, Aces full of Fives
Seat 3: davie2k (big blind) folded before Flop
Seat 4: blistein folded before Flop (didn't bet)
Seat 5: vampire131313 showed [Js Jc] and lost with two pair, Aces and Jacks
Seat 6: PleBeY95 folded before Flop (didn't bet)


PokerStars Hand #228961763567:  Hold'em No Limit ($0.25/$0.50 USD) - 2021/08/10 16:41:36 ET
Table 'Hertha IV' 6-max Seat #2 is the button
Seat 1: $iganov1 ($55.49 in chips)
Seat 2: Mr.Lancer1 ($41.91 in chips)
Seat 3: davie2k ($40.55 in chips)
Seat 4: blistein ($50 in chips)
Seat 5: vampire131313 ($50 in chips)
Seat 6: PleBeY95 ($54.81 in chips)
davie2k: posts small blind $0.25
blistein: posts big blind $0.50
*** HOLE CARDS ***
vampire131313: folds
PleBeY95: raises $1 to $1.50
$iganov1: folds
Mr.Lancer1: calls $1.50
davie2k: calls $1.25
blistein: folds
*** FLOP *** [Ts 3h 8h]
davie2k: checks
PleBeY95: checks
Mr.Lancer1: bets $2.87
davie2k: raises $5.25 to $8.12
PleBeY95: raises $45.19 to $53.31 and is all-in
Mr.Lancer1: folds
davie2k: calls $30.93 and is all-in
Uncalled bet ($14.26) returned to PleBeY95
*** TURN *** [Ts 3h 8h] [Js]
*** RIVER *** [Ts 3h 8h Js] [Jd]
*** SHOW DOWN ***
davie2k: shows [Qh Th] (two pair, Jacks and Tens)
PleBeY95: shows [8d 8c] (a full house, Eights full of Jacks)
PleBeY95 collected $83.97 from pot
*** SUMMARY ***
Total pot $85.97 | Rake $2
Board [Ts 3h 8h Js Jd]
Seat 1: $iganov1 folded before Flop (didn't bet)
Seat 2: Mr.Lancer1 (button) folded on the Flop
Seat 3: davie2k (small blind) showed [Qh Th] and lost with two pair, Jacks and Tens
Seat 4: blistein (big blind) folded before Flop
Seat 5: vampire131313 folded before Flop (didn't bet)
Seat 6: PleBeY95 showed [8d 8c] and won ($83.97) with a full house, Eights full of Jacks


PokerStars Hand #228961802601:  Hold'em No Limit ($0.25/$0.50 USD) - 2021/08/10 16:43:01 ET
Table 'Hertha IV' 6-max Seat #4 is the button
Seat 1: $iganov1 ($55.49 in chips)
Seat 2: Mr.Lancer1 ($37.54 in chips)
Seat 4: blistein ($50 in chips)
Seat 5: vampire131313 ($50 in chips)
Seat 6: PleBeY95 ($98.23 in chips)
vampire131313: posts small blind $0.25
PleBeY95: posts big blind $0.50
*** HOLE CARDS ***
$iganov1: folds
Mr.Lancer1: raises $1 to $1.50
blistein: folds
vampire131313: folds
PleBeY95: calls $1
*** FLOP *** [2s 7d Ah]
PleBeY95: checks
Mr.Lancer1: checks
*** TURN *** [2s 7d Ah] [4d]
PleBeY95: checks
Mr.Lancer1: checks
*** RIVER *** [2s 7d Ah 4d] [Qs]
PleBeY95: bets $4.64
Mr.Lancer1: calls $4.64
*** SHOW DOWN ***
PleBeY95: shows [Ac 9c] (a pair of Aces)
Mr.Lancer1: mucks hand
PleBeY95 collected $11.90 from pot
*** SUMMARY ***
Total pot $12.53 | Rake $0.63
Board [2s 7d Ah 4d Qs]
Seat 1: $iganov1 folded before Flop (didn't bet)
Seat 2: Mr.Lancer1 mucked
Seat 4: blistein (button) folded before Flop (didn't bet)
Seat 5: vampire131313 (small blind) folded before Flop
Seat 6: PleBeY95 (big blind) showed [Ac 9c] and won ($11.90) with a pair of Aces


PokerStars Hand #228961995168:  Hold'em No Limit ($0.25/$0.50 USD) - 2021/08/10 16:49:58 ET
Table 'Hertha IV' 6-max Seat #6 is the button
Seat 1: $iganov1 ($50.29 in chips)
Seat 2: Mr.Lancer1 ($37.92 in chips)
Seat 4: blistein ($50 in chips)
Seat 5: vampire131313 ($51.50 in chips)
Seat 6: PleBeY95 ($102.43 in chips)
$iganov1: posts small blind $0.25
Mr.Lancer1: posts big blind $0.50
*** HOLE CARDS ***
blistein: folds
vampire131313: folds
PleBeY95: folds
$iganov1: raises $1 to $1.50
Mr.Lancer1: raises $3 to $4.50
$iganov1: calls $3
*** FLOP *** [9d Jh 7h]
$iganov1: checks
Mr.Lancer1: checks
*** TURN *** [9d Jh 7h] [5s]
$iganov1: bets $8
Mr.Lancer1: calls $8
*** RIVER *** [9d Jh 7h 5s] [6c]
$iganov1: bets $37.79 and is all-in
Mr.Lancer1: calls $25.42 and is all-in
Uncalled bet ($12.37) returned to $iganov1
*** SHOW DOWN ***
$iganov1: shows [Ks Th] (high card King)
Mr.Lancer1: shows [8s Ac] (a straight, Five to Nine)
Mr.Lancer1 collected $73.84 from pot
*** SUMMARY ***
Total pot $75.84 | Rake $2
Board [9d Jh 7h 5s 6c]
Seat 1: $iganov1 (small blind) showed [Ks Th] and lost with high card King
Seat 2: Mr.Lancer1 (big blind) showed [8s Ac] and won ($73.84) with a straight, Five to Nine
Seat 4: blistein folded before Flop (didn't bet)
Seat 5: vampire131313 folded before Flop (didn't bet)
Seat 6: PleBeY95 (button) folded before Flop (didn't bet)


PokerStars Hand #228962069219:  Hold'em No Limit ($0.25/$0.50 USD) - 2021/08/10 16:52:23 ET
Table 'Hertha IV' 6-max Seat #6 is the button
Seat 1: $iganov1 ($50 in chips)
Seat 2: Mr.Lancer1 ($71.51 in chips)
Seat 4: blistein ($50 in chips)
Seat 5: vampire131313 ($55.08 in chips)
Seat 6: PleBeY95 ($102.68 in chips)
$iganov1: posts small blind $0.25
Mr.Lancer1: posts big blind $0.50
wild_mouse01: sits out
*** HOLE CARDS ***
blistein: folds
vampire131313: raises $0.75 to $1.25
PleBeY95: folds
$iganov1: calls $1
Mr.Lancer1: folds
*** FLOP *** [Ac 7c 7d]
$iganov1: checks
vampire131313: bets $0.94
$iganov1: calls $0.94
*** TURN *** [Ac 7c 7d] [4s]
$iganov1: checks
vampire131313: bets $3.06
$iganov1: calls $3.06
*** RIVER *** [Ac 7c 7d 4s] [Jh]
$iganov1: checks
vampire131313: checks
*** SHOW DOWN ***
$iganov1: shows [Tc As] (two pair, Aces and Sevens)
vampire131313: mucks hand
$iganov1 collected $10.45 from pot
*** SUMMARY ***
Total pot $11 | Rake $0.55
Board [Ac 7c 7d 4s Jh]
Seat 1: $iganov1 (small blind) showed [Tc As] and won ($10.45) with two pair, Aces and Sevens
Seat 2: Mr.Lancer1 (big blind) folded before Flop
Seat 4: blistein folded before Flop (didn't bet)
Seat 5: vampire131313 mucked
Seat 6: PleBeY95 (button) folded before Flop (didn't bet)


PokerStars Hand #228962141634:  Hold'em No Limit ($0.25/$0.50 USD) - 2021/08/10 16:54:50 ET
Table 'Hertha IV' 6-max Seat #5 is the button
Seat 2: Mr.Lancer1 ($90.72 in chips)
Seat 3: wild_mouse01 ($50 in chips)
Seat 4: blistein ($50 in chips)
Seat 5: vampire131313 ($50 in chips)
Seat 6: PleBeY95 ($97.68 in chips)
PleBeY95: posts small blind $0.25
Mr.Lancer1: posts big blind $0.50
*** HOLE CARDS ***
wild_mouse01: folds
blistein: folds
vampire131313: folds
PleBeY95: raises $1 to $1.50
Mr.Lancer1: calls $1
*** FLOP *** [2c 3h 6c]
PleBeY95: bets $0.94
Mr.Lancer1: calls $0.94
*** TURN *** [2c 3h 6c] [4c]
PleBeY95: bets $3.48
Mr.Lancer1: calls $3.48
*** RIVER *** [2c 3h 6c 4c] [Jc]
PleBeY95: bets $5
Mr.Lancer1: calls $5
*** SHOW DOWN ***
PleBeY95: shows [Kc Ad] (a flush, King high)
Mr.Lancer1: mucks hand
PleBeY95 collected $20.75 from pot
*** SUMMARY ***
Total pot $21.84 | Rake $1.09
Board [2c 3h 6c 4c Jc]
Seat 2: Mr.Lancer1 (big blind) mucked
Seat 3: wild_mouse01 folded before Flop (didn't bet)
Seat 4: blistein folded before Flop (didn't bet)
Seat 5: vampire131313 (button) folded before Flop (didn't bet)
Seat 6: PleBeY95 (small blind) showed [Kc Ad] and won ($20.75) with a flush, King high


PokerStars Hand #228962157449:  Hold'em No Limit ($0.25/$0.50 USD) - 2021/08/10 16:55:19 ET
Table 'Hertha IV' 6-max Seat #6 is the button
Seat 2: Mr.Lancer1 ($79.80 in chips)
Seat 3: wild_mouse01 ($50 in chips)
Seat 4: blistein ($50 in chips)
Seat 5: vampire131313 ($50 in chips)
Seat 6: PleBeY95 ($107.51 in chips)
Mr.Lancer1: posts small blind $0.25
wild_mouse01: posts big blind $0.50
*** HOLE CARDS ***
blistein: raises $1 to $1.50
vampire131313: folds
PleBeY95: folds
Mr.Lancer1: calls $1.25
wild_mouse01: folds
*** FLOP *** [Th 5s 8c]
Mr.Lancer1: bets $3.32
blistein: raises $5.93 to $9.25
Mr.Lancer1: raises $69.05 to $78.30 and is all-in
blistein: calls $39.25 and is all-in
Uncalled bet ($29.80) returned to Mr.Lancer1
*** TURN *** [Th 5s 8c] [6c]
*** RIVER *** [Th 5s 8c 6c] [8d]
*** SHOW DOWN ***
Mr.Lancer1: shows [8h Ts] (a full house, Eights full of Tens)
blistein: shows [Qh Qc] (two pair, Queens and Eights)
Mr.Lancer1 collected $98.50 from pot
*** SUMMARY ***
Total pot $100.50 | Rake $2
Board [Th 5s 8c 6c 8d]
Seat 2: Mr.Lancer1 (small blind) showed [8h Ts] and won ($98.50) with a full house, Eights full of Tens
Seat 3: wild_mouse01 (big blind) folded before Flop
Seat 4: blistein showed [Qh Qc] and lost with two pair, Queens and Eights
Seat 5: vampire131313 folded before Flop (didn't bet)
Seat 6: PleBeY95 (button) folded before Flop (didn't bet)


PokerStars Hand #215435863352:  Hold'em No Limit ($0.25/$0.50 USD) - 2020/06/17 7:38:05 ET
Table 'Wratislavia II' 6-max Seat #3 is the button
Seat 1: LitviN88 ($50.90 in chips)
Seat 2: sircatres ($53.06 in chips)
Seat 3: Rusyaha ($54.72 in chips)
Seat 4: blistein ($50 in chips)
Seat 6: Rinoldo87 ($32.15 in chips)
blistein: posts small blind $0.25
Shibakov: is sitting out
Rinoldo87: posts big blind $0.50
*** HOLE CARDS ***
LitviN88: folds
sircatres: folds
Rusyaha: folds
blistein: raises $1 to $1.50
Rinoldo87: calls $1
*** FLOP *** [Jd 6d 4h]
blistein: checks
Rinoldo87: bets $1.50
blistein: calls $1.50
*** TURN *** [Jd 6d 4h] [4c]
blistein: checks
Rinoldo87: checks
*** RIVER *** [Jd 6d 4h 4c] [2s]
blistein: checks
Rinoldo87: bets $3
blistein: calls $3
*** SHOW DOWN ***
Rinoldo87: shows [7c 7h] (two pair, Sevens and Fours)
blistein: mucks hand
Rinoldo87 collected $11.40 from pot
*** SUMMARY ***
Total pot $12 | Rake $0.60
Board [Jd 6d 4h 4c 2s]
Seat 1: LitviN88 folded before Flop (didn't bet)
Seat 2: sircatres folded before Flop (didn't bet)
Seat 3: Rusyaha (button) folded before Flop (didn't bet)
Seat 4: blistein (small blind) mucked
Seat 6: Rinoldo87 (big blind) showed [7c 7h] and won ($11.40) with two pair, Sevens and Fours


PokerStars Hand #215435934580:  Hold'em No Limit ($0.25/$0.50 USD) - 2020/06/17 7:41:30 ET
Table 'Wratislavia II' 6-max Seat #4 is the button
Seat 1: LitviN88 ($52.50 in chips)
Seat 2: sircatres ($52.42 in chips)
Seat 3: Rusyaha ($54.72 in chips)
Seat 4: blistein ($57.50 in chips)
Seat 5: Shibakov ($51.78 in chips)
Seat 6: Rinoldo87 ($28.87 in chips)
Shibakov: posts small blind $0.25
Rinoldo87: posts big blind $0.50
*** HOLE CARDS ***
LitviN88: folds
sircatres: raises $1 to $1.50
Rusyaha: folds
blistein: calls $1.50
Shibakov: folds
Rinoldo87: calls $1
*** FLOP *** [9s 5s 6d]
Rinoldo87: checks
sircatres: checks
blistein: bets $1.58
Rinoldo87: raises $3.92 to $5.50
sircatres: folds
blistein: raises $32.50 to $38
Rinoldo87: calls $21.87 and is all-in
Uncalled bet ($10.63) returned to blistein
*** TURN *** [9s 5s 6d] [2s]
*** RIVER *** [9s 5s 6d 2s] [3c]
*** SHOW DOWN ***
Rinoldo87: shows [7d 8s] (a straight, Five to Nine)
blistein: shows [Ks Js] (a flush, King high)
blistein collected $57.49 from pot
Rinoldo87 cashed out the hand for $37.66 | Cash Out Fee $0.38
*** SUMMARY ***
Total pot $59.49 | Rake $2
Board [9s 5s 6d 2s 3c]
Seat 1: LitviN88 folded before Flop (didn't bet)
Seat 2: sircatres folded on the Flop
Seat 3: Rusyaha folded before Flop (didn't bet)
Seat 4: blistein (button) showed [Ks Js] and won ($57.49) with a flush, King high
Seat 5: Shibakov (small blind) folded before Flop
Seat 6: Rinoldo87 (big blind) showed [7d 8s] and lost with a straight, Five to Nine (cashed out).


PokerStars Hand #215435993132:  Hold'em No Limit ($0.25/$0.50 USD) - 2020/06/17 7:44:17 ET
Table 'Wratislavia II' 6-max Seat #3 is the button
Seat 1: LitviN88 ($51.25 in chips)
Seat 2: sircatres ($50.17 in chips)
Seat 3: Rusyaha ($52.97 in chips)
Seat 4: blistein ($84.12 in chips)
Seat 5: Shibakov ($52.37 in chips)
Seat 6: Rinoldo87 ($41.96 in chips)
blistein: posts small blind $0.25
Shibakov: posts big blind $0.50
*** HOLE CARDS ***
Rinoldo87: calls $0.50
LitviN88: folds
sircatres: folds
Rusyaha: raises $2 to $2.50
blistein: folds
Shibakov: folds
Rinoldo87: calls $2
*** FLOP *** [Ah As 6h]
Rinoldo87: checks
Rusyaha: bets $3.50
Rinoldo87: raises $3.50 to $7
Rusyaha: calls $3.50
*** TURN *** [Ah As 6h] [3c]
Rinoldo87: bets $9.50
Rusyaha: calls $9.50
*** RIVER *** [Ah As 6h 3c] [3s]
Rinoldo87: checks
Rusyaha: checks
*** SHOW DOWN ***
Rinoldo87: shows [7d Kd] (two pair, Aces and Threes)
Rusyaha: shows [6s 6c] (a full house, Sixes full of Aces)
Rusyaha collected $36.81 from pot
*** SUMMARY ***
Total pot $38.75 | Rake $1.94
Board [Ah As 6h 3c 3s]
Seat 1: LitviN88 folded before Flop (didn't bet)
Seat 2: sircatres folded before Flop (didn't bet)
Seat 3: Rusyaha (button) showed [6s 6c] and won ($36.81) with a full house, Sixes full of Aces
Seat 4: blistein (small blind) folded before Flop
Seat 5: Shibakov (big blind) folded before Flop
Seat 6: Rinoldo87 showed [7d Kd] and lost with two pair, Aces and Threes


PokerStars Hand #215436023146:  Hold'em No Limit ($0.25/$0.50 USD) - 2020/06/17 7:45:43 ET
Table 'Wratislavia II' 6-max Seat #6 is the button
Seat 1: LitviN88 ($51.50 in chips)
Seat 2: sircatres ($50.17 in chips)
Seat 3: Rusyaha ($70.78 in chips)
Seat 4: blistein ($83.87 in chips)
Seat 5: Shibakov ($52.32 in chips)
Seat 6: Rinoldo87 ($22.21 in chips)
LitviN88: posts small blind $0.25
sircatres: posts big blind $0.50
*** HOLE CARDS ***
Rusyaha: folds
blistein: folds
Shibakov: folds
Rinoldo87: calls $0.50
LitviN88: raises $1.50 to $2
sircatres: calls $1.50
Rinoldo87: calls $1.50
*** FLOP *** [Qc Ks Ts]
LitviN88: bets $2.85
sircatres: folds
Rinoldo87: raises $4.35 to $7.20
LitviN88: raises $42.30 to $49.50 and is all-in
Rinoldo87: calls $13.01 and is all-in
Uncalled bet ($29.29) returned to LitviN88
*** TURN *** [Qc Ks Ts] [3c]
*** RIVER *** [Qc Ks Ts 3c] [9d]
*** SHOW DOWN ***
LitviN88: shows [Jh Ac] (a straight, Ten to Ace)
Rinoldo87: shows [Kd 6c] (a pair of Kings)
LitviN88 collected $44.42 from pot
Rinoldo87 cashed out the hand for $1.44 | Cash Out Fee $0.01
*** SUMMARY ***
Total pot $46.42 | Rake $2
Board [Qc Ks Ts 3c 9d]
Seat 1: LitviN88 (small blind) showed [Jh Ac] and won ($44.42) with a straight, Ten to Ace
Seat 2: sircatres (big blind) folded on the Flop
Seat 3: Rusyaha folded before Flop (didn't bet)
Seat 4: blistein folded before Flop (didn't bet)
Seat 5: Shibakov folded before Flop (didn't bet)
Seat 6: Rinoldo87 (button) showed [Kd 6c] and lost with a pair of Kings (cashed out).


PokerStars Hand #215436041857:  Hold'em No Limit ($0.25/$0.50 USD) - 2020/06/17 7:46:36 ET
Table 'Wratislavia II' 6-max Seat #1 is the button
Seat 1: LitviN88 ($73.71 in chips)
Seat 2: sircatres ($50 in chips)
Seat 3: Rusyaha ($70.78 in chips)
Seat 4: blistein ($83.87 in chips)
Seat 5: Shibakov ($52.32 in chips)
Seat 6: Rinoldo87 ($1.44 in chips)
sircatres: posts small blind $0.25
Rusyaha: posts big blind $0.50
*** HOLE CARDS ***
blistein: folds
Shibakov: folds
Rinoldo87: raises $0.94 to $1.44 and is all-in
blistein leaves the table
LitviN88: folds
eraser2308 joins the table at seat #4
sircatres: raises $3.56 to $5
Rusyaha: folds
Uncalled bet ($3.56) returned to sircatres
*** FLOP *** [Qs Td Jc]
*** TURN *** [Qs Td Jc] [9h]
*** RIVER *** [Qs Td Jc 9h] [8d]
*** SHOW DOWN ***
sircatres: shows [Ks Kd] (a straight, Nine to King)
Rinoldo87: shows [4h 5c] (a straight, Eight to Queen)
sircatres collected $3.21 from pot
*** SUMMARY ***
Total pot $3.38 | Rake $0.17
Board [Qs Td Jc 9h 8d]
Seat 1: LitviN88 (button) folded before Flop (didn't bet)
Seat 2: sircatres (small blind) showed [Ks Kd] and won ($3.21) with a straight, Nine to King
Seat 3: Rusyaha (big blind) folded before Flop
Seat 4: blistein folded before Flop (didn't bet)
Seat 5: Shibakov folded before Flop (didn't bet)
Seat 6: Rinoldo87 showed [4h 5c] and lost with a straight, Eight to Queen


PokerStars Hand #216096597773:  Hold'em No Limit ($0.25/$0.50 USD) - 2020/07/05 8:13:03 ET
Table 'Irpedina IV' 6-max Seat #2 is the button
Seat 1: T999SE ($26.48 in chips)
Seat 2: xattabbychEV ($62.89 in chips)
Seat 3: blistein ($50.50 in chips)
Seat 4: I LOVE RUS34 ($50 in chips)
Seat 6: sxcgirl696969 ($51.10 in chips)
blistein: posts small blind $0.25
I LOVE RUS34: posts big blind $0.50
supern0v8: sits out
*** HOLE CARDS ***
sxcgirl696969: folds
T999SE: raises $1 to $1.50
xattabbychEV: folds
blistein: raises $3 to $4.50
I LOVE RUS34: folds
T999SE: calls $3
*** FLOP *** [Jc Qh Ah]
blistein: bets $30.25
T999SE: calls $21.98 and is all-in
Uncalled bet ($8.27) returned to blistein
*** TURN *** [Jc Qh Ah] [8h]
*** RIVER *** [Jc Qh Ah 8h] [6h]
*** SHOW DOWN ***
blistein: shows [Jd Ad] (two pair, Aces and Jacks)
T999SE: shows [Ac 9s] (a pair of Aces)
blistein collected $51.46 from pot
T999SE cashed out the hand for $4.75 | Cash Out Fee $0.05
*** SUMMARY ***
Total pot $53.46 | Rake $2
Board [Jc Qh Ah 8h 6h]
Seat 1: T999SE showed [Ac 9s] and lost with a pair of Aces (cashed out).
Seat 2: xattabbychEV (button) folded before Flop (didn't bet)
Seat 3: blistein (small blind) showed [Jd Ad] and won ($51.46) with two pair, Aces and Jacks
Seat 4: I LOVE RUS34 (big blind) folded before Flop
Seat 6: sxcgirl696969 folded before Flop (didn't bet)


PokerStars Hand #216096618264:  Hold'em No Limit ($0.25/$0.50 USD) - 2020/07/05 8:13:57 ET
Table 'Irpedina IV' 6-max Seat #4 is the button
Seat 1: T999SE ($4.75 in chips)
Seat 2: xattabbychEV ($62.89 in chips)
Seat 3: blistein ($74.23 in chips)
Seat 4: I LOVE RUS34 ($51.75 in chips)
Seat 5: supern0v8 ($50 in chips)
Seat 6: sxcgirl696969 ($51.10 in chips)
supern0v8: posts small blind $0.25
sxcgirl696969: posts big blind $0.50
*** HOLE CARDS ***
T999SE: raises $4.25 to $4.75 and is all-in
xattabbychEV: folds
blistein: folds
I LOVE RUS34: folds
supern0v8: folds
sxcgirl696969: calls $4.25
*** FLOP *** [3h 9c 7h]
*** TURN *** [3h 9c 7h] [As]
*** RIVER *** [3h 9c 7h As] [7s]
*** SHOW DOWN ***
sxcgirl696969: shows [9h Ah] (two pair, Aces and Nines)
T999SE: shows [Kh Jh] (a pair of Sevens)
sxcgirl696969 collected $9.26 from pot
*** SUMMARY ***
Total pot $9.75 | Rake $0.49
Board [3h 9c 7h As 7s]
Seat 1: T999SE showed [Kh Jh] and lost with a pair of Sevens
Seat 2: xattabbychEV folded before Flop (didn't bet)
Seat 3: blistein folded before Flop (didn't bet)
Seat 4: I LOVE RUS34 (button) folded before Flop (didn't bet)
Seat 5: supern0v8 (small blind) folded before Flop
Seat 6: sxcgirl696969 (big blind) showed [9h Ah] and won ($9.26) with two pair, Aces and Nines


PokerStars Hand #225520098025:  Hold'em No Limit ($0.25/$0.50 USD) - 2021/04/05 1:27:04 ET
Table 'Uppsala II' 6-max Seat #2 is the button
Seat 1: S1HED ($168.48 in chips)
Seat 2: Grant[NY] ($50 in chips)
Seat 3: GunnarTwoSeven ($41.50 in chips)
Seat 4: chiller_8918 ($28.40 in chips)
Seat 6: bulhakau ($52.11 in chips)
GunnarTwoSeven: posts small blind $0.25
chiller_8918: posts big blind $0.50
blistein: sits out
*** HOLE CARDS ***
bulhakau: folds
S1HED: raises $0.75 to $1.25
Grant[NY]: calls $1.25
GunnarTwoSeven: calls $1
chiller_8918: raises $0.75 to $2
S1HED: calls $0.75
Grant[NY]: calls $0.75
GunnarTwoSeven: calls $0.75
*** FLOP *** [Jc 4c Js]
GunnarTwoSeven: checks
chiller_8918: bets $1
S1HED: folds
Grant[NY]: calls $1
GunnarTwoSeven: folds
*** TURN *** [Jc 4c Js] [4s]
chiller_8918: bets $3
Grant[NY]: calls $3
*** RIVER *** [Jc 4c Js 4s] [8s]
chiller_8918: bets $7.60
Grant[NY]: calls $7.60
*** SHOW DOWN ***
chiller_8918: shows [Kh Qd] (two pair, Jacks and Fours)
Grant[NY]: shows [5d 5h] (two pair, Jacks and Fives)
Grant[NY] collected $29.64 from pot
*** SUMMARY ***
Total pot $31.20 | Rake $1.56
Board [Jc 4c Js 4s 8s]
Seat 1: S1HED folded on the Flop
Seat 2: Grant[NY] (button) showed [5d 5h] and won ($29.64) with two pair, Jacks and Fives
Seat 3: GunnarTwoSeven (small blind) folded on the Flop
Seat 4: chiller_8918 (big blind) showed [Kh Qd] and lost with two pair, Jacks and Fours
Seat 6: bulhakau folded before Flop (didn't bet)


PokerStars Hand #225520218562:  Hold'em No Limit ($0.25/$0.50 USD) - 2021/04/05 1:39:09 ET
Table 'Uppsala II' 6-max Seat #4 is the button
Seat 1: S1HED ($163.22 in chips)
Seat 2: Grant[NY] ($64.18 in chips)
Seat 3: GunnarTwoSeven ($50.22 in chips)
Seat 4: chiller_8918 ($11.19 in chips)
Seat 5: blistein ($50 in chips)
Seat 6: bulhakau ($56.61 in chips)
blistein: posts small blind $0.25
bulhakau: posts big blind $0.50
*** HOLE CARDS ***
S1HED: folds
Grant[NY]: raises $1 to $1.50
GunnarTwoSeven: calls $1.50
chiller_8918: folds
blistein: folds
bulhakau: folds
*** FLOP *** [Ad Ts 7d]
Grant[NY]: checks
GunnarTwoSeven: checks
*** TURN *** [Ad Ts 7d] [6d]
Grant[NY]: bets $2.74
GunnarTwoSeven: calls $2.74
*** RIVER *** [Ad Ts 7d 6d] [6c]
Grant[NY]: checks
GunnarTwoSeven: checks
*** SHOW DOWN ***
Grant[NY]: shows [Js Jd] (two pair, Jacks and Sixes)
GunnarTwoSeven: shows [Td Ac] (two pair, Aces and Tens)
GunnarTwoSeven collected $8.77 from pot
*** SUMMARY ***
Total pot $9.23 | Rake $0.46
Board [Ad Ts 7d 6d 6c]
Seat 1: S1HED folded before Flop (didn't bet)
Seat 2: Grant[NY] showed [Js Jd] and lost with two pair, Jacks and Sixes
Seat 3: GunnarTwoSeven showed [Td Ac] and won ($8.77) with two pair, Aces and Tens
Seat 4: chiller_8918 (button) folded before Flop (didn't bet)
Seat 5: blistein (small blind) folded before Flop
Seat 6: bulhakau (big blind) folded before Flop


PokerStars Hand #225520223443:  Hold'em No Limit ($0.25/$0.50 USD) - 2021/04/05 1:39:41 ET
Table 'Uppsala II' 6-max Seat #5 is the button
Seat 2: Grant[NY] ($59.94 in chips)
Seat 3: GunnarTwoSeven ($54.75 in chips)
Seat 4: chiller_8918 ($11.19 in chips)
Seat 5: blistein ($50 in chips)
Seat 6: bulhakau ($56.11 in chips)
bulhakau: posts small blind $0.25
S1HED: is sitting out
Grant[NY]: posts big blind $0.50
*** HOLE CARDS ***
S1HED leaves the table
GunnarTwoSeven: folds
chiller_8918: folds
blistein: raises $0.75 to $1.25
bulhakau: folds
KOCTA47 joins the table at seat #1
Grant[NY]: calls $0.75
*** FLOP *** [9h 8d 2d]
Grant[NY]: checks
blistein: checks
*** TURN *** [9h 8d 2d] [8s]
Grant[NY]: checks
blistein: checks
*** RIVER *** [9h 8d 2d 8s] [4c]
Grant[NY]: checks
blistein: checks
*** SHOW DOWN ***
Grant[NY]: shows [6c Ac] (a pair of Eights)
blistein: shows [As 6d] (a pair of Eights)
Grant[NY] collected $1.31 from pot
blistein collected $1.30 from pot
*** SUMMARY ***
Total pot $2.75 | Rake $0.14
Board [9h 8d 2d 8s 4c]
Seat 2: Grant[NY] (big blind) showed [6c Ac] and won ($1.31) with a pair of Eights
Seat 3: GunnarTwoSeven folded before Flop (didn't bet)
Seat 4: chiller_8918 folded before Flop (didn't bet)
Seat 5: blistein (button) showed [As 6d] and won ($1.30) with a pair of Eights
Seat 6: bulhakau (small blind) folded before Flop


PokerStars Hand #225520232187:  Hold'em No Limit ($0.25/$0.50 USD) - 2021/04/05 1:40:38 ET
Table 'Uppsala II' 6-max Seat #6 is the button
Seat 2: Grant[NY] ($60 in chips)
Seat 3: GunnarTwoSeven ($54.75 in chips)
Seat 4: chiller_8918 ($11.19 in chips)
Seat 5: blistein ($50.05 in chips)
Seat 6: bulhakau ($55.86 in chips)
Grant[NY]: posts small blind $0.25
GunnarTwoSeven: posts big blind $0.50
*** HOLE CARDS ***
chiller_8918: calls $0.50
blistein: folds
bulhakau: folds
Grant[NY]: calls $0.25
GunnarTwoSeven: checks
*** FLOP *** [8h Ts 7d]
Grant[NY]: bets $0.50
GunnarTwoSeven: calls $0.50
chiller_8918: calls $0.50
*** TURN *** [8h Ts 7d] [2c]
Grant[NY]: checks
GunnarTwoSeven: checks
chiller_8918: bets $2
Grant[NY]: folds
GunnarTwoSeven: calls $2
*** RIVER *** [8h Ts 7d 2c] [Jd]
GunnarTwoSeven: checks
chiller_8918: checks
*** SHOW DOWN ***
GunnarTwoSeven: shows [3h 9d] (a straight, Seven to Jack)
chiller_8918: mucks hand
GunnarTwoSeven collected $6.65 from pot
*** SUMMARY ***
Total pot $7 | Rake $0.35
Board [8h Ts 7d 2c Jd]
Seat 2: Grant[NY] (small blind) folded on the Turn
Seat 3: GunnarTwoSeven (big blind) showed [3h 9d] and won ($6.65) with a straight, Seven to Jack
Seat 4: chiller_8918 mucked
Seat 5: blistein folded before Flop (didn't bet)
Seat 6: bulhakau (button) folded before Flop (didn't bet)


PokerStars Hand #225520247254:  Hold'em No Limit ($0.25/$0.50 USD) - 2021/04/05 1:42:17 ET
Table 'Uppsala II' 6-max Seat #5 is the button
Seat 1: KOCTA47 ($50 in chips)
Seat 2: Grant[NY] ($59 in chips)
Seat 3: GunnarTwoSeven ($58.90 in chips)
Seat 4: chiller_8918 ($7.44 in chips)
Seat 5: blistein ($50.05 in chips)
KOCTA47: posts small blind $0.25
Grant[NY]: posts big blind $0.50
*** HOLE CARDS ***
GunnarTwoSeven: folds
chiller_8918: calls $0.50
blistein: folds
KOCTA47: calls $0.25
Grant[NY]: checks
*** FLOP *** [8d Ks 3s]
KOCTA47: checks
Grant[NY]: checks
chiller_8918: bets $1
KOCTA47: folds
Grant[NY]: calls $1
*** TURN *** [8d Ks 3s] [2d]
Grant[NY]: checks
chiller_8918: bets $5.94 and is all-in
Grant[NY]: calls $5.94
*** RIVER *** [8d Ks 3s 2d] [As]
*** SHOW DOWN ***
Grant[NY]: shows [2s 8s] (a flush, Ace high)
chiller_8918: shows [Qh 7d] (high card Ace)
Grant[NY] collected $14.61 from pot
*** SUMMARY ***
Total pot $15.38 | Rake $0.77
Board [8d Ks 3s 2d As]
Seat 1: KOCTA47 (small blind) folded on the Flop
Seat 2: Grant[NY] (big blind) showed [2s 8s] and won ($14.61) with a flush, Ace high
Seat 3: GunnarTwoSeven folded before Flop (didn't bet)
Seat 4: chiller_8918 showed [Qh 7d] and lost with high card Ace
Seat 5: blistein (button) folded before Flop (didn't bet)


PokerStars Hand #225520330263:  Hold'em No Limit ($0.25/$0.50 USD) - 2021/04/05 1:51:00 ET
Table 'Uppsala II' 6-max Seat #3 is the button
Seat 1: KOCTA47 ($54.72 in chips)
Seat 3: GunnarTwoSeven ($60.75 in chips)
Seat 4: mantisxyle ($51.50 in chips)
Seat 5: blistein ($50.85 in chips)
mantisxyle: posts small blind $0.25
blistein: posts big blind $0.50
*** HOLE CARDS ***
KOCTA47: folds
GunnarTwoSeven: raises $0.50 to $1
mantisxyle: raises $4 to $5
blistein: folds
GunnarTwoSeven: calls $4
*** FLOP *** [3d 8d 5s]
mantisxyle: bets $3.29
GunnarTwoSeven: calls $3.29
*** TURN *** [3d 8d 5s] [Ac]
mantisxyle: bets $10.78
GunnarTwoSeven: raises $41.68 to $52.46 and is all-in
mantisxyle: calls $32.43 and is all-in
Uncalled bet ($9.25) returned to GunnarTwoSeven
*** RIVER *** [3d 8d 5s Ac] [4s]
*** SHOW DOWN ***
mantisxyle: shows [Kc As] (a pair of Aces)
GunnarTwoSeven: shows [6d Ad] (a pair of Aces - lower kicker)
mantisxyle collected $102.75 from pot
*** SUMMARY ***
Total pot $103.50 | Rake $0.75
Board [3d 8d 5s Ac 4s]
Seat 1: KOCTA47 folded before Flop (didn't bet)
Seat 3: GunnarTwoSeven (button) showed [6d Ad] and lost with a pair of Aces
Seat 4: mantisxyle (small blind) showed [Kc As] and won ($102.75) with a pair of Aces
Seat 5: blistein (big blind) folded before Flop


PokerStars Hand #224436722697:  Hold'em No Limit ($0.25/$0.50 USD) - 2021/03/03 23:49:12 ET
Table 'Hakone' 6-max Seat #6 is the button
Seat 1: ph0en1x77791 ($53.56 in chips)
Seat 3: rainielmd.surg ($39.31 in chips)
Seat 4: K0nstantinus ($56.29 in chips)
Seat 5: CATHEB ($56.63 in chips)
Seat 6: kozirek ($50 in chips)
ph0en1x77791: posts small blind $0.25
rainielmd.surg: posts big blind $0.50
*** HOLE CARDS ***
K0nstantinus: raises $0.75 to $1.25
CATHEB: folds
kozirek: folds
ph0en1x77791: raises $4.30 to $5.55
rainielmd.surg: folds
K0nstantinus: calls $4.30
*** FLOP *** [9s Qc Kc]
blistein joins the table at seat #2
ph0en1x77791: bets $3.42
K0nstantinus: calls $3.42
*** TURN *** [9s Qc Kc] [Jd]
ph0en1x77791: checks
K0nstantinus: checks
*** RIVER *** [9s Qc Kc Jd] [Jc]
ph0en1x77791: bets $11.56
K0nstantinus: calls $11.56
*** SHOW DOWN ***
ph0en1x77791: shows [Qh Qs] (a full house, Queens full of Jacks)
K0nstantinus: mucks hand
ph0en1x77791 collected $39.56 from pot
*** SUMMARY ***
Total pot $41.56 | Rake $2
Board [9s Qc Kc Jd Jc]
Seat 1: ph0en1x77791 (small blind) showed [Qh Qs] and won ($39.56) with a full house, Queens full of Jacks
Seat 3: rainielmd.surg (big blind) folded before Flop
Seat 4: K0nstantinus mucked
Seat 5: CATHEB folded before Flop (didn't bet)
Seat 6: kozirek (button) folded before Flop (didn't bet)


PokerStars Hand #224436756860:  Hold'em No Limit ($0.25/$0.50 USD) - 2021/03/03 23:51:21 ET
Table 'Hakone' 6-max Seat #5 is the button
Seat 1: ph0en1x77791 ($75.08 in chips)
Seat 3: rainielmd.surg ($40.01 in chips)
Seat 4: K0nstantinus ($50 in chips)
Seat 5: CATHEB ($55.88 in chips)
Seat 6: kozirek ($50.25 in chips)
kozirek: posts small blind $0.25
ph0en1x77791: posts big blind $0.50
blistein: sits out
*** HOLE CARDS ***
rainielmd.surg: raises $1 to $1.50
K0nstantinus: calls $1.50
CATHEB: folds
kozirek: folds
ph0en1x77791: folds
*** FLOP *** [Jc Qd Js]
rainielmd.surg: checks
K0nstantinus: checks
*** TURN *** [Jc Qd Js] [8c]
rainielmd.surg: bets $1.78
K0nstantinus: calls $1.78
*** RIVER *** [Jc Qd Js 8c] [3h]
rainielmd.surg: bets $4.47
K0nstantinus: calls $4.47
*** SHOW DOWN ***
rainielmd.surg: shows [Kd Td] (a pair of Jacks)
K0nstantinus: shows [7s 7d] (two pair, Jacks and Sevens)
K0nstantinus collected $15.44 from pot
*** SUMMARY ***
Total pot $16.25 | Rake $0.81
Board [Jc Qd Js 8c 3h]
Seat 1: ph0en1x77791 (big blind) folded before Flop
Seat 3: rainielmd.surg showed [Kd Td] and lost with a pair of Jacks
Seat 4: K0nstantinus showed [7s 7d] and won ($15.44) with two pair, Jacks and Sevens
Seat 5: CATHEB (button) folded before Flop (didn't bet)
Seat 6: kozirek (small blind) folded before Flop


PokerStars Hand #224436848811:  Hold'em No Limit ($0.25/$0.50 USD) - 2021/03/04 0:00:06 ET
Table 'Hakone' 6-max Seat #6 is the button
Seat 1: ph0en1x77791 ($75.17 in chips)
Seat 5: CATHEB ($59.17 in chips)
Seat 6: kozirek ($51.25 in chips)
ph0en1x77791: posts small blind $0.25
blistein: is sitting out
blistein leaves the table
K0nstantinus: is sitting out
CATHEB: posts big blind $0.50
*** HOLE CARDS ***
K0nstantinus leaves the table
kozirek: raises $0.75 to $1.25
ph0en1x77791: raises $4.30 to $5.55
CATHEB: folds
kozirek: calls $4.30
*** FLOP *** [5h 5d 7c]
ph0en1x77791: bets $2.76
kozirek: calls $2.76
*** TURN *** [5h 5d 7c] [5c]
ph0en1x77791: checks
kozirek: bets $11.95
ph0en1x77791: calls $11.95
*** RIVER *** [5h 5d 7c 5c] [8s]
ph0en1x77791: checks
kozirek: bets $30.99 and is all-in
ph0en1x77791: calls $30.99
*** SHOW DOWN ***
kozirek: shows [8h 7h] (a full house, Fives full of Eights)
ph0en1x77791: shows [Kh Ad] (three of a kind, Fives)
kozirek collected $102.25 from pot
*** SUMMARY ***
Total pot $103 | Rake $0.75
Board [5h 5d 7c 5c 8s]
Seat 1: ph0en1x77791 (small blind) showed [Kh Ad] and lost with three of a kind, Fives
Seat 5: CATHEB (big blind) folded before Flop
Seat 6: kozirek (button) showed [8h 7h] and won ($102.25) with a full house, Fives full of Eights


PokerStars Hand #229819287286:  Hold'em No Limit ($0.25/$0.50 USD) - 2021/09/13 9:46:53 ET
Table 'Huberta IV' 6-max Seat #5 is the button
Seat 1: p3ro17 ($50 in chips)
Seat 2: blistein ($50.75 in chips)
Seat 3: Kopishinsky. ($51.25 in chips)
Seat 4: Maikl530 ($50 in chips)
Seat 5: easy_sarcasm ($50 in chips)
Seat 6: fengaton ($50 in chips)
fengaton: posts small blind $0.25
p3ro17: posts big blind $0.50
*** HOLE CARDS ***
blistein: folds
Kopishinsky.: raises $0.75 to $1.25
Maikl530: folds
easy_sarcasm: folds
fengaton: folds
p3ro17: raises $4.25 to $5.50
Kopishinsky.: calls $4.25
*** FLOP *** [5s 6d 8d]
p3ro17: checks
Kopishinsky.: bets $8.02
p3ro17: calls $8.02
*** TURN *** [5s 6d 8d] [7d]
p3ro17: checks
Kopishinsky.: checks
*** RIVER *** [5s 6d 8d 7d] [Kd]
p3ro17: checks
Kopishinsky.: checks
*** SHOW DOWN ***
p3ro17: shows [Ks Ah] (a pair of Kings)
Kopishinsky.: mucks hand
p3ro17 collected $25.93 from pot
*** SUMMARY ***
Total pot $27.29 | Rake $1.36
Board [5s 6d 8d 7d Kd]
Seat 1: p3ro17 (big blind) showed [Ks Ah] and won ($25.93) with a pair of Kings
Seat 2: blistein folded before Flop (didn't bet)
Seat 3: Kopishinsky. mucked
Seat 4: Maikl530 folded before Flop (didn't bet)
Seat 5: easy_sarcasm (button) folded before Flop (didn't bet)
Seat 6: fengaton (small blind) folded before Flop


PokerStars Hand #229819416612:  Hold'em No Limit ($0.25/$0.50 USD) - 2021/09/13 9:54:00 ET
Table 'Huberta IV' 6-max Seat #6 is the button
Seat 1: p3ro17 ($64.45 in chips)
Seat 2: Tieschum ($50 in chips)
Seat 3: Kopishinsky. ($51.85 in chips)
Seat 4: Amrotu ($50 in chips)
Seat 5: casiusjacky ($31.84 in chips)
Seat 6: blistein ($50 in chips)
p3ro17: posts small blind $0.25
Tieschum: posts big blind $0.50
casiusjacky: posts big blind $0.50
*** HOLE CARDS ***
Kopishinsky.: folds
Amrotu: calls $0.50
casiusjacky: raises $1.75 to $2.25
blistein: calls $2.25
p3ro17: folds
Tieschum: folds
Amrotu: raises $7.50 to $9.75
casiusjacky: calls $7.50
blistein: folds
*** FLOP *** [Qs 7h Ks]
Amrotu: bets $21.38
casiusjacky: raises $0.71 to $22.09 and is all-in
Amrotu: calls $0.71
*** TURN *** [Qs 7h Ks] [As]
*** RIVER *** [Qs 7h Ks As] [2d]
*** SHOW DOWN ***
Amrotu: shows [Jh Ah] (a pair of Aces)
casiusjacky: shows [Qh Th] (a pair of Queens)
Amrotu collected $64.18 from pot
*** SUMMARY ***
Total pot $66.68 | Rake $2.50
Board [Qs 7h Ks As 2d]
Seat 1: p3ro17 (small blind) folded before Flop
Seat 2: Tieschum (big blind) folded before Flop
Seat 3: Kopishinsky. folded before Flop (didn't bet)
Seat 4: Amrotu showed [Jh Ah] and won ($64.18) with a pair of Aces
Seat 5: casiusjacky showed [Qh Th] and lost with a pair of Queens
Seat 6: blistein (button) folded before Flop


PokerStars Hand #229819688577:  Hold'em No Limit ($0.25/$0.50 USD) - 2021/09/13 10:10:00 ET
Table 'Huberta IV' 6-max Seat #3 is the button
Seat 1: shoujk ($50 in chips)
Seat 2: Igoreshque ($74.14 in chips)
Seat 3: orbcrazyk ($50 in chips)
Seat 4: 5tunt3r ($59.45 in chips)
Seat 5: sponge2132 ($49.77 in chips)
5tunt3r: posts small blind $0.25
sponge2132: posts big blind $0.50
blistein: sits out
shoujk: posts big blind $0.50
*** HOLE CARDS ***
shoujk: checks
Igoreshque: folds
orbcrazyk: folds
5tunt3r: folds
sponge2132: checks
*** FLOP *** [Qd 2d Jc]
sponge2132: checks
shoujk: checks
*** TURN *** [Qd 2d Jc] [Jh]
sponge2132: checks
shoujk: checks
*** RIVER *** [Qd 2d Jc Jh] [4h]
sponge2132: checks
shoujk: checks
*** SHOW DOWN ***
sponge2132: shows [Kd 5c] (a pair of Jacks)
shoujk: mucks hand
sponge2132 collected $1.19 from pot
*** SUMMARY ***
Total pot $1.25 | Rake $0.06
Board [Qd 2d Jc Jh 4h]
Seat 1: shoujk mucked
Seat 2: Igoreshque folded before Flop (didn't bet)
Seat 3: orbcrazyk (button) folded before Flop (didn't bet)
Seat 4: 5tunt3r (small blind) folded before Flop
Seat 5: sponge2132 (big blind) showed [Kd 5c] and won ($1.19) with a pair of Jacks


PokerStars Hand #229819713657:  Hold'em No Limit ($0.25/$0.50 USD) - 2021/09/13 10:11:23 ET
Table 'Huberta IV' 6-max Seat #6 is the button
Seat 1: shoujk ($50 in chips)
Seat 2: Igoreshque ($74.14 in chips)
Seat 3: orbcrazyk ($50 in chips)
Seat 4: 5tunt3r ($59.20 in chips)
Seat 5: sponge2132 ($49.71 in chips)
Seat 6: blistein ($51.10 in chips)
shoujk: posts small blind $0.25
Igoreshque: posts big blind $0.50
*** HOLE CARDS ***
orbcrazyk: raises $1 to $1.50
5tunt3r: folds
sponge2132: calls $1.50
blistein: folds
shoujk: folds
Igoreshque: calls $1
*** FLOP *** [Ah 8d 2c]
Igoreshque: checks
orbcrazyk: checks
sponge2132: checks
*** TURN *** [Ah 8d 2c] [8s]
Igoreshque: checks
orbcrazyk: checks
sponge2132: checks
*** RIVER *** [Ah 8d 2c 8s] [6c]
Igoreshque: checks
orbcrazyk: checks
sponge2132: checks
*** SHOW DOWN ***
Igoreshque: shows [9c Ad] (two pair, Aces and Eights)
orbcrazyk: mucks hand
sponge2132: mucks hand
Igoreshque collected $4.51 from pot
*** SUMMARY ***
Total pot $4.75 | Rake $0.24
Board [Ah 8d 2c 8s 6c]
Seat 1: shoujk (small blind) folded before Flop
Seat 2: Igoreshque (big blind) showed [9c Ad] and won ($4.51) with two pair, Aces and Eights
Seat 3: orbcrazyk mucked
Seat 4: 5tunt3r folded before Flop (didn't bet)
Seat 5: sponge2132 mucked
Seat 6: blistein (button) folded before Flop (didn't bet)


PokerStars Hand #229819747253:  Hold'em No Limit ($0.25/$0.50 USD) - 2021/09/13 10:13:11 ET
Table 'Huberta IV' 6-max Seat #2 is the button
Seat 1: shoujk ($50 in chips)
Seat 2: Igoreshque ($76.90 in chips)
Seat 3: orbcrazyk ($50 in chips)
Seat 4: 5tunt3r ($61.83 in chips)
Seat 5: sponge2132 ($48.21 in chips)
Seat 6: blistein ($51.10 in chips)
orbcrazyk: posts small blind $0.25
5tunt3r: posts big blind $0.50
*** HOLE CARDS ***
sponge2132: folds
blistein: folds
shoujk: folds
Igoreshque: folds
orbcrazyk: raises $1 to $1.50
5tunt3r: raises $3.50 to $5
orbcrazyk: calls $3.50
*** FLOP *** [3d Jh 9s]
orbcrazyk: checks
5tunt3r: checks
*** TURN *** [3d Jh 9s] [As]
orbcrazyk: checks
5tunt3r: bets $5.13
orbcrazyk: calls $5.13
*** RIVER *** [3d Jh 9s As] [Qs]
orbcrazyk: bets $6.35
5tunt3r: calls $6.35
*** SHOW DOWN ***
orbcrazyk: shows [Ks Ts] (a flush, Ace high)
5tunt3r: mucks hand
orbcrazyk collected $31.31 from pot
*** SUMMARY ***
Total pot $32.96 | Rake $1.65
Board [3d Jh 9s As Qs]
Seat 1: shoujk folded before Flop (didn't bet)
Seat 2: Igoreshque (button) folded before Flop (didn't bet)
Seat 3: orbcrazyk (small blind) showed [Ks Ts] and won ($31.31) with a flush, Ace high
Seat 4: 5tunt3r (big blind) mucked
Seat 5: sponge2132 folded before Flop (didn't bet)
Seat 6: blistein folded before Flop (didn't bet)


PokerStars Hand #229820816055:  Hold'em No Limit ($0.25/$0.50 USD) - 2021/09/13 11:08:56 ET
Table 'Huberta IV' 6-max Seat #1 is the button
Seat 1: shoujk ($60.25 in chips)
Seat 3: Tilt_Avenue ($86.24 in chips)
Seat 4: 5tunt3r ($98.73 in chips)
Seat 5: zidinko ($45.63 in chips)
Seat 6: blistein ($50 in chips)
Tilt_Avenue: posts small blind $0.25
5tunt3r: posts big blind $0.50
*** HOLE CARDS ***
zidinko: folds
blistein: folds
shoujk: raises $0.50 to $1
Tilt_Avenue: raises $2.50 to $3.50
5tunt3r: folds
shoujk: calls $2.50
*** FLOP *** [8h Ah 2d]
Tilt_Avenue: bets $3.25
shoujk: calls $3.25
*** TURN *** [8h Ah 2d] [Tc]
Tilt_Avenue: checks
shoujk: checks
*** RIVER *** [8h Ah 2d Tc] [9h]
Tilt_Avenue: checks
shoujk: checks
*** SHOW DOWN ***
Tilt_Avenue: shows [5c 4c] (high card Ace)
shoujk: shows [Js Jh] (a pair of Jacks)
shoujk collected $13.30 from pot
*** SUMMARY ***
Total pot $14 | Rake $0.70
Board [8h Ah 2d Tc 9h]
Seat 1: shoujk (button) showed [Js Jh] and won ($13.30) with a pair of Jacks
Seat 3: Tilt_Avenue (small blind) showed [5c 4c] and lost with high card Ace
Seat 4: 5tunt3r (big blind) folded before Flop
Seat 5: zidinko folded before Flop (didn't bet)
Seat 6: blistein folded before Flop (didn't bet)


PokerStars Hand #229824076774:  Hold'em No Limit ($0.25/$0.50 USD) - 2021/09/13 13:22:58 ET
Table 'Huberta IV' 6-max Seat #1 is the button
Seat 1: 13tochka5 ($57.82 in chips)
Seat 2: RUIB ($50.69 in chips)
Seat 3: Tolosoto ($75.13 in chips)
Seat 4: 5tunt3r ($67.46 in chips)
Seat 5: MKB-Poker99 ($40.86 in chips)
Seat 6: kvitun ($50 in chips)
RUIB: posts small blind $0.25
Tolosoto: posts big blind $0.50
*** HOLE CARDS ***
5tunt3r: folds
MKB-Poker99: folds
MKB-Poker99 leaves the table
kvitun: raises $0.75 to $1.25
13tochka5: folds
RUIB: folds
Tolosoto: calls $0.75
*** FLOP *** [4h Qs 9s]
Tolosoto: checks
kvitun: bets $1.74
Tolosoto: raises $1.74 to $3.48
kvitun: calls $1.74
*** TURN *** [4h Qs 9s] [Ks]
Tolosoto: checks
kvitun: bets $7.15
Tolosoto: calls $7.15
*** RIVER *** [4h Qs 9s Ks] [3h]
Tolosoto: checks
kvitun: bets $38.12 and is all-in
blistein joins the table at seat #5
Tolosoto: calls $38.12
*** SHOW DOWN ***
kvitun: shows [8s Ts] (a flush, King high)
Tolosoto: shows [9d 9h] (three of a kind, Nines)
kvitun collected $98.25 from pot
*** SUMMARY ***
Total pot $100.25 | Rake $2
Board [4h Qs 9s Ks 3h]
Seat 1: 13tochka5 (button) folded before Flop (didn't bet)
Seat 2: RUIB (small blind) folded before Flop
Seat 3: Tolosoto (big blind) showed [9d 9h] and lost with three of a kind, Nines
Seat 4: 5tunt3r folded before Flop (didn't bet)
Seat 5: MKB-Poker99 folded before Flop (didn't bet)
Seat 6: kvitun showed [8s Ts] and won ($98.25) with a flush, King high


PokerStars Hand #229824117958:  Hold'em No Limit ($0.25/$0.50 USD) - 2021/09/13 13:24:18 ET
Table 'Huberta IV' 6-max Seat #2 is the button
Seat 1: 13tochka5 ($57.82 in chips)
Seat 2: RUIB ($50.44 in chips)
Seat 3: Tolosoto ($25.13 in chips)
Seat 4: 5tunt3r ($67.46 in chips)
Seat 6: kvitun ($98.25 in chips)
Tolosoto: posts small blind $0.25
5tunt3r: posts big blind $0.50
blistein: sits out
*** HOLE CARDS ***
kvitun: raises $0.75 to $1.25
13tochka5: folds
RUIB: folds
Tolosoto: calls $1
5tunt3r: folds
*** FLOP *** [Ac 7c 7d]
Tolosoto: checks
kvitun: bets $0.94
Tolosoto: raises $2.06 to $3
kvitun: calls $2.06
*** TURN *** [Ac 7c 7d] [2h]
Tolosoto: bets $5.70
kvitun: calls $5.70
*** RIVER *** [Ac 7c 7d 2h] [3h]
Tolosoto: bets $15.18 and is all-in
kvitun: calls $15.18
*** SHOW DOWN ***
Tolosoto: shows [8s Tc] (a pair of Sevens)
kvitun: shows [Ad Jh] (two pair, Aces and Sevens)
kvitun collected $48.76 from pot
*** SUMMARY ***
Total pot $50.76 | Rake $2
Board [Ac 7c 7d 2h 3h]
Seat 1: 13tochka5 folded before Flop (didn't bet)
Seat 2: RUIB (button) folded before Flop (didn't bet)
Seat 3: Tolosoto (small blind) showed [8s Tc] and lost with a pair of Sevens
Seat 4: 5tunt3r (big blind) folded before Flop
Seat 6: kvitun showed [Ad Jh] and won ($48.76) with two pair, Aces and Sevens


PokerStars Hand #229824414230:  Hold'em No Limit ($0.25/$0.50 USD) - 2021/09/13 13:33:55 ET
Table 'Huberta IV' 6-max Seat #6 is the button
Seat 1: Pathu-7777 ($50.36 in chips)
Seat 2: RUIB ($50 in chips)
Seat 3: Tolosoto ($74.72 in chips)
Seat 4: 5tunt3r ($65.77 in chips)
Seat 5: blistein ($50 in chips)
Seat 6: kvitun ($115.93 in chips)
Pathu-7777: posts small blind $0.25
RUIB: posts big blind $0.50
*** HOLE CARDS ***
Tolosoto: folds
5tunt3r: folds
blistein: raises $0.75 to $1.25
kvitun: folds
Pathu-7777: calls $1
RUIB: folds
*** FLOP *** [9h 4h 6c]
Pathu-7777: checks
blistein: bets $1.48
Pathu-7777: calls $1.48
*** TURN *** [9h 4h 6c] [Ts]
Pathu-7777: checks
blistein: bets $4.25
Pathu-7777: calls $4.25
*** RIVER *** [9h 4h 6c Ts] [9d]
Pathu-7777: checks
blistein: checks
*** SHOW DOWN ***
Pathu-7777: shows [Ad Th] (two pair, Tens and Nines)
blistein: shows [As Td] (two pair, Tens and Nines)
Pathu-7777 collected $6.87 from pot
blistein collected $6.87 from pot
*** SUMMARY ***
Total pot $14.46 | Rake $0.72
Board [9h 4h 6c Ts 9d]
Seat 1: Pathu-7777 (small blind) showed [Ad Th] and won ($6.87) with two pair, Tens and Nines
Seat 2: RUIB (big blind) folded before Flop
Seat 3: Tolosoto folded before Flop (didn't bet)
Seat 4: 5tunt3r folded before Flop (didn't bet)
Seat 5: blistein showed [As Td] and won ($6.87) with two pair, Tens and Nines
Seat 6: kvitun (button) folded before Flop (didn't bet)


PokerStars Hand #229824501288:  Hold'em No Limit ($0.25/$0.50 USD) - 2021/09/13 13:36:43 ET
Table 'Huberta IV' 6-max Seat #3 is the button
Seat 1: Pathu-7777 ($45.75 in chips)
Seat 2: RUIB ($50 in chips)
Seat 3: Tolosoto ($79.46 in chips)
Seat 4: 5tunt3r ($65.27 in chips)
Seat 5: blistein ($50 in chips)
Seat 6: kvitun ($115.93 in chips)
5tunt3r: posts small blind $0.25
blistein: posts big blind $0.50
*** HOLE CARDS ***
kvitun: folds
Pathu-7777: raises $0.75 to $1.25
RUIB: folds
Tolosoto: calls $1.25
5tunt3r: folds
blistein: folds
*** FLOP *** [As 7d 8h]
Pathu-7777: checks
Tolosoto: bets $1.55
Pathu-7777: calls $1.55
*** TURN *** [As 7d 8h] [Js]
Pathu-7777: checks
Tolosoto: checks
*** RIVER *** [As 7d 8h Js] [Kc]
Pathu-7777: bets $6.03
Tolosoto: calls $6.03
*** SHOW DOWN ***
Pathu-7777: shows [9d Th] (a straight, Seven to Jack)
Tolosoto: mucks hand
Pathu-7777 collected $17.49 from pot
*** SUMMARY ***
Total pot $18.41 | Rake $0.92
Board [As 7d 8h Js Kc]
Seat 1: Pathu-7777 showed [9d Th] and won ($17.49) with a straight, Seven to Jack
Seat 2: RUIB folded before Flop (didn't bet)
Seat 3: Tolosoto (button) mucked
Seat 4: 5tunt3r (small blind) folded before Flop
Seat 5: blistein (big blind) folded before Flop
Seat 6: kvitun folded before Flop (didn't bet)


PokerStars Hand #229824537349:  Hold'em No Limit ($0.25/$0.50 USD) - 2021/09/13 13:37:52 ET
Table 'Huberta IV' 6-max Seat #5 is the button
Seat 1: Pathu-7777 ($54.41 in chips)
Seat 2: RUIB ($50 in chips)
Seat 3: Tolosoto ($71.38 in chips)
Seat 4: 5tunt3r ($65.02 in chips)
Seat 5: blistein ($50 in chips)
Seat 6: kvitun ($115.43 in chips)
kvitun: posts small blind $0.25
Pathu-7777: posts big blind $0.50
*** HOLE CARDS ***
RUIB: raises $0.60 to $1.10
Tolosoto: folds
5tunt3r: folds
blistein: folds
kvitun: folds
Pathu-7777: calls $0.60
*** FLOP *** [2c Js 4s]
Pathu-7777: checks
RUIB: checks
*** TURN *** [2c Js 4s] [Td]
Pathu-7777: checks
RUIB: checks
*** RIVER *** [2c Js 4s Td] [2d]
Pathu-7777: checks
RUIB: checks
*** SHOW DOWN ***
Pathu-7777: shows [6c 9h] (a pair of Deuces)
RUIB: shows [9c 8c] (a pair of Deuces)
Pathu-7777 collected $1.17 from pot
RUIB collected $1.16 from pot
*** SUMMARY ***
Total pot $2.45 | Rake $0.12
Board [2c Js 4s Td 2d]
Seat 1: Pathu-7777 (big blind) showed [6c 9h] and won ($1.17) with a pair of Deuces
Seat 2: RUIB showed [9c 8c] and won ($1.16) with a pair of Deuces
Seat 3: Tolosoto folded before Flop (didn't bet)
Seat 4: 5tunt3r folded before Flop (didn't bet)
Seat 5: blistein (button) folded before Flop (didn't bet)
Seat 6: kvitun (small blind) folded before Flop


PokerStars Hand #229824555917:  Hold'em No Limit ($0.25/$0.50 USD) - 2021/09/13 13:38:28 ET
Table 'Huberta IV' 6-max Seat #6 is the button
Seat 1: Pathu-7777 ($54.48 in chips)
Seat 2: RUIB ($50.06 in chips)
Seat 3: Tolosoto ($71.38 in chips)
Seat 4: 5tunt3r ($65.02 in chips)
Seat 5: blistein ($50 in chips)
Seat 6: kvitun ($115.18 in chips)
Pathu-7777: posts small blind $0.25
RUIB: posts big blind $0.50
*** HOLE CARDS ***
Tolosoto has timed out
Tolosoto: folds
5tunt3r: raises $0.75 to $1.25
blistein: folds
kvitun: folds
Pathu-7777: calls $1
RUIB: calls $0.75
*** FLOP *** [7s Ks 6c]
Pathu-7777: checks
RUIB: checks
5tunt3r: checks
*** TURN *** [7s Ks 6c] [8h]
Pathu-7777: checks
RUIB: bets $3.03
5tunt3r: folds
Pathu-7777: calls $3.03
*** RIVER *** [7s Ks 6c 8h] [2c]
Pathu-7777: checks
RUIB: checks
*** SHOW DOWN ***
Pathu-7777: shows [8d Qd] (a pair of Eights)
RUIB: mucks hand
Pathu-7777 collected $9.32 from pot
*** SUMMARY ***
Total pot $9.81 | Rake $0.49
Board [7s Ks 6c 8h 2c]
Seat 1: Pathu-7777 (small blind) showed [8d Qd] and won ($9.32) with a pair of Eights
Seat 2: RUIB (big blind) mucked
Seat 3: Tolosoto folded before Flop (didn't bet)
Seat 4: 5tunt3r folded on the Turn
Seat 5: blistein folded before Flop (didn't bet)
Seat 6: kvitun (button) folded before Flop (didn't bet)


PokerStars Hand #229824673188:  Hold'em No Limit ($0.25/$0.50 USD) - 2021/09/13 13:42:14 ET
Table 'Huberta IV' 6-max Seat #4 is the button
Seat 1: Pathu-7777 ($50.02 in chips)
Seat 2: RUIB ($50 in chips)
Seat 3: Tolosoto ($84.04 in chips)
Seat 4: 5tunt3r ($60.27 in chips)
Seat 5: blistein ($50 in chips)
Seat 6: kvitun ($116.78 in chips)
blistein: posts small blind $0.25
kvitun: posts big blind $0.50
*** HOLE CARDS ***
Pathu-7777: raises $0.75 to $1.25
Tolosoto said, "nf"
RUIB has timed out
RUIB: folds
Tolosoto: folds
5tunt3r: folds
blistein: folds
kvitun: calls $0.75
*** FLOP *** [8c 2h Kc]
kvitun: checks
Pathu-7777: bets $1.70
kvitun: calls $1.70
*** TURN *** [8c 2h Kc] [Td]
kvitun: checks
Pathu-7777: bets $3.80
kvitun: calls $3.80
*** RIVER *** [8c 2h Kc Td] [Ac]
kvitun: checks
Pathu-7777: checks
*** SHOW DOWN ***
kvitun: shows [Kd Jc] (a pair of Kings)
Pathu-7777: mucks hand
kvitun collected $13.06 from pot
*** SUMMARY ***
Total pot $13.75 | Rake $0.69
Board [8c 2h Kc Td Ac]
Seat 1: Pathu-7777 mucked
Seat 2: RUIB folded before Flop (didn't bet)
Seat 3: Tolosoto folded before Flop (didn't bet)
Seat 4: 5tunt3r (button) folded before Flop (didn't bet)
Seat 5: blistein (small blind) folded before Flop
Seat 6: kvitun (big blind) showed [Kd Jc] and won ($13.06) with a pair of Kings


PokerStars Hand #229824839135:  Hold'em No Limit ($0.25/$0.50 USD) - 2021/09/13 13:47:16 ET
Table 'Huberta IV' 6-max Seat #5 is the button
Seat 1: Pathu-7777 ($50.24 in chips)
Seat 3: Tolosoto ($54.21 in chips)
Seat 4: 5tunt3r ($87.45 in chips)
Seat 5: blistein ($50 in chips)
Seat 6: kvitun ($119.84 in chips)
kvitun: posts small blind $0.25
Pathu-7777: posts big blind $0.50
MyBestPokeR: sits out
*** HOLE CARDS ***
Tolosoto: folds
5tunt3r: folds
blistein: raises $0.75 to $1.25
kvitun: calls $1
Pathu-7777: calls $0.75
*** FLOP *** [Js 3c Jd]
kvitun: checks
Pathu-7777: checks
blistein: bets $1.85
kvitun: calls $1.85
Pathu-7777: folds
*** TURN *** [Js 3c Jd] [3h]
kvitun: checks
blistein: checks
*** RIVER *** [Js 3c Jd 3h] [Tc]
kvitun: checks
blistein: checks
*** SHOW DOWN ***
kvitun: shows [8c 8d] (two pair, Jacks and Eights)
blistein: mucks hand
kvitun collected $7.08 from pot
*** SUMMARY ***
Total pot $7.45 | Rake $0.37
Board [Js 3c Jd 3h Tc]
Seat 1: Pathu-7777 (big blind) folded on the Flop
Seat 3: Tolosoto folded before Flop (didn't bet)
Seat 4: 5tunt3r folded before Flop (didn't bet)
Seat 5: blistein (button) mucked
Seat 6: kvitun (small blind) showed [8c 8d] and won ($7.08) with two pair, Jacks and Eights


PokerStars Hand #221327283037:  Hold'em No Limit ($0.25/$0.50 USD) - 2020/12/11 11:48:55 ET
Table 'Niobe II' 6-max Seat #6 is the button
Seat 1: WinstonasX ($21.91 in chips)
Seat 2: ex contador ($50 in chips)
Seat 3: FreshLocky ($53.79 in chips)
Seat 4: AstrumNatale ($50 in chips)
Seat 6: blistein ($50 in chips)
WinstonasX: posts small blind $0.25
ex contador: posts big blind $0.50
*** HOLE CARDS ***
FreshLocky: folds
AstrumNatale: folds
blistein: folds
WinstonasX: calls $0.25
ex contador: checks
*** FLOP *** [Qc Ac 8h]
WinstonasX: checks
ex contador: checks
*** TURN *** [Qc Ac 8h] [Ad]
WinstonasX: checks
ex contador: checks
*** RIVER *** [Qc Ac 8h Ad] [7d]
WinstonasX: checks
ex contador: checks
*** SHOW DOWN ***
WinstonasX: shows [9h 7s] (two pair, Aces and Sevens)
ex contador: mucks hand
WinstonasX collected $0.95 from pot
*** SUMMARY ***
Total pot $1 | Rake $0.05
Board [Qc Ac 8h Ad 7d]
Seat 1: WinstonasX (small blind) showed [9h 7s] and won ($0.95) with two pair, Aces and Sevens
Seat 2: ex contador (big blind) mucked
Seat 3: FreshLocky folded before Flop (didn't bet)
Seat 4: AstrumNatale folded before Flop (didn't bet)
Seat 6: blistein (button) folded before Flop (didn't bet)


PokerStars Hand #221327306327:  Hold'em No Limit ($0.25/$0.50 USD) - 2020/12/11 11:49:39 ET
Table 'Niobe II' 6-max Seat #1 is the button
Seat 1: WinstonasX ($22.36 in chips)
Seat 2: ex contador ($50 in chips)
Seat 3: FreshLocky ($53.79 in chips)
Seat 4: AstrumNatale ($50 in chips)
Seat 6: blistein ($50 in chips)
ex contador: posts small blind $0.25
FreshLocky: posts big blind $0.50
*** HOLE CARDS ***
AstrumNatale: folds
blistein: folds
WinstonasX: calls $0.50
ex contador: folds
FreshLocky: checks
*** FLOP *** [3s 5c 8s]
toru79 joins the table at seat #5
FreshLocky: checks
WinstonasX: checks
*** TURN *** [3s 5c 8s] [4s]
FreshLocky: checks
WinstonasX: checks
*** RIVER *** [3s 5c 8s 4s] [9c]
FreshLocky: checks
WinstonasX: checks
*** SHOW DOWN ***
FreshLocky: shows [Ts 3d] (a pair of Threes)
WinstonasX: mucks hand
FreshLocky collected $1.19 from pot
*** SUMMARY ***
Total pot $1.25 | Rake $0.06
Board [3s 5c 8s 4s 9c]
Seat 1: WinstonasX (button) mucked
Seat 2: ex contador (small blind) folded before Flop
Seat 3: FreshLocky (big blind) showed [Ts 3d] and won ($1.19) with a pair of Threes
Seat 4: AstrumNatale folded before Flop (didn't bet)
Seat 6: blistein folded before Flop (didn't bet)


PokerStars Hand #221327334063:  Hold'em No Limit ($0.25/$0.50 USD) - 2020/12/11 11:50:32 ET
Table 'Niobe II' 6-max Seat #2 is the button
Seat 1: WinstonasX ($21.86 in chips)
Seat 2: ex contador ($50 in chips)
Seat 3: FreshLocky ($54.48 in chips)
Seat 4: AstrumNatale ($50 in chips)
Seat 6: blistein ($50 in chips)
FreshLocky: posts small blind $0.25
AstrumNatale: posts big blind $0.50
toru79: sits out
*** HOLE CARDS ***
blistein: folds
WinstonasX: calls $0.50
ex contador: folds
FreshLocky: folds
AstrumNatale: checks
*** FLOP *** [5s 7c Ad]
AstrumNatale: checks
WinstonasX: checks
*** TURN *** [5s 7c Ad] [5d]
AstrumNatale: bets $0.92
WinstonasX: calls $0.92
*** RIVER *** [5s 7c Ad 5d] [3h]
AstrumNatale: checks
WinstonasX: checks
*** SHOW DOWN ***
AstrumNatale: shows [4s 3d] (two pair, Fives and Threes)
WinstonasX: shows [8s Ah] (two pair, Aces and Fives)
WinstonasX collected $2.94 from pot
*** SUMMARY ***
Total pot $3.09 | Rake $0.15
Board [5s 7c Ad 5d 3h]
Seat 1: WinstonasX showed [8s Ah] and won ($2.94) with two pair, Aces and Fives
Seat 2: ex contador (button) folded before Flop (didn't bet)
Seat 3: FreshLocky (small blind) folded before Flop
Seat 4: AstrumNatale (big blind) showed [4s 3d] and lost with two pair, Fives and Threes
Seat 6: blistein folded before Flop (didn't bet)


PokerStars Hand #221327358926:  Hold'em No Limit ($0.25/$0.50 USD) - 2020/12/11 11:51:19 ET
Table 'Niobe II' 6-max Seat #3 is the button
Seat 1: WinstonasX ($23.38 in chips)
Seat 2: ex contador ($50 in chips)
Seat 3: FreshLocky ($54.23 in chips)
Seat 4: AstrumNatale ($50 in chips)
Seat 5: toru79 ($50 in chips)
Seat 6: blistein ($50 in chips)
AstrumNatale: posts small blind $0.25
toru79: posts big blind $0.50
*** HOLE CARDS ***
blistein: folds
WinstonasX: folds
ex contador: raises $0.75 to $1.25
FreshLocky: folds
AstrumNatale: folds
toru79: calls $0.75
*** FLOP *** [9d Qs 8d]
blistein leaves the table
toru79: checks
ex contador: bets $1.96
toru79: calls $1.96
*** TURN *** [9d Qs 8d] [3s]
toru79: checks
ex contador: bets $4.76
AxolotlExhibit joins the table at seat #6
toru79: raises $7.93 to $12.69
ex contador: calls $7.93
*** RIVER *** [9d Qs 8d 3s] [4h]
toru79: checks
ex contador: checks
*** SHOW DOWN ***
toru79: shows [8h 9c] (two pair, Nines and Eights)
ex contador: mucks hand
toru79 collected $30.45 from pot
*** SUMMARY ***
Total pot $32.05 | Rake $1.60
Board [9d Qs 8d 3s 4h]
Seat 1: WinstonasX folded before Flop (didn't bet)
Seat 2: ex contador mucked
Seat 3: FreshLocky (button) folded before Flop (didn't bet)
Seat 4: AstrumNatale (small blind) folded before Flop
Seat 5: toru79 (big blind) showed [8h 9c] and won ($30.45) with two pair, Nines and Eights
Seat 6: blistein folded before Flop (didn't bet)


PokerStars Hand #226626678331:  Hold'em No Limit ($0.25/$0.50 USD) - 2021/05/10 4:05:43 ET
Table 'Alekto' 6-max Seat #6 is the button
Seat 1: Godlike1379 ($85.23 in chips)
Seat 3: MiguelitoSsan ($59.74 in chips)
Seat 4: I am hater ($50.10 in chips)
Seat 6: Kach_2010 ($51.75 in chips)
Godlike1379: posts small blind $0.25
nastja336: is sitting out
MiguelitoSsan: posts big blind $0.50
*** HOLE CARDS ***
I am hater: raises $0.85 to $1.35
nastja336 leaves the table
Kach_2010: folds
Godlike1379: calls $1.10
MiguelitoSsan: folds
*** FLOP *** [8d 6d Kd]
Godlike1379: checks
I am hater: bets $0.75
Godlike1379: calls $0.75
*** TURN *** [8d 6d Kd] [5s]
Godlike1379: checks
I am hater: checks
*** RIVER *** [8d 6d Kd 5s] [7s]
temirlan140323 joins the table at seat #2
blistein joins the table at seat #5
Godlike1379: checks
I am hater: checks
*** SHOW DOWN ***
Godlike1379: shows [As 8s] (a pair of Eights)
I am hater: mucks hand
Godlike1379 collected $4.46 from pot
*** SUMMARY ***
Total pot $4.70 | Rake $0.24
Board [8d 6d Kd 5s 7s]
Seat 1: Godlike1379 (small blind) showed [As 8s] and won ($4.46) with a pair of Eights
Seat 3: MiguelitoSsan (big blind) folded before Flop
Seat 4: I am hater mucked
Seat 6: Kach_2010 (button) folded before Flop (didn't bet)


PokerStars Hand #226626694959:  Hold'em No Limit ($0.25/$0.50 USD) - 2021/05/10 4:07:25 ET
Table 'Alekto' 6-max Seat #6 is the button
Seat 1: Godlike1379 ($87.09 in chips)
Seat 2: temirlan140323 ($20.25 in chips)
Seat 3: MiguelitoSsan ($60.88 in chips)
Seat 4: I am hater ($51 in chips)
Seat 5: blistein ($50 in chips)
Seat 6: Kach_2010 ($50.50 in chips)
Godlike1379: posts small blind $0.25
temirlan140323: posts big blind $0.50
*** HOLE CARDS ***
MiguelitoSsan: folds
I am hater: folds
blistein: folds
Kach_2010: folds
Godlike1379: raises $1 to $1.50
temirlan140323: calls $1
*** FLOP *** [9d Th 2d]
Godlike1379: bets $2.17
temirlan140323: calls $2.17
*** TURN *** [9d Th 2d] [8h]
Godlike1379: checks
temirlan140323: bets $3.48
Godlike1379: calls $3.48
*** RIVER *** [9d Th 2d 8h] [Ah]
Godlike1379: checks
temirlan140323: checks
*** SHOW DOWN ***
Godlike1379: shows [Kd Qd] (high card Ace)
temirlan140323: shows [Ks 9s] (a pair of Nines)
temirlan140323 collected $13.58 from pot
*** SUMMARY ***
Total pot $14.30 | Rake $0.72
Board [9d Th 2d 8h Ah]
Seat 1: Godlike1379 (small blind) showed [Kd Qd] and lost with high card Ace
Seat 2: temirlan140323 (big blind) showed [Ks 9s] and won ($13.58) with a pair of Nines
Seat 3: MiguelitoSsan folded before Flop (didn't bet)
Seat 4: I am hater folded before Flop (didn't bet)
Seat 5: blistein folded before Flop (didn't bet)
Seat 6: Kach_2010 (button) folded before Flop (didn't bet)


PokerStars Hand #226626999582:  Hold'em No Limit ($0.25/$0.50 USD) - 2021/05/10 4:37:33 ET
Table 'Alekto' 6-max Seat #3 is the button
Seat 2: temirlan140323 ($33.53 in chips)
Seat 3: Solovyova ($50 in chips)
Seat 5: eeeLOVEnkov ($50 in chips)
eeeLOVEnkov: posts small blind $0.25
FooFighter92: is sitting out
temirlan140323: posts big blind $0.50
*** HOLE CARDS ***
FooFighter92 leaves the table
Solovyova: raises $0.75 to $1.25
eeeLOVEnkov: folds
temirlan140323: calls $0.75
*** FLOP *** [Kd 3d 9c]
blistein joins the table at seat #1
temirlan140323: checks
KumarKGB joins the table at seat #6
Solovyova: bets $0.89
temirlan140323: calls $0.89
*** TURN *** [Kd 3d 9c] [Ah]
temirlan140323: checks
Solovyova: bets $3.44
temirlan140323: calls $3.44
*** RIVER *** [Kd 3d 9c Ah] [5h]
temirlan140323: checks
Solovyova: checks
*** SHOW DOWN ***
temirlan140323: shows [Kc Tc] (a pair of Kings)
Solovyova: mucks hand
temirlan140323 collected $10.84 from pot
*** SUMMARY ***
Total pot $11.41 | Rake $0.57
Board [Kd 3d 9c Ah 5h]
Seat 2: temirlan140323 (big blind) showed [Kc Tc] and won ($10.84) with a pair of Kings
Seat 3: Solovyova (button) mucked
Seat 5: eeeLOVEnkov (small blind) folded before Flop


PokerStars Hand #226627084466:  Hold'em No Limit ($0.25/$0.50 USD) - 2021/05/10 4:44:47 ET
Table 'Alekto' 6-max Seat #6 is the button
Seat 1: Cakkelito ($46.89 in chips)
Seat 2: PERITTA ($50.75 in chips)
Seat 3: Solovyova ($50.75 in chips)
Seat 4: I am hater ($73.23 in chips)
Seat 5: eeeLOVEnkov ($61.09 in chips)
Seat 6: blistein ($50 in chips)
Cakkelito: posts small blind $0.25
PERITTA: posts big blind $0.50
*** HOLE CARDS ***
Solovyova: raises $0.60 to $1.10
I am hater: folds
eeeLOVEnkov: folds
blistein: folds
Cakkelito: calls $0.85
PERITTA: folds
*** FLOP *** [3s Td 5h]
Cakkelito: checks
Solovyova: bets $0.87
Cakkelito: calls $0.87
*** TURN *** [3s Td 5h] [Ah]
Cakkelito: checks
Solovyova: checks
*** RIVER *** [3s Td 5h Ah] [7c]
Cakkelito: checks
Solovyova: checks
*** SHOW DOWN ***
Cakkelito: shows [7h 4h] (a pair of Sevens)
Solovyova: mucks hand
Cakkelito collected $4.22 from pot
*** SUMMARY ***
Total pot $4.44 | Rake $0.22
Board [3s Td 5h Ah 7c]
Seat 1: Cakkelito (small blind) showed [7h 4h] and won ($4.22) with a pair of Sevens
Seat 2: PERITTA (big blind) folded before Flop
Seat 3: Solovyova mucked
Seat 4: I am hater folded before Flop (didn't bet)
Seat 5: eeeLOVEnkov folded before Flop (didn't bet)
Seat 6: blistein (button) folded before Flop (didn't bet)


PokerStars Hand #226627109703:  Hold'em No Limit ($0.25/$0.50 USD) - 2021/05/10 4:46:59 ET
Table 'Alekto' 6-max Seat #5 is the button
Seat 1: Cakkelito ($49.14 in chips)
Seat 2: PERITTA ($50.35 in chips)
Seat 3: Solovyova ($50 in chips)
Seat 4: I am hater ($80.98 in chips)
Seat 5: eeeLOVEnkov ($60.34 in chips)
Seat 6: blistein ($50 in chips)
blistein: posts small blind $0.25
Cakkelito: posts big blind $0.50
*** HOLE CARDS ***
PERITTA: folds
Solovyova: folds
I am hater: folds
eeeLOVEnkov: folds
blistein: raises $1 to $1.50
Cakkelito: calls $1
*** FLOP *** [4h 5d Qh]
blistein: checks
Cakkelito: checks
*** TURN *** [4h 5d Qh] [Jc]
blistein: checks
Cakkelito: bets $2
blistein: calls $2
*** RIVER *** [4h 5d Qh Jc] [3c]
blistein: checks
Cakkelito: bets $4
blistein: calls $4
*** SHOW DOWN ***
Cakkelito: shows [Js Ks] (a pair of Jacks)
blistein: mucks hand
Cakkelito collected $14.25 from pot
*** SUMMARY ***
Total pot $15 | Rake $0.75
Board [4h 5d Qh Jc 3c]
Seat 1: Cakkelito (big blind) showed [Js Ks] and won ($14.25) with a pair of Jacks
Seat 2: PERITTA folded before Flop (didn't bet)
Seat 3: Solovyova folded before Flop (didn't bet)
Seat 4: I am hater folded before Flop (didn't bet)
Seat 5: eeeLOVEnkov (button) folded before Flop (didn't bet)
Seat 6: blistein (small blind) mucked


PokerStars Hand #226627144858:  Hold'em No Limit ($0.25/$0.50 USD) - 2021/05/10 4:50:03 ET
Table 'Alekto' 6-max Seat #5 is the button
Seat 1: Cakkelito ($54.52 in chips)
Seat 2: PERITTA ($50.35 in chips)
Seat 3: Solovyova ($50 in chips)
Seat 4: I am hater ($82.70 in chips)
Seat 5: eeeLOVEnkov ($59.59 in chips)
Seat 6: blistein ($52.91 in chips)
blistein: posts small blind $0.25
Cakkelito: posts big blind $0.50
*** HOLE CARDS ***
PERITTA: folds
Solovyova: folds
I am hater: raises $0.85 to $1.35
eeeLOVEnkov: folds
blistein: folds
Cakkelito: calls $0.85
*** FLOP *** [7c Ah 2h]
Cakkelito: checks
I am hater: bets $0.92
Cakkelito: raises $1.58 to $2.50
I am hater: raises $5.93 to $8.43
Cakkelito: calls $5.93
*** TURN *** [7c Ah 2h] [8h]
Cakkelito: checks
I am hater: bets $12.30
Cakkelito: raises $32.44 to $44.74 and is all-in
I am hater: calls $32.44
*** RIVER *** [7c Ah 2h 8h] [2s]
*** SHOW DOWN ***
Cakkelito: shows [Jc As] (two pair, Aces and Deuces)
I am hater: shows [7h 7d] (a full house, Sevens full of Deuces)
I am hater collected $107.29 from pot
*** SUMMARY ***
Total pot $109.29 | Rake $2
Board [7c Ah 2h 8h 2s]
Seat 1: Cakkelito (big blind) showed [Jc As] and lost with two pair, Aces and Deuces
Seat 2: PERITTA folded before Flop (didn't bet)
Seat 3: Solovyova folded before Flop (didn't bet)
Seat 4: I am hater showed [7h 7d] and won ($107.29) with a full house, Sevens full of Deuces
Seat 5: eeeLOVEnkov (button) folded before Flop (didn't bet)
Seat 6: blistein (small blind) folded before Flop


PokerStars Hand #226627219400:  Hold'em No Limit ($0.25/$0.50 USD) - 2021/05/10 4:56:52 ET
Table 'Alekto' 6-max Seat #2 is the button
Seat 1: n3v3ts94 ($35.88 in chips)
Seat 2: PERITTA ($58 in chips)
Seat 3: Solovyova ($51.66 in chips)
Seat 4: sims84 ($51.43 in chips)
Seat 5: eeeLOVEnkov ($65.65 in chips)
Seat 6: blistein ($53.77 in chips)
Solovyova: posts small blind $0.25
sims84: posts big blind $0.50
*** HOLE CARDS ***
eeeLOVEnkov: folds
blistein: folds
n3v3ts94: raises $0.50 to $1
PERITTA: folds
Solovyova: folds
sims84: calls $0.50
*** FLOP *** [7s 3c Ac]
sims84: checks
n3v3ts94: checks
*** TURN *** [7s 3c Ac] [3d]
sims84: bets $1
n3v3ts94: calls $1
*** RIVER *** [7s 3c Ac 3d] [7d]
sims84: checks
PERITTA is disconnected
n3v3ts94: checks
*** SHOW DOWN ***
sims84: shows [5h As] (two pair, Aces and Sevens)
n3v3ts94: mucks hand
sims84 collected $4.04 from pot
*** SUMMARY ***
Total pot $4.25 | Rake $0.21
Board [7s 3c Ac 3d 7d]
Seat 1: n3v3ts94 mucked
Seat 2: PERITTA (button) folded before Flop (didn't bet)
Seat 3: Solovyova (small blind) folded before Flop
Seat 4: sims84 (big blind) showed [5h As] and won ($4.04) with two pair, Aces and Sevens
Seat 5: eeeLOVEnkov folded before Flop (didn't bet)
Seat 6: blistein folded before Flop (didn't bet)


PokerStars Hand #226627238861:  Hold'em No Limit ($0.25/$0.50 USD) - 2021/05/10 4:58:51 ET
Table 'Alekto' 6-max Seat #1 is the button
Seat 1: n3v3ts94 ($34.57 in chips)
Seat 2: PERITTA ($57.50 in chips)
Seat 3: Solovyova ($52.91 in chips)
Seat 4: sims84 ($53.22 in chips)
Seat 5: eeeLOVEnkov ($64.90 in chips)
Seat 6: blistein ($53.02 in chips)
PERITTA: posts small blind $0.25
Solovyova: posts big blind $0.50
*** HOLE CARDS ***
sims84: folds
eeeLOVEnkov: folds
blistein: raises $0.75 to $1.25
n3v3ts94: calls $1.25
PERITTA: folds
Solovyova: calls $0.75
*** FLOP *** [As Jh 8s]
Solovyova: checks
blistein: bets $1.27
n3v3ts94: folds
Solovyova: raises $3.68 to $4.95
blistein: calls $3.68
*** TURN *** [As Jh 8s] [9h]
PERITTA is disconnected
Solovyova: checks
blistein: checks
*** RIVER *** [As Jh 8s 9h] [8c]
Solovyova: checks
blistein: checks
*** SHOW DOWN ***
Solovyova: shows [9c Tc] (two pair, Nines and Eights)
blistein: shows [Js Ks] (two pair, Jacks and Eights)
blistein collected $13.20 from pot
*** SUMMARY ***
Total pot $13.90 | Rake $0.70
Board [As Jh 8s 9h 8c]
Seat 1: n3v3ts94 (button) folded on the Flop
Seat 2: PERITTA (small blind) folded before Flop
Seat 3: Solovyova (big blind) showed [9c Tc] and lost with two pair, Nines and Eights
Seat 4: sims84 folded before Flop (didn't bet)
Seat 5: eeeLOVEnkov folded before Flop (didn't bet)
Seat 6: blistein showed [Js Ks] and won ($13.20) with two pair, Jacks and Eights


PokerStars Hand #226627251413:  Hold'em No Limit ($0.25/$0.50 USD) - 2021/05/10 5:00:09 ET
Table 'Alekto' 6-max Seat #2 is the button
Seat 1: n3v3ts94 ($33.32 in chips)
Seat 2: PERITTA ($57.25 in chips)
Seat 3: Solovyova ($50 in chips)
Seat 4: sims84 ($53.22 in chips)
Seat 5: eeeLOVEnkov ($64.90 in chips)
Seat 6: blistein ($60.02 in chips)
Solovyova: posts small blind $0.25
sims84: posts big blind $0.50
*** HOLE CARDS ***
eeeLOVEnkov: folds
blistein: folds
n3v3ts94: folds
PERITTA: raises $0.75 to $1.25
Solovyova: folds
sims84: calls $0.75
*** FLOP *** [2h Tc Qc]
sims84: checks
PERITTA: checks
*** TURN *** [2h Tc Qc] [2c]
sims84: checks
PERITTA: bets $1
sims84: calls $1
*** RIVER *** [2h Tc Qc 2c] [Ts]
sims84: checks
PERITTA: checks
*** SHOW DOWN ***
sims84: shows [As 6c] (two pair, Tens and Deuces)
PERITTA: shows [Ah Js] (two pair, Tens and Deuces)
sims84 collected $2.26 from pot
PERITTA collected $2.25 from pot
*** SUMMARY ***
Total pot $4.75 | Rake $0.24
Board [2h Tc Qc 2c Ts]
Seat 1: n3v3ts94 folded before Flop (didn't bet)
Seat 2: PERITTA (button) showed [Ah Js] and won ($2.25) with two pair, Tens and Deuces
Seat 3: Solovyova (small blind) folded before Flop
Seat 4: sims84 (big blind) showed [As 6c] and won ($2.26) with two pair, Tens and Deuces
Seat 5: eeeLOVEnkov folded before Flop (didn't bet)
Seat 6: blistein folded before Flop (didn't bet)


PokerStars Hand #226627267733:  Hold'em No Limit ($0.25/$0.50 USD) - 2021/05/10 5:01:38 ET
Table 'Alekto' 6-max Seat #6 is the button
Seat 1: n3v3ts94 ($33.57 in chips)
Seat 2: PERITTA ($57.25 in chips)
Seat 3: Solovyova ($50 in chips)
Seat 4: sims84 ($53.73 in chips)
Seat 6: blistein ($59.27 in chips)
n3v3ts94: posts small blind $0.25
PERITTA: posts big blind $0.50
*** HOLE CARDS ***
Solovyova: raises $0.60 to $1.10
sims84: folds
blistein: folds
n3v3ts94: folds
PERITTA: calls $0.60
*** FLOP *** [Qd 5c 6s]
PERITTA: checks
Solovyova: bets $0.79
PERITTA: raises $1.71 to $2.50
Solovyova: calls $1.71
*** TURN *** [Qd 5c 6s] [Ts]
PERITTA: checks
Solovyova: checks
*** RIVER *** [Qd 5c 6s Ts] [Td]
PERITTA: checks
Solovyova: checks
*** SHOW DOWN ***
PERITTA: shows [8d Ad] (a pair of Tens)
Solovyova: shows [9c 9d] (two pair, Tens and Nines)
Solovyova collected $7.08 from pot
*** SUMMARY ***
Total pot $7.45 | Rake $0.37
Board [Qd 5c 6s Ts Td]
Seat 1: n3v3ts94 (small blind) folded before Flop
Seat 2: PERITTA (big blind) showed [8d Ad] and lost with a pair of Tens
Seat 3: Solovyova showed [9c 9d] and won ($7.08) with two pair, Tens and Nines
Seat 4: sims84 folded before Flop (didn't bet)
Seat 6: blistein (button) folded before Flop (didn't bet)


PokerStars Hand #228825003128:  Hold'em No Limit ($0.25/$0.50 USD) - 2021/08/05 6:32:03 ET
Table 'Themisto III' 6-max Seat #4 is the button
Seat 1: MMM102 ($64.93 in chips)
Seat 3: big-sinder ($38.10 in chips)
Seat 4: andrewbal77 ($76.48 in chips)
Seat 5: SATAN0SS ($54.40 in chips)
Seat 6: blistein ($50 in chips)
SATAN0SS: posts small blind $0.25
blistein: posts big blind $0.50
OGamee: sits out
*** HOLE CARDS ***
MMM102: folds
big-sinder: calls $0.50
andrewbal77: calls $0.50
SATAN0SS: folds
blistein: checks
*** FLOP *** [8c 5c Ah]
blistein: checks
big-sinder: checks
andrewbal77: checks
*** TURN *** [8c 5c Ah] [4h]
blistein: checks
big-sinder: checks
andrewbal77: checks
*** RIVER *** [8c 5c Ah 4h] [Qc]
blistein: checks
big-sinder: checks
andrewbal77: checks
*** SHOW DOWN ***
blistein: shows [Js 2h] (high card Ace)
big-sinder: mucks hand
andrewbal77: shows [9d Kd] (high card Ace - King kicker)
andrewbal77 collected $1.66 from pot
*** SUMMARY ***
Total pot $1.75 | Rake $0.09
Board [8c 5c Ah 4h Qc]
Seat 1: MMM102 folded before Flop (didn't bet)
Seat 3: big-sinder mucked
Seat 4: andrewbal77 (button) showed [9d Kd] and won ($1.66) with high card Ace
Seat 5: SATAN0SS (small blind) folded before Flop
Seat 6: blistein (big blind) showed [Js 2h] and lost with high card Ace


PokerStars Hand #221286217504:  Hold'em No Limit ($0.25/$0.50 USD) - 2020/12/10 6:45:29 ET
Table 'Homam' 6-max Seat #5 is the button
Seat 1: Aleqseuka ($93.79 in chips)
Seat 2: Jarvid88 ($58.79 in chips)
Seat 3: Soulfly42 ($43.43 in chips)
Seat 4: ViktorBloom2 ($62.66 in chips)
Seat 5: blistein ($56.32 in chips)
Seat 6: coman567 ($69.57 in chips)
coman567: posts small blind $0.25
Aleqseuka: posts big blind $0.50
*** HOLE CARDS ***
Jarvid88: folds
Soulfly42: folds
ViktorBloom2: raises $0.73 to $1.23
blistein: folds
coman567: folds
Aleqseuka: calls $0.73
*** FLOP *** [4s Jh 8h]
Aleqseuka: checks
ViktorBloom2: bets $1.72
Aleqseuka: calls $1.72
*** TURN *** [4s Jh 8h] [8s]
Aleqseuka: checks
ViktorBloom2: checks
*** RIVER *** [4s Jh 8h 8s] [2s]
Aleqseuka: checks
ViktorBloom2: bets $3
Aleqseuka: calls $3
*** SHOW DOWN ***
ViktorBloom2: shows [Kh Qc] (a pair of Eights)
Aleqseuka: shows [Ac Qd] (a pair of Eights - Ace kicker)
Aleqseuka collected $11.54 from pot
*** SUMMARY ***
Total pot $12.15 | Rake $0.61
Board [4s Jh 8h 8s 2s]
Seat 1: Aleqseuka (big blind) showed [Ac Qd] and won ($11.54) with a pair of Eights
Seat 2: Jarvid88 folded before Flop (didn't bet)
Seat 3: Soulfly42 folded before Flop (didn't bet)
Seat 4: ViktorBloom2 showed [Kh Qc] and lost with a pair of Eights
Seat 5: blistein (button) folded before Flop (didn't bet)
Seat 6: coman567 (small blind) folded before Flop


PokerStars Hand #221286247993:  Hold'em No Limit ($0.25/$0.50 USD) - 2020/12/10 6:47:11 ET
Table 'Homam' 6-max Seat #6 is the button
Seat 1: Aleqseuka ($99.38 in chips)
Seat 2: Jarvid88 ($58.79 in chips)
Seat 3: Soulfly42 ($43.43 in chips)
Seat 4: ViktorBloom2 ($56.71 in chips)
Seat 5: blistein ($56.32 in chips)
Seat 6: coman567 ($69.32 in chips)
Aleqseuka: posts small blind $0.25
Jarvid88: posts big blind $0.50
*** HOLE CARDS ***
Soulfly42: raises $1.50 to $2
ViktorBloom2: folds
blistein: folds
coman567: folds
Aleqseuka: folds
Jarvid88: raises $4.25 to $6.25
Soulfly42: calls $4.25
*** FLOP *** [Ah 6c Tc]
Jarvid88: bets $4.50
Soulfly42: calls $4.50
*** TURN *** [Ah 6c Tc] [3s]
Jarvid88: bets $10.50
Soulfly42: calls $10.50
*** RIVER *** [Ah 6c Tc 3s] [Qd]
Jarvid88: bets $32.60
Soulfly42: calls $22.18 and is all-in
Uncalled bet ($10.42) returned to Jarvid88
*** SHOW DOWN ***
Jarvid88: shows [As Kc] (a pair of Aces)
Soulfly42: shows [Ad Jc] (a pair of Aces - lower kicker)
Jarvid88 collected $85.11 from pot
*** SUMMARY ***
Total pot $87.11 | Rake $2
Board [Ah 6c Tc 3s Qd]
Seat 1: Aleqseuka (small blind) folded before Flop
Seat 2: Jarvid88 (big blind) showed [As Kc] and won ($85.11) with a pair of Aces
Seat 3: Soulfly42 showed [Ad Jc] and lost with a pair of Aces
Seat 4: ViktorBloom2 folded before Flop (didn't bet)
Seat 5: blistein folded before Flop (didn't bet)
Seat 6: coman567 (button) folded before Flop (didn't bet)


PokerStars Hand #221286281053:  Hold'em No Limit ($0.25/$0.50 USD) - 2020/12/10 6:49:03 ET
Table 'Homam' 6-max Seat #5 is the button
Seat 1: Aleqseuka ($102.86 in chips)
Seat 2: Jarvid88 ($94.97 in chips)
Seat 3: Soulfly42 ($39.25 in chips)
Seat 4: ViktorBloom2 ($59.96 in chips)
Seat 5: blistein ($55.57 in chips)
Seat 6: coman567 ($68.82 in chips)
coman567: posts small blind $0.25
Aleqseuka: posts big blind $0.50
*** HOLE CARDS ***
Jarvid88: folds
Soulfly42: calls $0.50
ViktorBloom2: folds
blistein: raises $1.50 to $2
coman567: folds
Aleqseuka: folds
Soulfly42: calls $1.50
*** FLOP *** [5d 5h 7d]
Soulfly42: checks
blistein: bets $2.48
Soulfly42: calls $2.48
*** TURN *** [5d 5h 7d] [Ks]
Soulfly42: checks
blistein: checks
*** RIVER *** [5d 5h 7d Ks] [2d]
Soulfly42: bets $2
blistein: calls $2
*** SHOW DOWN ***
Soulfly42: shows [Qd 7h] (two pair, Sevens and Fives)
blistein: mucks hand
Soulfly42 collected $13.02 from pot
*** SUMMARY ***
Total pot $13.71 | Rake $0.69
Board [5d 5h 7d Ks 2d]
Seat 1: Aleqseuka (big blind) folded before Flop
Seat 2: Jarvid88 folded before Flop (didn't bet)
Seat 3: Soulfly42 showed [Qd 7h] and won ($13.02) with two pair, Sevens and Fives
Seat 4: ViktorBloom2 folded before Flop (didn't bet)
Seat 5: blistein (button) mucked
Seat 6: coman567 (small blind) folded before Flop


PokerStars Hand #221286303485:  Hold'em No Limit ($0.25/$0.50 USD) - 2020/12/10 6:50:19 ET
Table 'Homam' 6-max Seat #1 is the button
Seat 1: Aleqseuka ($102.11 in chips)
Seat 2: Jarvid88 ($94.47 in chips)
Seat 3: Soulfly42 ($45.79 in chips)
Seat 4: ViktorBloom2 ($59.96 in chips)
Seat 5: blistein ($50 in chips)
Seat 6: coman567 ($69.32 in chips)
Jarvid88: posts small blind $0.25
Soulfly42: posts big blind $0.50
*** HOLE CARDS ***
ViktorBloom2: folds
blistein: folds
coman567: raises $1 to $1.50
Aleqseuka: calls $1.50
Jarvid88: calls $1.25
Soulfly42: folds
*** FLOP *** [9d 5s 8d]
Jarvid88: checks
coman567: checks
Aleqseuka: bets $1.43
Jarvid88: folds
coman567: calls $1.43
*** TURN *** [9d 5s 8d] [Qc]
coman567: checks
Aleqseuka: checks
*** RIVER *** [9d 5s 8d Qc] [7c]
coman567: checks
Aleqseuka: checks
*** SHOW DOWN ***
coman567: shows [Js 9s] (a pair of Nines)
Aleqseuka: mucks hand
coman567 collected $7.47 from pot
*** SUMMARY ***
Total pot $7.86 | Rake $0.39
Board [9d 5s 8d Qc 7c]
Seat 1: Aleqseuka (button) mucked
Seat 2: Jarvid88 (small blind) folded on the Flop
Seat 3: Soulfly42 (big blind) folded before Flop
Seat 4: ViktorBloom2 folded before Flop (didn't bet)
Seat 5: blistein folded before Flop (didn't bet)
Seat 6: coman567 showed [Js 9s] and won ($7.47) with a pair of Nines


PokerStars Hand #221286324428:  Hold'em No Limit ($0.25/$0.50 USD) - 2020/12/10 6:51:30 ET
Table 'Homam' 6-max Seat #2 is the button
Seat 1: Aleqseuka ($99.18 in chips)
Seat 2: Jarvid88 ($92.97 in chips)
Seat 3: Soulfly42 ($45.29 in chips)
Seat 4: ViktorBloom2 ($59.96 in chips)
Seat 5: blistein ($50 in chips)
Seat 6: coman567 ($73.86 in chips)
Soulfly42: posts small blind $0.25
ViktorBloom2: posts big blind $0.50
*** HOLE CARDS ***
blistein: folds
coman567: raises $1 to $1.50
Aleqseuka: folds
Jarvid88: folds
Soulfly42: raises $2.50 to $4
ViktorBloom2: folds
coman567: calls $2.50
*** FLOP *** [8c Jh 6s]
Soulfly42: checks
coman567: checks
*** TURN *** [8c Jh 6s] [2h]
Soulfly42: checks
coman567: bets $2.67
Soulfly42: calls $2.67
*** RIVER *** [8c Jh 6s 2h] [Ts]
Soulfly42: checks
coman567: bets $1.99
Soulfly42: calls $1.99
*** SHOW DOWN ***
coman567: shows [9s 9c] (a pair of Nines)
Soulfly42: mucks hand
coman567 collected $16.93 from pot
*** SUMMARY ***
Total pot $17.82 | Rake $0.89
Board [8c Jh 6s 2h Ts]
Seat 1: Aleqseuka folded before Flop (didn't bet)
Seat 2: Jarvid88 (button) folded before Flop (didn't bet)
Seat 3: Soulfly42 (small blind) mucked
Seat 4: ViktorBloom2 (big blind) folded before Flop
Seat 5: blistein folded before Flop (didn't bet)
Seat 6: coman567 showed [9s 9c] and won ($16.93) with a pair of Nines


PokerStars Hand #221286358382:  Hold'em No Limit ($0.25/$0.50 USD) - 2020/12/10 6:53:23 ET
Table 'Homam' 6-max Seat #6 is the button
Seat 1: Aleqseuka ($98.68 in chips)
Seat 2: Jarvid88 ($93.72 in chips)
Seat 3: Soulfly42 ($35.38 in chips)
Seat 4: ViktorBloom2 ($59.21 in chips)
Seat 5: blistein ($50 in chips)
Seat 6: coman567 ($83.91 in chips)
Aleqseuka: posts small blind $0.25
Jarvid88: posts big blind $0.50
*** HOLE CARDS ***
Soulfly42: calls $0.50
ViktorBloom2: folds
blistein: folds
coman567: folds
Aleqseuka: raises $1.50 to $2
Jarvid88: calls $1.50
Soulfly42: folds
*** FLOP *** [Js 3d 2s]
Aleqseuka: checks
Jarvid88: checks
*** TURN *** [Js 3d 2s] [Ks]
Aleqseuka: checks
Jarvid88: checks
*** RIVER *** [Js 3d 2s Ks] [3h]
Aleqseuka: checks
Jarvid88: checks
*** SHOW DOWN ***
Aleqseuka: shows [9d Ad] (a pair of Threes)
Jarvid88: mucks hand
Aleqseuka collected $4.28 from pot
*** SUMMARY ***
Total pot $4.50 | Rake $0.22
Board [Js 3d 2s Ks 3h]
Seat 1: Aleqseuka (small blind) showed [9d Ad] and won ($4.28) with a pair of Threes
Seat 2: Jarvid88 (big blind) mucked
Seat 3: Soulfly42 folded before Flop
Seat 4: ViktorBloom2 folded before Flop (didn't bet)
Seat 5: blistein folded before Flop (didn't bet)
Seat 6: coman567 (button) folded before Flop (didn't bet)


PokerStars Hand #221288195599:  Hold'em No Limit ($0.25/$0.50 USD) - 2020/12/10 8:29:05 ET
Table 'Homam' 6-max Seat #2 is the button
Seat 2: Jarvid88 ($73.94 in chips)
Seat 3: vybz111 ($29.20 in chips)
Seat 4: P3RRYG25 ($71.06 in chips)
Seat 5: Ruzik89 ($64.22 in chips)
Seat 6: Akeli4_by ($91.29 in chips)
vybz111: posts small blind $0.25
P3RRYG25: posts big blind $0.50
blistein: sits out
*** HOLE CARDS ***
Ruzik89: folds
Akeli4_by: folds
Jarvid88: raises $0.75 to $1.25
vybz111: calls $1
P3RRYG25: calls $0.75
*** FLOP *** [Qd 2s 3h]
vybz111: checks
P3RRYG25: checks
Jarvid88: checks
*** TURN *** [Qd 2s 3h] [5d]
vybz111: checks
P3RRYG25: checks
Jarvid88: checks
*** RIVER *** [Qd 2s 3h 5d] [9c]
vybz111: checks
P3RRYG25: checks
Jarvid88: checks
*** SHOW DOWN ***
vybz111: shows [Td Ac] (high card Ace)
P3RRYG25: shows [7h 9h] (a pair of Nines)
Jarvid88: mucks hand
P3RRYG25 collected $3.56 from pot
*** SUMMARY ***
Total pot $3.75 | Rake $0.19
Board [Qd 2s 3h 5d 9c]
Seat 2: Jarvid88 (button) mucked
Seat 3: vybz111 (small blind) showed [Td Ac] and lost with high card Ace
Seat 4: P3RRYG25 (big blind) showed [7h 9h] and won ($3.56) with a pair of Nines
Seat 5: Ruzik89 folded before Flop (didn't bet)
Seat 6: Akeli4_by folded before Flop (didn't bet)


PokerStars Hand #221288224282:  Hold'em No Limit ($0.25/$0.50 USD) - 2020/12/10 8:30:24 ET
Table 'Homam' 6-max Seat #1 is the button
Seat 1: blistein ($50 in chips)
Seat 2: Jarvid88 ($73.69 in chips)
Seat 3: vybz111 ($29.45 in chips)
Seat 4: P3RRYG25 ($73.12 in chips)
Seat 5: Ruzik89 ($63.47 in chips)
Seat 6: Akeli4_by ($90.54 in chips)
Jarvid88: posts small blind $0.25
vybz111: posts big blind $0.50
*** HOLE CARDS ***
P3RRYG25: raises $0.60 to $1.10
Ruzik89: folds
Akeli4_by: folds
blistein: folds
Jarvid88: folds
vybz111: calls $0.60
*** FLOP *** [Jd 5s Ac]
vybz111: checks
P3RRYG25: checks
*** TURN *** [Jd 5s Ac] [4h]
vybz111: checks
P3RRYG25: bets $1
vybz111: calls $1
*** RIVER *** [Jd 5s Ac 4h] [7c]
vybz111: checks
P3RRYG25: checks
*** SHOW DOWN ***
vybz111: shows [6s 7h] (a pair of Sevens)
P3RRYG25: mucks hand
vybz111 collected $4.23 from pot
*** SUMMARY ***
Total pot $4.45 | Rake $0.22
Board [Jd 5s Ac 4h 7c]
Seat 1: blistein (button) folded before Flop (didn't bet)
Seat 2: Jarvid88 (small blind) folded before Flop
Seat 3: vybz111 (big blind) showed [6s 7h] and won ($4.23) with a pair of Sevens
Seat 4: P3RRYG25 mucked
Seat 5: Ruzik89 folded before Flop (didn't bet)
Seat 6: Akeli4_by folded before Flop (didn't bet)


PokerStars Hand #221294154450:  Hold'em No Limit ($0.25/$0.50 USD) - 2020/12/10 12:18:13 ET
Table 'Homam' 6-max Seat #3 is the button
Seat 1: TrOtPhoenix ($53.76 in chips)
Seat 2: fcgl ($51.84 in chips)
Seat 3: Ma1n1 ($50 in chips)
Seat 4: Machier ($22.10 in chips)
Seat 5: DXJ7 ($115.29 in chips)
Seat 6: blistein ($50.50 in chips)
Machier: posts small blind $0.25
DXJ7: posts big blind $0.50
*** HOLE CARDS ***
blistein: folds
TrOtPhoenix: folds
fcgl: folds
Ma1n1: folds
Machier: raises $0.50 to $1
DXJ7: calls $0.50
*** FLOP *** [Qd Ah 5s]
Machier: bets $0.50
DXJ7: raises $1.50 to $2
Machier: calls $1.50
*** TURN *** [Qd Ah 5s] [Ac]
Machier: bets $0.50
DXJ7: calls $0.50
*** RIVER *** [Qd Ah 5s Ac] [Ks]
Machier: bets $3.32
DXJ7: raises $5.68 to $9
Machier: calls $5.68
*** SHOW DOWN ***
DXJ7: shows [Tc Js] (a straight, Ten to Ace)
Machier: mucks hand
DXJ7 collected $23.75 from pot
*** SUMMARY ***
Total pot $25 | Rake $1.25
Board [Qd Ah 5s Ac Ks]
Seat 1: TrOtPhoenix folded before Flop (didn't bet)
Seat 2: fcgl folded before Flop (didn't bet)
Seat 3: Ma1n1 (button) folded before Flop (didn't bet)
Seat 4: Machier (small blind) mucked
Seat 5: DXJ7 (big blind) showed [Tc Js] and won ($23.75) with a straight, Ten to Ace
Seat 6: blistein folded before Flop (didn't bet)


PokerStars Hand #221294185178:  Hold'em No Limit ($0.25/$0.50 USD) - 2020/12/10 12:19:12 ET
Table 'Homam' 6-max Seat #4 is the button
Seat 1: TrOtPhoenix ($53.76 in chips)
Seat 2: fcgl ($51.84 in chips)
Seat 3: Ma1n1 ($50 in chips)
Seat 4: Machier ($9.60 in chips)
Seat 5: DXJ7 ($126.54 in chips)
Seat 6: blistein ($50.50 in chips)
DXJ7: posts small blind $0.25
blistein: posts big blind $0.50
*** HOLE CARDS ***
TrOtPhoenix: raises $0.75 to $1.25
fcgl: folds
Ma1n1: folds
Machier: calls $1.25
DXJ7: folds
blistein: folds
*** FLOP *** [5d 4c Ad]
TrOtPhoenix: checks
Machier: checks
*** TURN *** [5d 4c Ad] [Jh]
TrOtPhoenix: bets $2.16
Machier: calls $2.16
*** RIVER *** [5d 4c Ad Jh] [9c]
TrOtPhoenix: bets $5.03
Machier: calls $5.03
*** SHOW DOWN ***
TrOtPhoenix: shows [7c Ac] (a pair of Aces)
Machier: mucks hand
TrOtPhoenix collected $16.75 from pot
*** SUMMARY ***
Total pot $17.63 | Rake $0.88
Board [5d 4c Ad Jh 9c]
Seat 1: TrOtPhoenix showed [7c Ac] and won ($16.75) with a pair of Aces
Seat 2: fcgl folded before Flop (didn't bet)
Seat 3: Ma1n1 folded before Flop (didn't bet)
Seat 4: Machier (button) mucked
Seat 5: DXJ7 (small blind) folded before Flop
Seat 6: blistein (big blind) folded before Flop


PokerStars Hand #221294231527:  Hold'em No Limit ($0.25/$0.50 USD) - 2020/12/10 12:20:40 ET
Table 'Homam' 6-max Seat #1 is the button
Seat 1: TrOtPhoenix ($63.18 in chips)
Seat 2: fcgl ($50.84 in chips)
Seat 3: Ma1n1 ($50 in chips)
Seat 4: Machier ($1.16 in chips)
Seat 5: DXJ7 ($126.29 in chips)
Seat 6: blistein ($50 in chips)
fcgl: posts small blind $0.25
Ma1n1: posts big blind $0.50
*** HOLE CARDS ***
Machier: raises $0.66 to $1.16 and is all-in
DXJ7: folds
blistein: folds
TrOtPhoenix: folds
fcgl: folds
Ma1n1: calls $0.66
*** FLOP *** [Jh 5s Th]
*** TURN *** [Jh 5s Th] [4s]
*** RIVER *** [Jh 5s Th 4s] [7d]
*** SHOW DOWN ***
Ma1n1: shows [Qd Qs] (a pair of Queens)
Machier: shows [Kh 3h] (high card King)
Ma1n1 collected $2.44 from pot
*** SUMMARY ***
Total pot $2.57 | Rake $0.13
Board [Jh 5s Th 4s 7d]
Seat 1: TrOtPhoenix (button) folded before Flop (didn't bet)
Seat 2: fcgl (small blind) folded before Flop
Seat 3: Ma1n1 (big blind) showed [Qd Qs] and won ($2.44) with a pair of Queens
Seat 4: Machier showed [Kh 3h] and lost with high card King
Seat 5: DXJ7 folded before Flop (didn't bet)
Seat 6: blistein folded before Flop (didn't bet)


PokerStars Hand #221294354055:  Hold'em No Limit ($0.25/$0.50 USD) - 2020/12/10 12:24:33 ET
Table 'Homam' 6-max Seat #4 is the button
Seat 1: TrOtPhoenix ($57.97 in chips)
Seat 4: Machier ($20.60 in chips)
Seat 5: DXJ7 ($128.83 in chips)
Seat 6: blistein ($54.64 in chips)
DXJ7: posts small blind $0.25
blistein: posts big blind $0.50
*** HOLE CARDS ***
TrOtPhoenix: folds
Machier: raises $0.50 to $1
DXJ7: raises $2.50 to $3.50
blistein: folds
Machier: raises $17.10 to $20.60 and is all-in
DXJ7: calls $17.10
*** FLOP *** [Qd 8h 5d]
*** TURN *** [Qd 8h 5d] [6c]
*** RIVER *** [Qd 8h 5d 6c] [9d]
*** SHOW DOWN ***
DXJ7: shows [9s 9h] (three of a kind, Nines)
Machier: shows [Jc Ad] (high card Ace)
DXJ7 collected $40.95 from pot
*** SUMMARY ***
Total pot $41.70 | Rake $0.75
Board [Qd 8h 5d 6c 9d]
Seat 1: TrOtPhoenix folded before Flop (didn't bet)
Seat 4: Machier (button) showed [Jc Ad] and lost with high card Ace
Seat 5: DXJ7 (small blind) showed [9s 9h] and won ($40.95) with three of a kind, Nines
Seat 6: blistein (big blind) folded before Flop


PokerStars Hand #221294375954:  Hold'em No Limit ($0.25/$0.50 USD) - 2020/12/10 12:25:14 ET
Table 'Homam' 6-max Seat #6 is the button
Seat 1: TrOtPhoenix ($57.47 in chips)
Seat 5: DXJ7 ($149.18 in chips)
Seat 6: blistein ($54.64 in chips)
TrOtPhoenix: posts small blind $0.25
DXJ7: posts big blind $0.50
*** HOLE CARDS ***
spartaknv joins the table at seat #3
blistein: folds
TrOtPhoenix: raises $1 to $1.50
DXJ7: calls $1
*** FLOP *** [Ah Kc Ac]
TrOtPhoenix: bets $0.86
DXJ7: calls $0.86
*** TURN *** [Ah Kc Ac] [4h]
TrOtPhoenix: checks
DXJ7: checks
*** RIVER *** [Ah Kc Ac 4h] [3d]
TrOtPhoenix: checks
DXJ7: checks
*** SHOW DOWN ***
TrOtPhoenix: shows [Jd 9d] (a pair of Aces)
DXJ7: shows [Qc 4c] (two pair, Aces and Fours)
DXJ7 collected $4.48 from pot
*** SUMMARY ***
Total pot $4.72 | Rake $0.24
Board [Ah Kc Ac 4h 3d]
Seat 1: TrOtPhoenix (small blind) showed [Jd 9d] and lost with a pair of Aces
Seat 5: DXJ7 (big blind) showed [Qc 4c] and won ($4.48) with two pair, Aces and Fours
Seat 6: blistein (button) folded before Flop (didn't bet)


PokerStars Hand #221294485885:  Hold'em No Limit ($0.25/$0.50 USD) - 2020/12/10 12:28:34 ET
Table 'Homam' 6-max Seat #6 is the button
Seat 1: TrOtPhoenix ($55.36 in chips)
Seat 2: yutabou ($50 in chips)
Seat 3: spartaknv ($57.94 in chips)
Seat 4: Machier ($30.97 in chips)
Seat 5: DXJ7 ($141.89 in chips)
Seat 6: blistein ($53.89 in chips)
TrOtPhoenix: posts small blind $0.25
yutabou: posts big blind $0.50
*** HOLE CARDS ***
spartaknv: folds
Machier: folds
DXJ7: raises $0.65 to $1.15
blistein: folds
TrOtPhoenix: folds
yutabou: raises $2.55 to $3.70
DXJ7: raises $5.30 to $9
yutabou: calls $5.30
*** FLOP *** [5s 5h Kc]
yutabou: bets $17.34
DXJ7: calls $17.34
*** TURN *** [5s 5h Kc] [8d]
yutabou: bets $23.66 and is all-in
DXJ7: calls $23.66
*** RIVER *** [5s 5h Kc 8d] [6d]
*** SHOW DOWN ***
yutabou: shows [Tc Qd] (a pair of Fives)
DXJ7: shows [As Ad] (two pair, Aces and Fives)
DXJ7 collected $98.25 from pot
*** SUMMARY ***
Total pot $100.25 | Rake $2
Board [5s 5h Kc 8d 6d]
Seat 1: TrOtPhoenix (small blind) folded before Flop
Seat 2: yutabou (big blind) showed [Tc Qd] and lost with a pair of Fives
Seat 3: spartaknv folded before Flop (didn't bet)
Seat 4: Machier folded before Flop (didn't bet)
Seat 5: DXJ7 showed [As Ad] and won ($98.25) with two pair, Aces and Fives
Seat 6: blistein (button) folded before Flop (didn't bet)


PokerStars Hand #221294574256:  Hold'em No Limit ($0.25/$0.50 USD) - 2020/12/10 12:31:12 ET
Table 'Homam' 6-max Seat #6 is the button
Seat 1: TrOtPhoenix ($53.36 in chips)
Seat 2: Akeli4_by ($50 in chips)
Seat 4: Machier ($31.22 in chips)
Seat 5: DXJ7 ($189.89 in chips)
Seat 6: blistein ($55.75 in chips)
TrOtPhoenix: posts small blind $0.25
Akeli4_by: posts big blind $0.50
orobertino: sits out
*** HOLE CARDS ***
Machier: folds
DXJ7: folds
blistein: folds
TrOtPhoenix: raises $1 to $1.50
Akeli4_by: raises $3.50 to $5
TrOtPhoenix: calls $3.50
*** FLOP *** [6s 3d 7c]
TrOtPhoenix: checks
Akeli4_by: checks
*** TURN *** [6s 3d 7c] [6h]
TrOtPhoenix: checks
Akeli4_by: bets $2.95
TrOtPhoenix: calls $2.95
*** RIVER *** [6s 3d 7c 6h] [9s]
TrOtPhoenix: checks
Akeli4_by: checks
*** SHOW DOWN ***
TrOtPhoenix: shows [Tc Ac] (a pair of Sixes)
Akeli4_by: shows [Td Ad] (a pair of Sixes)
TrOtPhoenix collected $7.55 from pot
Akeli4_by collected $7.55 from pot
*** SUMMARY ***
Total pot $15.90 | Rake $0.80
Board [6s 3d 7c 6h 9s]
Seat 1: TrOtPhoenix (small blind) showed [Tc Ac] and won ($7.55) with a pair of Sixes
Seat 2: Akeli4_by (big blind) showed [Td Ad] and won ($7.55) with a pair of Sixes
Seat 4: Machier folded before Flop (didn't bet)
Seat 5: DXJ7 folded before Flop (didn't bet)
Seat 6: blistein (button) folded before Flop (didn't bet)


PokerStars Hand #221294710915:  Hold'em No Limit ($0.25/$0.50 USD) - 2020/12/10 12:35:12 ET
Table 'Homam' 6-max Seat #4 is the button
Seat 1: TrOtPhoenix ($53.71 in chips)
Seat 2: Akeli4_by ($57.31 in chips)
Seat 3: orobertino ($50 in chips)
Seat 4: Machier ($22.97 in chips)
Seat 5: DXJ7 ($196.70 in chips)
Seat 6: blistein ($55.75 in chips)
DXJ7: posts small blind $0.25
blistein: posts big blind $0.50
*** HOLE CARDS ***
TrOtPhoenix: folds
TrOtPhoenix leaves the table
Akeli4_by: folds
orobertino: folds
Machier: raises $0.50 to $1
DXJ7: folds
blistein: calls $0.50
*** FLOP *** [Kh Ts 2h]
Openson joins the table at seat #1
blistein: checks
Machier: checks
*** TURN *** [Kh Ts 2h] [8h]
blistein: bets $0.71
Machier: calls $0.71
*** RIVER *** [Kh Ts 2h 8h] [Th]
blistein: checks
Machier: checks
*** SHOW DOWN ***
blistein: shows [6c 4c] (a pair of Tens)
Machier: shows [3s As] (a pair of Tens - Ace kicker)
Machier collected $3.49 from pot
*** SUMMARY ***
Total pot $3.67 | Rake $0.18
Board [Kh Ts 2h 8h Th]
Seat 1: TrOtPhoenix folded before Flop (didn't bet)
Seat 2: Akeli4_by folded before Flop (didn't bet)
Seat 3: orobertino folded before Flop (didn't bet)
Seat 4: Machier (button) showed [3s As] and won ($3.49) with a pair of Tens
Seat 5: DXJ7 (small blind) folded before Flop
Seat 6: blistein (big blind) showed [6c 4c] and lost with a pair of Tens


PokerStars Hand #221294725635:  Hold'em No Limit ($0.25/$0.50 USD) - 2020/12/10 12:35:38 ET
Table 'Homam' 6-max Seat #5 is the button
Seat 1: Openson ($50 in chips)
Seat 2: Akeli4_by ($57.31 in chips)
Seat 3: orobertino ($50 in chips)
Seat 4: Machier ($24.75 in chips)
Seat 5: DXJ7 ($196.45 in chips)
Seat 6: blistein ($54.04 in chips)
blistein: posts small blind $0.25
Openson: posts big blind $0.50
*** HOLE CARDS ***
Akeli4_by: raises $1 to $1.50
orobertino: raises $3 to $4.50
Machier: folds
DXJ7: folds
blistein: folds
Openson: folds
Akeli4_by: raises $7.50 to $12
orobertino: raises $38 to $50 and is all-in
Akeli4_by: calls $38
*** FLOP *** [4s Th Ah]
*** TURN *** [4s Th Ah] [3h]
*** RIVER *** [4s Th Ah 3h] [3s]
*** SHOW DOWN ***
Akeli4_by: shows [As Ad] (a full house, Aces full of Threes)
orobertino: shows [Kh Kd] (two pair, Kings and Threes)
Akeli4_by collected $98.75 from pot
*** SUMMARY ***
Total pot $100.75 | Rake $2
Board [4s Th Ah 3h 3s]
Seat 1: Openson (big blind) folded before Flop
Seat 2: Akeli4_by showed [As Ad] and won ($98.75) with a full house, Aces full of Threes
Seat 3: orobertino showed [Kh Kd] and lost with two pair, Kings and Threes
Seat 4: Machier folded before Flop (didn't bet)
Seat 5: DXJ7 (button) folded before Flop (didn't bet)
Seat 6: blistein (small blind) folded before Flop


PokerStars Hand #221294793280:  Hold'em No Limit ($0.25/$0.50 USD) - 2020/12/10 12:37:37 ET
Table 'Homam' 6-max Seat #3 is the button
Seat 1: Openson ($51.36 in chips)
Seat 2: Akeli4_by ($106.06 in chips)
Seat 3: orobertino ($50 in chips)
Seat 4: Machier ($23.35 in chips)
Seat 5: DXJ7 ($197.95 in chips)
Seat 6: blistein ($53.79 in chips)
Machier: posts small blind $0.25
DXJ7: posts big blind $0.50
*** HOLE CARDS ***
blistein: raises $1 to $1.50
Openson: folds
Akeli4_by: folds
orobertino: folds
Machier: calls $1.25
DXJ7: folds
*** FLOP *** [9c Ah 2c]
Machier: checks
blistein: bets $1.83
Machier: calls $1.83
*** TURN *** [9c Ah 2c] [3c]
Machier: checks
blistein: checks
*** RIVER *** [9c Ah 2c 3c] [Kd]
Machier: checks
blistein: checks
*** SHOW DOWN ***
Machier: shows [9s 8d] (a pair of Nines)
blistein: shows [Td Th] (a pair of Tens)
blistein collected $6.80 from pot
*** SUMMARY ***
Total pot $7.16 | Rake $0.36
Board [9c Ah 2c 3c Kd]
Seat 1: Openson folded before Flop (didn't bet)
Seat 2: Akeli4_by folded before Flop (didn't bet)
Seat 3: orobertino (button) folded before Flop (didn't bet)
Seat 4: Machier (small blind) showed [9s 8d] and lost with a pair of Nines
Seat 5: DXJ7 (big blind) folded before Flop
Seat 6: blistein showed [Td Th] and won ($6.80) with a pair of Tens


PokerStars Hand #221294836540:  Hold'em No Limit ($0.25/$0.50 USD) - 2020/12/10 12:38:53 ET
Table 'Homam' 6-max Seat #6 is the button
Seat 1: Openson ($50.86 in chips)
Seat 2: Akeli4_by ($110.53 in chips)
Seat 3: orobertino ($50 in chips)
Seat 4: Machier ($15.85 in chips)
Seat 5: DXJ7 ($197.20 in chips)
Seat 6: blistein ($57.26 in chips)
Openson: posts small blind $0.25
Akeli4_by: posts big blind $0.50
*** HOLE CARDS ***
orobertino: folds
Machier: raises $0.50 to $1
DXJ7: folds
blistein: raises $2.50 to $3.50
orobertino was removed from the table for failing to post
orobertino leaves the table
Openson: folds
Shava3012 joins the table at seat #3
Akeli4_by: folds
Machier: calls $2.50
*** FLOP *** [Jh 9c 4s]
Machier: checks
blistein: bets $4.05
Machier: raises $8.30 to $12.35 and is all-in
blistein: calls $8.30
*** TURN *** [Jh 9c 4s] [2c]
*** RIVER *** [Jh 9c 4s 2c] [Qs]
*** SHOW DOWN ***
Machier: shows [Jd 6d] (a pair of Jacks)
blistein: shows [Ah Qc] (a pair of Queens)
blistein collected $30.83 from pot
*** SUMMARY ***
Total pot $32.45 | Rake $1.62
Board [Jh 9c 4s 2c Qs]
Seat 1: Openson (small blind) folded before Flop
Seat 2: Akeli4_by (big blind) folded before Flop
Seat 3: orobertino folded before Flop (didn't bet)
Seat 4: Machier showed [Jd 6d] and lost with a pair of Jacks
Seat 5: DXJ7 folded before Flop (didn't bet)
Seat 6: blistein (button) showed [Ah Qc] and won ($30.83) with a pair of Queens


PokerStars Hand #221294952846:  Hold'em No Limit ($0.25/$0.50 USD) - 2020/12/10 12:42:18 ET
Table 'Homam' 6-max Seat #2 is the button
Seat 2: Akeli4_by ($106.62 in chips)
Seat 3: Shava3012 ($56 in chips)
Seat 4: okiedokiepoker ($28.25 in chips)
Shava3012: posts small blind $0.25
okiedokiepoker: posts big blind $0.50
Pavel Podkur: sits out
blistein: sits out
Openson: sits out
*** HOLE CARDS ***
Akeli4_by: raises $1 to $1.50
Shava3012: folds
okiedokiepoker: calls $1
*** FLOP *** [7s Qc 3h]
okiedokiepoker: checks
Akeli4_by: bets $0.96
okiedokiepoker: calls $0.96
*** TURN *** [7s Qc 3h] [6c]
okiedokiepoker: checks
Akeli4_by: checks
*** RIVER *** [7s Qc 3h 6c] [8h]
okiedokiepoker: checks
Akeli4_by: checks
*** SHOW DOWN ***
okiedokiepoker: shows [As 5c] (high card Ace)
Akeli4_by: shows [Ah 6d] (a pair of Sixes)
Akeli4_by collected $4.91 from pot
*** SUMMARY ***
Total pot $5.17 | Rake $0.26
Board [7s Qc 3h 6c 8h]
Seat 2: Akeli4_by (button) showed [Ah 6d] and won ($4.91) with a pair of Sixes
Seat 3: Shava3012 (small blind) folded before Flop
Seat 4: okiedokiepoker (big blind) showed [As 5c] and lost with high card Ace


PokerStars Hand #221295000066:  Hold'em No Limit ($0.25/$0.50 USD) - 2020/12/10 12:43:41 ET
Table 'Homam' 6-max Seat #1 is the button
Seat 1: Openson ($50 in chips)
Seat 2: Akeli4_by ($108.57 in chips)
Seat 3: Shava3012 ($55 in chips)
Seat 4: okiedokiepoker ($27.04 in chips)
Seat 5: Pavel Podkur ($51.34 in chips)
Seat 6: blistein ($69.24 in chips)
Akeli4_by: posts small blind $0.25
Shava3012: posts big blind $0.50
*** HOLE CARDS ***
okiedokiepoker: folds
Pavel Podkur: folds
blistein: folds
Openson: folds
Akeli4_by: raises $1 to $1.50
Shava3012: calls $1
*** FLOP *** [6s 9c 8s]
Akeli4_by: checks
Shava3012: bets $2
Akeli4_by: calls $2
*** TURN *** [6s 9c 8s] [Ts]
Akeli4_by: checks
Shava3012: bets $5
Akeli4_by: calls $5
*** RIVER *** [6s 9c 8s Ts] [2c]
Akeli4_by: checks
Shava3012: checks
*** SHOW DOWN ***
Akeli4_by: shows [Ks Tc] (a pair of Tens)
Shava3012: shows [Jc 7c] (a straight, Seven to Jack)
Shava3012 collected $16.15 from pot
*** SUMMARY ***
Total pot $17 | Rake $0.85
Board [6s 9c 8s Ts 2c]
Seat 1: Openson (button) folded before Flop (didn't bet)
Seat 2: Akeli4_by (small blind) showed [Ks Tc] and lost with a pair of Tens
Seat 3: Shava3012 (big blind) showed [Jc 7c] and won ($16.15) with a straight, Seven to Jack
Seat 4: okiedokiepoker folded before Flop (didn't bet)
Seat 5: Pavel Podkur folded before Flop (didn't bet)
Seat 6: blistein folded before Flop (didn't bet)


PokerStars Hand #232868646837:  Hold'em No Limit ($0.25/$0.50 USD) - 2022/01/06 8:59:06 ET
Table 'Kollaa IV' 6-max Seat #1 is the button
Seat 1: Rakechaser ($52 in chips)
Seat 2: Estevancvel ($50 in chips)
Seat 4: J4SunO ($63.26 in chips)
Seat 5: Margadon78 ($29.97 in chips)
Seat 6: ahs14789 ($36.63 in chips)
Estevancvel: posts small blind $0.25
J4SunO: posts big blind $0.50
*** HOLE CARDS ***
Margadon78: raises $0.50 to $1
ahs14789: folds
Rakechaser: raises $2 to $3
Estevancvel: folds
J4SunO: folds
blistein joins the table at seat #3
Margadon78: calls $2
*** FLOP *** [7d Kd 2s]
Margadon78: checks
Rakechaser: bets $2.12
Margadon78: calls $2.12
*** TURN *** [7d Kd 2s] [4d]
Margadon78: checks
Rakechaser: checks
*** RIVER *** [7d Kd 2s 4d] [3h]
Margadon78: bets $8.22
Rakechaser: calls $8.22
*** SHOW DOWN ***
Margadon78: shows [Ad Jh] (high card Ace)
Rakechaser: shows [Kh Th] (a pair of Kings)
Rakechaser collected $25.72 from pot
*** SUMMARY ***
Total pot $27.43 | Rake $1.71
Board [7d Kd 2s 4d 3h]
Seat 1: Rakechaser (button) showed [Kh Th] and won ($25.72) with a pair of Kings
Seat 2: Estevancvel (small blind) folded before Flop
Seat 4: J4SunO (big blind) folded before Flop
Seat 5: Margadon78 showed [Ad Jh] and lost with high card Ace
Seat 6: ahs14789 folded before Flop (didn't bet)


PokerStars Hand #232868705485:  Hold'em No Limit ($0.25/$0.50 USD) - 2022/01/06 9:02:15 ET
Table 'Kollaa IV' 6-max Seat #3 is the button
Seat 1: Rakechaser ($62.82 in chips)
Seat 2: Estevancvel ($50 in chips)
Seat 3: blistein ($50 in chips)
Seat 4: J4SunO ($65.12 in chips)
Seat 5: Margadon78 ($10.52 in chips)
Seat 6: ahs14789 ($42.49 in chips)
J4SunO: posts small blind $0.25
Margadon78: posts big blind $0.50
*** HOLE CARDS ***
ahs14789: folds
Rakechaser: folds
Estevancvel: raises $1 to $1.50
blistein: raises $3 to $4.50
J4SunO: folds
Margadon78: raises $6.02 to $10.52 and is all-in
Estevancvel: folds
blistein: calls $6.02
*** FLOP *** [3s As 4c]
*** TURN *** [3s As 4c] [5d]
*** RIVER *** [3s As 4c 5d] [3c]
*** SHOW DOWN ***
Margadon78: shows [Kc Kh] (two pair, Kings and Threes)
blistein: shows [Ks Jh] (a pair of Threes)
Margadon78 collected $21.65 from pot
*** SUMMARY ***
Total pot $22.79 | Rake $1.14
Board [3s As 4c 5d 3c]
Seat 1: Rakechaser folded before Flop (didn't bet)
Seat 2: Estevancvel folded before Flop
Seat 3: blistein (button) showed [Ks Jh] and lost with a pair of Threes
Seat 4: J4SunO (small blind) folded before Flop
Seat 5: Margadon78 (big blind) showed [Kc Kh] and won ($21.65) with two pair, Kings and Threes
Seat 6: ahs14789 folded before Flop (didn't bet)


PokerStars Hand #227640796756:  Hold'em No Limit ($0.25/$0.50 USD) - 2021/06/17 4:34:02 ET
Table 'Shane II' 6-max Seat #5 is the button
Seat 1: $iganov1 ($50 in chips)
Seat 3: Poringboy ($50 in chips)
Seat 4: Knappen-Ass ($50 in chips)
Seat 5: blistein ($50 in chips)
$iganov1: posts small blind $0.25
True GAMBIT: is sitting out
Weihnach joins the table at seat #6
Poringboy: posts big blind $0.50
*** HOLE CARDS ***
Knappen-Ass: calls $0.50
blistein: folds
$iganov1: calls $0.25
Poringboy: checks
*** FLOP *** [2s 8c 5c]
$iganov1: checks
Poringboy: checks
Knappen-Ass: checks
*** TURN *** [2s 8c 5c] [Ts]
$iganov1: checks
Poringboy: bets $1
Knappen-Ass: calls $1
$iganov1: folds
*** RIVER *** [2s 8c 5c Ts] [2c]
Poringboy: checks
Knappen-Ass: checks
*** SHOW DOWN ***
Poringboy: shows [Qs 4s] (a pair of Deuces)
Knappen-Ass: shows [As 3s] (a pair of Deuces - Ace kicker)
Knappen-Ass collected $3.32 from pot
*** SUMMARY ***
Total pot $3.50 | Rake $0.18
Board [2s 8c 5c Ts 2c]
Seat 1: $iganov1 (small blind) folded on the Turn
Seat 3: Poringboy (big blind) showed [Qs 4s] and lost with a pair of Deuces
Seat 4: Knappen-Ass showed [As 3s] and won ($3.32) with a pair of Deuces
Seat 5: blistein (button) folded before Flop (didn't bet)


PokerStars Hand #227640819660:  Hold'em No Limit ($0.25/$0.50 USD) - 2021/06/17 4:36:22 ET
Table 'Shane II' 6-max Seat #6 is the button
Seat 1: $iganov1 ($50 in chips)
Seat 2: True GAMBIT ($50 in chips)
Seat 3: Poringboy ($47.26 in chips)
Seat 4: Knappen-Ass ($54.93 in chips)
Seat 5: blistein ($50 in chips)
Seat 6: Weihnach ($50 in chips)
$iganov1: posts small blind $0.25
True GAMBIT: posts big blind $0.50
*** HOLE CARDS ***
Poringboy has timed out
Poringboy: folds
Knappen-Ass: folds
blistein: raises $0.75 to $1.25
Weihnach: folds
$iganov1: raises $4 to $5.25
True GAMBIT: folds
blistein: calls $4
*** FLOP *** [5d 4d 4s]
$iganov1: bets $5.23
blistein: calls $5.23
*** TURN *** [5d 4d 4s] [Qs]
$iganov1: checks
blistein: checks
*** RIVER *** [5d 4d 4s Qs] [Jh]
$iganov1: checks
blistein: checks
*** SHOW DOWN ***
$iganov1: shows [Qd Qh] (a full house, Queens full of Fours)
blistein: mucks hand
$iganov1 collected $20.39 from pot
*** SUMMARY ***
Total pot $21.46 | Rake $1.07
Board [5d 4d 4s Qs Jh]
Seat 1: $iganov1 (small blind) showed [Qd Qh] and won ($20.39) with a full house, Queens full of Fours
Seat 2: True GAMBIT (big blind) folded before Flop
Seat 3: Poringboy folded before Flop (didn't bet)
Seat 4: Knappen-Ass folded before Flop (didn't bet)
Seat 5: blistein mucked
Seat 6: Weihnach (button) folded before Flop (didn't bet)


PokerStars Hand #227640842199:  Hold'em No Limit ($0.25/$0.50 USD) - 2021/06/17 4:38:39 ET
Table 'Shane II' 6-max Seat #4 is the button
Seat 1: $iganov1 ($59.91 in chips)
Seat 2: True GAMBIT ($51.50 in chips)
Seat 3: Poringboy ($46.51 in chips)
Seat 4: Knappen-Ass ($54.93 in chips)
Seat 5: blistein ($50 in chips)
Seat 6: Weihnach ($50 in chips)
blistein: posts small blind $0.25
Weihnach: posts big blind $0.50
*** HOLE CARDS ***
$iganov1: folds
True GAMBIT: folds
Poringboy: raises $1 to $1.50
Knappen-Ass: calls $1.50
blistein: folds
Weihnach: folds
*** FLOP *** [7c Kd 2s]
Poringboy: bets $2
Knappen-Ass: calls $2
*** TURN *** [7c Kd 2s] [8c]
Poringboy: checks
Knappen-Ass: checks
*** RIVER *** [7c Kd 2s 8c] [7d]
Poringboy: checks
Knappen-Ass: checks
*** SHOW DOWN ***
Poringboy: shows [Ac Js] (a pair of Sevens)
Knappen-Ass: shows [9s Kh] (two pair, Kings and Sevens)
Knappen-Ass collected $7.36 from pot
*** SUMMARY ***
Total pot $7.75 | Rake $0.39
Board [7c Kd 2s 8c 7d]
Seat 1: $iganov1 folded before Flop (didn't bet)
Seat 2: True GAMBIT folded before Flop (didn't bet)
Seat 3: Poringboy showed [Ac Js] and lost with a pair of Sevens
Seat 4: Knappen-Ass (button) showed [9s Kh] and won ($7.36) with two pair, Kings and Sevens
Seat 5: blistein (small blind) folded before Flop
Seat 6: Weihnach (big blind) folded before Flop


PokerStars Hand #227640861081:  Hold'em No Limit ($0.25/$0.50 USD) - 2021/06/17 4:40:31 ET
Table 'Shane II' 6-max Seat #3 is the button
Seat 1: $iganov1 ($56.51 in chips)
Seat 2: True GAMBIT ($50.75 in chips)
Seat 3: Poringboy ($44.27 in chips)
Seat 4: Knappen-Ass ($59.25 in chips)
Seat 5: blistein ($52.25 in chips)
Seat 6: Weihnach ($50 in chips)
Knappen-Ass: posts small blind $0.25
blistein: posts big blind $0.50
*** HOLE CARDS ***
Weihnach: folds
$iganov1: folds
True GAMBIT: raises $0.75 to $1.25
Poringboy: calls $1.25
Knappen-Ass: calls $1
blistein: folds
*** FLOP *** [Jh 7s 3c]
Knappen-Ass: checks
True GAMBIT: bets $1.21
Poringboy: raises $2.29 to $3.50
Knappen-Ass: folds
True GAMBIT: calls $2.29
*** TURN *** [Jh 7s 3c] [5h]
True GAMBIT: checks
Poringboy: checks
*** RIVER *** [Jh 7s 3c 5h] [Qd]
True GAMBIT: checks
Poringboy: checks
*** SHOW DOWN ***
True GAMBIT: shows [Jc Td] (a pair of Jacks)
Poringboy: mucks hand
True GAMBIT collected $10.69 from pot
*** SUMMARY ***
Total pot $11.25 | Rake $0.56
Board [Jh 7s 3c 5h Qd]
Seat 1: $iganov1 folded before Flop (didn't bet)
Seat 2: True GAMBIT showed [Jc Td] and won ($10.69) with a pair of Jacks
Seat 3: Poringboy (button) mucked
Seat 4: Knappen-Ass (small blind) folded on the Flop
Seat 5: blistein (big blind) folded before Flop
Seat 6: Weihnach folded before Flop (didn't bet)


PokerStars Hand #227640870321:  Hold'em No Limit ($0.25/$0.50 USD) - 2021/06/17 4:41:25 ET
Table 'Shane II' 6-max Seat #5 is the button
Seat 1: $iganov1 ($56.51 in chips)
Seat 2: True GAMBIT ($56.69 in chips)
Seat 3: Poringboy ($40.27 in chips)
Seat 4: Knappen-Ass ($58 in chips)
Seat 5: blistein ($51.50 in chips)
Seat 6: Weihnach ($50 in chips)
Weihnach: posts small blind $0.25
$iganov1: posts big blind $0.50
*** HOLE CARDS ***
True GAMBIT: folds
Poringboy: folds
Knappen-Ass: calls $0.50
blistein: folds
Weihnach: folds
$iganov1: checks
*** FLOP *** [2c 5c 5d]
$iganov1: checks
Knappen-Ass: checks
*** TURN *** [2c 5c 5d] [9c]
$iganov1: checks
Knappen-Ass: checks
*** RIVER *** [2c 5c 5d 9c] [3s]
$iganov1: checks
Knappen-Ass: checks
*** SHOW DOWN ***
$iganov1: shows [4s Js] (a pair of Fives)
Knappen-Ass: shows [8h Ah] (a pair of Fives - Ace kicker)
Knappen-Ass collected $1.19 from pot
*** SUMMARY ***
Total pot $1.25 | Rake $0.06
Board [2c 5c 5d 9c 3s]
Seat 1: $iganov1 (big blind) showed [4s Js] and lost with a pair of Fives
Seat 2: True GAMBIT folded before Flop (didn't bet)
Seat 3: Poringboy folded before Flop (didn't bet)
Seat 4: Knappen-Ass showed [8h Ah] and won ($1.19) with a pair of Fives
Seat 5: blistein (button) folded before Flop (didn't bet)
Seat 6: Weihnach (small blind) folded before Flop


PokerStars Hand #227640894077:  Hold'em No Limit ($0.25/$0.50 USD) - 2021/06/17 4:43:43 ET
Table 'Shane II' 6-max Seat #4 is the button
Seat 1: $iganov1 ($54.67 in chips)
Seat 2: True GAMBIT ($54.94 in chips)
Seat 3: Poringboy ($40.46 in chips)
Seat 4: Knappen-Ass ($57.94 in chips)
Seat 5: blistein ($54.61 in chips)
Seat 6: Weihnach ($50 in chips)
blistein: posts small blind $0.25
Weihnach: posts big blind $0.50
*** HOLE CARDS ***
$iganov1: folds
True GAMBIT: folds
Poringboy: folds
Knappen-Ass: folds
blistein: raises $1 to $1.50
Weihnach: calls $1
*** FLOP *** [9c Qs Kd]
blistein: checks
Weihnach: checks
*** TURN *** [9c Qs Kd] [7s]
blistein: checks
Weihnach: checks
*** RIVER *** [9c Qs Kd 7s] [2c]
blistein: bets $1.91
Weihnach: calls $1.91
*** SHOW DOWN ***
blistein: shows [6s Ad] (high card Ace)
Weihnach: shows [Ts 9s] (a pair of Nines)
Weihnach collected $6.48 from pot
*** SUMMARY ***
Total pot $6.82 | Rake $0.34
Board [9c Qs Kd 7s 2c]
Seat 1: $iganov1 folded before Flop (didn't bet)
Seat 2: True GAMBIT folded before Flop (didn't bet)
Seat 3: Poringboy folded before Flop (didn't bet)
Seat 4: Knappen-Ass (button) folded before Flop (didn't bet)
Seat 5: blistein (small blind) showed [6s Ad] and lost with high card Ace
Seat 6: Weihnach (big blind) showed [Ts 9s] and won ($6.48) with a pair of Nines


PokerStars Hand #227640905729:  Hold'em No Limit ($0.25/$0.50 USD) - 2021/06/17 4:44:50 ET
Table 'Shane II' 6-max Seat #5 is the button
Seat 1: $iganov1 ($54.67 in chips)
Seat 2: True GAMBIT ($54.94 in chips)
Seat 3: Poringboy ($40.46 in chips)
Seat 4: Knappen-Ass ($57.94 in chips)
Seat 5: blistein ($51.20 in chips)
Seat 6: Weihnach ($53.07 in chips)
Weihnach: posts small blind $0.25
$iganov1: posts big blind $0.50
*** HOLE CARDS ***
True GAMBIT: raises $0.75 to $1.25
Poringboy: calls $1.25
Knappen-Ass: folds
blistein: folds
Weihnach: folds
$iganov1: folds
*** FLOP *** [7s Ks 7h]
True GAMBIT: bets $0.93
Poringboy: raises $2.57 to $3.50
True GAMBIT: calls $2.57
*** TURN *** [7s Ks 7h] [Jd]
True GAMBIT: checks
Poringboy: checks
*** RIVER *** [7s Ks 7h Jd] [4s]
True GAMBIT: checks
Poringboy: bets $3
True GAMBIT: calls $3
*** SHOW DOWN ***
Poringboy: shows [7c 6c] (three of a kind, Sevens)
True GAMBIT: shows [9s 8s] (a flush, King high)
True GAMBIT collected $15.44 from pot
*** SUMMARY ***
Total pot $16.25 | Rake $0.81
Board [7s Ks 7h Jd 4s]
Seat 1: $iganov1 (big blind) folded before Flop
Seat 2: True GAMBIT showed [9s 8s] and won ($15.44) with a flush, King high
Seat 3: Poringboy showed [7c 6c] and lost with three of a kind, Sevens
Seat 4: Knappen-Ass folded before Flop (didn't bet)
Seat 5: blistein (button) folded before Flop (didn't bet)
Seat 6: Weihnach (small blind) folded before Flop


PokerStars Hand #227640918574:  Hold'em No Limit ($0.25/$0.50 USD) - 2021/06/17 4:46:03 ET
Table 'Shane II' 6-max Seat #2 is the button
Seat 1: $iganov1 ($53.92 in chips)
Seat 2: True GAMBIT ($62.63 in chips)
Seat 4: Knappen-Ass ($58.19 in chips)
Seat 5: blistein ($51.20 in chips)
Seat 6: Weihnach ($52.82 in chips)
Knappen-Ass: posts small blind $0.25
blistein: posts big blind $0.50
*** HOLE CARDS ***
Weihnach: raises $0.75 to $1.25
$iganov1: folds
True GAMBIT: calls $1.25
Knappen-Ass: folds
Mr.Korotaev joins the table at seat #3
blistein: folds
*** FLOP *** [6s As 9d]
Weihnach: bets $0.93
True GAMBIT: calls $0.93
*** TURN *** [6s As 9d] [8d]
Weihnach: checks
True GAMBIT: bets $2.43
Weihnach: calls $2.43
*** RIVER *** [6s As 9d 8d] [Kd]
Weihnach: checks
True GAMBIT: checks
*** SHOW DOWN ***
Weihnach: shows [Qh Qs] (a pair of Queens)
True GAMBIT: shows [8h 8c] (three of a kind, Eights)
True GAMBIT collected $9.47 from pot
*** SUMMARY ***
Total pot $9.97 | Rake $0.50
Board [6s As 9d 8d Kd]
Seat 1: $iganov1 folded before Flop (didn't bet)
Seat 2: True GAMBIT (button) showed [8h 8c] and won ($9.47) with three of a kind, Eights
Seat 4: Knappen-Ass (small blind) folded before Flop
Seat 5: blistein (big blind) folded before Flop
Seat 6: Weihnach showed [Qh Qs] and lost with a pair of Queens


PokerStars Hand #227640944671:  Hold'em No Limit ($0.25/$0.50 USD) - 2021/06/17 4:48:32 ET
Table 'Shane II' 6-max Seat #2 is the button
Seat 1: $iganov1 ($54.42 in chips)
Seat 2: True GAMBIT ($71.83 in chips)
Seat 3: Mr.Korotaev ($50 in chips)
Seat 4: Knappen-Ass ($56.19 in chips)
Seat 5: blistein ($50 in chips)
Seat 6: Weihnach ($51.35 in chips)
Mr.Korotaev: posts small blind $0.25
Knappen-Ass: posts big blind $0.50
*** HOLE CARDS ***
blistein: folds
Weihnach: folds
$iganov1: folds
True GAMBIT: raises $0.75 to $1.25
Mr.Korotaev: folds
Knappen-Ass: calls $0.75
*** FLOP *** [7c 5c Js]
Knappen-Ass: checks
True GAMBIT: bets $0.78
Knappen-Ass: calls $0.78
*** TURN *** [7c 5c Js] [Qd]
Knappen-Ass: checks
True GAMBIT: checks
*** RIVER *** [7c 5c Js Qd] [Th]
Knappen-Ass: checks
True GAMBIT: checks
*** SHOW DOWN ***
Knappen-Ass: shows [9h Ac] (high card Ace)
True GAMBIT: mucks hand
Knappen-Ass collected $4.09 from pot
*** SUMMARY ***
Total pot $4.31 | Rake $0.22
Board [7c 5c Js Qd Th]
Seat 1: $iganov1 folded before Flop (didn't bet)
Seat 2: True GAMBIT (button) mucked
Seat 3: Mr.Korotaev (small blind) folded before Flop
Seat 4: Knappen-Ass (big blind) showed [9h Ac] and won ($4.09) with high card Ace
Seat 5: blistein folded before Flop (didn't bet)
Seat 6: Weihnach folded before Flop (didn't bet)


PokerStars Hand #227640956013:  Hold'em No Limit ($0.25/$0.50 USD) - 2021/06/17 4:49:35 ET
Table 'Shane II' 6-max Seat #4 is the button
Seat 1: $iganov1 ($54.42 in chips)
Seat 2: True GAMBIT ($70.55 in chips)
Seat 3: Mr.Korotaev ($50 in chips)
Seat 4: Knappen-Ass ($58 in chips)
Seat 5: blistein ($50 in chips)
Seat 6: Weihnach ($51.35 in chips)
blistein: posts small blind $0.25
Weihnach: posts big blind $0.50
*** HOLE CARDS ***
$iganov1: folds
True GAMBIT: folds
Mr.Korotaev: raises $1 to $1.50
Knappen-Ass: folds
blistein: folds
Weihnach: calls $1
*** FLOP *** [Ks 3c 8d]
Weihnach: checks
Mr.Korotaev: checks
*** TURN *** [Ks 3c 8d] [2d]
Weihnach: checks
Mr.Korotaev: bets $1.55
Weihnach: calls $1.55
*** RIVER *** [Ks 3c 8d 2d] [9h]
Weihnach: checks
Mr.Korotaev: checks
*** SHOW DOWN ***
Weihnach: shows [Ah Ts] (high card Ace)
Mr.Korotaev: shows [4c 4h] (a pair of Fours)
Mr.Korotaev collected $6.03 from pot
*** SUMMARY ***
Total pot $6.35 | Rake $0.32
Board [Ks 3c 8d 2d 9h]
Seat 1: $iganov1 folded before Flop (didn't bet)
Seat 2: True GAMBIT folded before Flop (didn't bet)
Seat 3: Mr.Korotaev showed [4c 4h] and won ($6.03) with a pair of Fours
Seat 4: Knappen-Ass (button) folded before Flop (didn't bet)
Seat 5: blistein (small blind) folded before Flop
Seat 6: Weihnach (big blind) showed [Ah Ts] and lost with high card Ace


PokerStars Hand #227640972145:  Hold'em No Limit ($0.25/$0.50 USD) - 2021/06/17 4:51:07 ET
Table 'Shane II' 6-max Seat #6 is the button
Seat 1: $iganov1 ($53.92 in chips)
Seat 2: True GAMBIT ($66.91 in chips)
Seat 3: Mr.Korotaev ($52.98 in chips)
Seat 4: Knappen-Ass ($61.99 in chips)
Seat 5: blistein ($50 in chips)
Seat 6: Weihnach ($50 in chips)
$iganov1: posts small blind $0.25
True GAMBIT: posts big blind $0.50
*** HOLE CARDS ***
Mr.Korotaev: folds
Knappen-Ass: folds
blistein: folds
Weihnach: folds
$iganov1: raises $1 to $1.50
True GAMBIT: calls $1
*** FLOP *** [Ac 7s Jd]
$iganov1: bets $1
True GAMBIT: calls $1
*** TURN *** [Ac 7s Jd] [Qd]
$iganov1: checks
True GAMBIT: checks
*** RIVER *** [Ac 7s Jd Qd] [5d]
$iganov1: bets $3.33
True GAMBIT: calls $3.33
*** SHOW DOWN ***
$iganov1: shows [Qs Qc] (three of a kind, Queens)
True GAMBIT: mucks hand
$iganov1 collected $11.08 from pot
*** SUMMARY ***
Total pot $11.66 | Rake $0.58
Board [Ac 7s Jd Qd 5d]
Seat 1: $iganov1 (small blind) showed [Qs Qc] and won ($11.08) with three of a kind, Queens
Seat 2: True GAMBIT (big blind) mucked
Seat 3: Mr.Korotaev folded before Flop (didn't bet)
Seat 4: Knappen-Ass folded before Flop (didn't bet)
Seat 5: blistein folded before Flop (didn't bet)
Seat 6: Weihnach (button) folded before Flop (didn't bet)


PokerStars Hand #227641015533:  Hold'em No Limit ($0.25/$0.50 USD) - 2021/06/17 4:55:16 ET
Table 'Shane II' 6-max Seat #1 is the button
Seat 1: $iganov1 ($62.53 in chips)
Seat 2: True GAMBIT ($59.44 in chips)
Seat 3: Mr.Korotaev ($61.44 in chips)
Seat 4: Knappen-Ass ($50.86 in chips)
Seat 5: blistein ($50 in chips)
Seat 6: Weihnach ($50 in chips)
True GAMBIT: posts small blind $0.25
Mr.Korotaev: posts big blind $0.50
*** HOLE CARDS ***
Knappen-Ass: calls $0.50
blistein: folds
Weihnach: folds
$iganov1: raises $1.25 to $1.75
True GAMBIT: folds
Mr.Korotaev: folds
Knappen-Ass: calls $1.25
*** FLOP *** [4s 6c Ks]
Knappen-Ass: checks
$iganov1: bets $2.02
Knappen-Ass: calls $2.02
*** TURN *** [4s 6c Ks] [Jd]
Knappen-Ass: checks
$iganov1: bets $3.94
Knappen-Ass: calls $3.94
*** RIVER *** [4s 6c Ks Jd] [4c]
Knappen-Ass: checks
$iganov1: checks
*** SHOW DOWN ***
Knappen-Ass: shows [Js 9h] (two pair, Jacks and Fours)
$iganov1: mucks hand
Knappen-Ass collected $15.36 from pot
*** SUMMARY ***
Total pot $16.17 | Rake $0.81
Board [4s 6c Ks Jd 4c]
Seat 1: $iganov1 (button) mucked
Seat 2: True GAMBIT (small blind) folded before Flop
Seat 3: Mr.Korotaev (big blind) folded before Flop
Seat 4: Knappen-Ass showed [Js 9h] and won ($15.36) with two pair, Jacks and Fours
Seat 5: blistein folded before Flop (didn't bet)
Seat 6: Weihnach folded before Flop (didn't bet)


PokerStars Hand #227641030690:  Hold'em No Limit ($0.25/$0.50 USD) - 2021/06/17 4:56:59 ET
Table 'Shane II' 6-max Seat #4 is the button
Seat 1: $iganov1 ($54.82 in chips)
Seat 2: True GAMBIT ($59.94 in chips)
Seat 3: Mr.Korotaev ($60.69 in chips)
Seat 4: Knappen-Ass ($53.90 in chips)
Seat 5: blistein ($50 in chips)
Seat 6: Weihnach ($54.16 in chips)
blistein: posts small blind $0.25
Weihnach: posts big blind $0.50
*** HOLE CARDS ***
$iganov1: folds
True GAMBIT: raises $0.75 to $1.25
Mr.Korotaev: folds
Knappen-Ass: folds
blistein: folds
Weihnach: calls $0.75
*** FLOP *** [7h 8s Ac]
Weihnach: checks
True GAMBIT: checks
*** TURN *** [7h 8s Ac] [4c]
Weihnach: bets $1.25
True GAMBIT: calls $1.25
*** RIVER *** [7h 8s Ac 4c] [Js]
Weihnach: bets $3.49
True GAMBIT: calls $3.49
*** SHOW DOWN ***
Weihnach: shows [9d Td] (a straight, Seven to Jack)
True GAMBIT: mucks hand
Weihnach collected $11.62 from pot
*** SUMMARY ***
Total pot $12.23 | Rake $0.61
Board [7h 8s Ac 4c Js]
Seat 1: $iganov1 folded before Flop (didn't bet)
Seat 2: True GAMBIT mucked
Seat 3: Mr.Korotaev folded before Flop (didn't bet)
Seat 4: Knappen-Ass (button) folded before Flop (didn't bet)
Seat 5: blistein (small blind) folded before Flop
Seat 6: Weihnach (big blind) showed [9d Td] and won ($11.62) with a straight, Seven to Jack


PokerStars Hand #227641037708:  Hold'em No Limit ($0.25/$0.50 USD) - 2021/06/17 4:57:46 ET
Table 'Shane II' 6-max Seat #5 is the button
Seat 1: $iganov1 ($54.82 in chips)
Seat 2: True GAMBIT ($53.95 in chips)
Seat 3: Mr.Korotaev ($60.69 in chips)
Seat 4: Knappen-Ass ($53.90 in chips)
Seat 5: blistein ($50 in chips)
Seat 6: Weihnach ($59.79 in chips)
Weihnach: posts small blind $0.25
$iganov1: posts big blind $0.50
*** HOLE CARDS ***
True GAMBIT: folds
Mr.Korotaev: raises $1 to $1.50
Knappen-Ass: calls $1.50
blistein: folds
Weihnach: folds
$iganov1: calls $1
*** FLOP *** [As 2c Qh]
$iganov1: checks
Mr.Korotaev: bets $1.49
Knappen-Ass: calls $1.49
$iganov1: calls $1.49
*** TURN *** [As 2c Qh] [3c]
$iganov1: checks
Mr.Korotaev: checks
Knappen-Ass: checks
*** RIVER *** [As 2c Qh 3c] [Kh]
$iganov1: checks
Mr.Korotaev: checks
Knappen-Ass: checks
*** SHOW DOWN ***
$iganov1: shows [Ks Jd] (a pair of Kings)
Mr.Korotaev: mucks hand
Knappen-Ass: shows [Ah 5h] (a pair of Aces)
Knappen-Ass collected $8.76 from pot
*** SUMMARY ***
Total pot $9.22 | Rake $0.46
Board [As 2c Qh 3c Kh]
Seat 1: $iganov1 (big blind) showed [Ks Jd] and lost with a pair of Kings
Seat 2: True GAMBIT folded before Flop (didn't bet)
Seat 3: Mr.Korotaev mucked
Seat 4: Knappen-Ass showed [Ah 5h] and won ($8.76) with a pair of Aces
Seat 5: blistein (button) folded before Flop (didn't bet)
Seat 6: Weihnach (small blind) folded before Flop


PokerStars Hand #227641092637:  Hold'em No Limit ($0.25/$0.50 USD) - 2021/06/17 5:03:25 ET
Table 'Shane II' 6-max Seat #5 is the button
Seat 1: $iganov1 ($53.93 in chips)
Seat 2: True GAMBIT ($50.95 in chips)
Seat 3: Mr.Korotaev ($55.23 in chips)
Seat 4: Knappen-Ass ($59.53 in chips)
Seat 5: blistein ($50.40 in chips)
Seat 6: Weihnach ($62.29 in chips)
Weihnach: posts small blind $0.25
$iganov1: posts big blind $0.50
*** HOLE CARDS ***
True GAMBIT: folds
Mr.Korotaev: folds
Knappen-Ass: calls $0.50
blistein: folds
Weihnach: folds
$iganov1: checks
*** FLOP *** [7h 8h Jh]
$iganov1: checks
Knappen-Ass: bets $1.19
$iganov1: calls $1.19
*** TURN *** [7h 8h Jh] [7s]
$iganov1: checks
Knappen-Ass: bets $3.45
$iganov1: calls $3.45
*** RIVER *** [7h 8h Jh 7s] [5s]
$iganov1: checks
Knappen-Ass: checks
*** SHOW DOWN ***
$iganov1: shows [5h Th] (a flush, Jack high)
Knappen-Ass: mucks hand
$iganov1 collected $10 from pot
*** SUMMARY ***
Total pot $10.53 | Rake $0.53
Board [7h 8h Jh 7s 5s]
Seat 1: $iganov1 (big blind) showed [5h Th] and won ($10) with a flush, Jack high
Seat 2: True GAMBIT folded before Flop (didn't bet)
Seat 3: Mr.Korotaev folded before Flop (didn't bet)
Seat 4: Knappen-Ass mucked
Seat 5: blistein (button) folded before Flop (didn't bet)
Seat 6: Weihnach (small blind) folded before Flop


PokerStars Hand #227641145999:  Hold'em No Limit ($0.25/$0.50 USD) - 2021/06/17 5:08:26 ET
Table 'Shane II' 6-max Seat #3 is the button
Seat 1: $iganov1 ($56.59 in chips)
Seat 2: True GAMBIT ($50.95 in chips)
Seat 3: Mr.Korotaev ($51.72 in chips)
Seat 4: Knappen-Ass ($54.25 in chips)
Seat 5: blistein ($50 in chips)
Seat 6: Weihnach ($69.67 in chips)
Knappen-Ass: posts small blind $0.25
blistein: posts big blind $0.50
*** HOLE CARDS ***
Weihnach: folds
$iganov1: folds
True GAMBIT: folds
Mr.Korotaev: raises $0.75 to $1.25
Knappen-Ass: folds
blistein: calls $0.75
*** FLOP *** [8s 9c 4s]
blistein: checks
Mr.Korotaev: checks
*** TURN *** [8s 9c 4s] [7c]
blistein: checks
Mr.Korotaev: bets $1.31
blistein: raises $3.94 to $5.25
Mr.Korotaev: calls $3.94
*** RIVER *** [8s 9c 4s 7c] [Kc]
blistein: checks
Mr.Korotaev: checks
*** SHOW DOWN ***
blistein: shows [Kh Ts] (a pair of Kings)
Mr.Korotaev: mucks hand
blistein collected $12.59 from pot
*** SUMMARY ***
Total pot $13.25 | Rake $0.66
Board [8s 9c 4s 7c Kc]
Seat 1: $iganov1 folded before Flop (didn't bet)
Seat 2: True GAMBIT folded before Flop (didn't bet)
Seat 3: Mr.Korotaev (button) mucked
Seat 4: Knappen-Ass (small blind) folded before Flop
Seat 5: blistein (big blind) showed [Kh Ts] and won ($12.59) with a pair of Kings
Seat 6: Weihnach folded before Flop (didn't bet)


PokerStars Hand #227641214157:  Hold'em No Limit ($0.25/$0.50 USD) - 2021/06/17 5:14:48 ET
Table 'Shane II' 6-max Seat #5 is the button
Seat 1: $iganov1 ($56.36 in chips)
Seat 2: True GAMBIT ($50 in chips)
Seat 3: Mr.Korotaev ($59.44 in chips)
Seat 5: blistein ($50 in chips)
Seat 6: Weihnach ($68.67 in chips)
Weihnach: posts small blind $0.25
$iganov1: posts big blind $0.50
*** HOLE CARDS ***
True GAMBIT: folds
Mr.Korotaev: raises $1 to $1.50
blistein: folds
Weihnach: calls $1.25
$iganov1: calls $1
*** FLOP *** [8c Qd 5s]
Weihnach: checks
$iganov1: checks
Mr.Korotaev: checks
*** TURN *** [8c Qd 5s] [Kc]
Weihnach: bets $2.14
$iganov1: folds
Mr.Korotaev: calls $2.14
*** RIVER *** [8c Qd 5s Kc] [Jh]
Weihnach: bets $5.84
ss4500 joins the table at seat #4
Mr.Korotaev: raises $15.02 to $20.86
Weihnach: calls $15.02
*** SHOW DOWN ***
Mr.Korotaev: shows [Ac Th] (a straight, Ten to Ace)
Weihnach: mucks hand
Mr.Korotaev collected $48.50 from pot
*** SUMMARY ***
Total pot $50.50 | Rake $2
Board [8c Qd 5s Kc Jh]
Seat 1: $iganov1 (big blind) folded on the Turn
Seat 2: True GAMBIT folded before Flop (didn't bet)
Seat 3: Mr.Korotaev showed [Ac Th] and won ($48.50) with a straight, Ten to Ace
Seat 5: blistein (button) folded before Flop (didn't bet)
Seat 6: Weihnach (small blind) mucked


PokerStars Hand #232256145006:  Hold'em No Limit ($0.25/$0.50 USD) - 2021/12/16 2:00:41 ET
Table 'Seraphina II' 6-max Seat #6 is the button
Seat 1: SeEevg ($56.44 in chips)
Seat 2: goldmel ($55.61 in chips)
Seat 3: bobo12315 ($36.11 in chips)
Seat 4: blistein ($52.94 in chips)
Seat 5: nonentitly ($50.75 in chips)
Seat 6: Gerafont ($50 in chips)
SeEevg: posts small blind $0.25
goldmel: posts big blind $0.50
*** HOLE CARDS ***
bobo12315: folds
blistein: folds
nonentitly: folds
Gerafont: raises $0.75 to $1.25
SeEevg: folds
goldmel: calls $0.75
*** FLOP *** [Qs 8c Kd]
goldmel: checks
Gerafont: checks
*** TURN *** [Qs 8c Kd] [2s]
goldmel: checks
Gerafont: checks
*** RIVER *** [Qs 8c Kd 2s] [4c]
goldmel: checks
Gerafont: checks
*** SHOW DOWN ***
goldmel: shows [7h 9h] (high card King)
Gerafont: shows [Ac 3c] (high card Ace)
Gerafont collected $2.61 from pot
*** SUMMARY ***
Total pot $2.75 | Rake $0.14
Board [Qs 8c Kd 2s 4c]
Seat 1: SeEevg (small blind) folded before Flop
Seat 2: goldmel (big blind) showed [7h 9h] and lost with high card King
Seat 3: bobo12315 folded before Flop (didn't bet)
Seat 4: blistein folded before Flop (didn't bet)
Seat 5: nonentitly folded before Flop (didn't bet)
Seat 6: Gerafont (button) showed [Ac 3c] and won ($2.61) with high card Ace


PokerStars Hand #232256189883:  Hold'em No Limit ($0.25/$0.50 USD) - 2021/12/16 2:06:10 ET
Table 'Seraphina II' 6-max Seat #1 is the button
Seat 1: SeEevg ($61.53 in chips)
Seat 2: goldmel ($50.25 in chips)
Seat 3: bobo12315 ($37.20 in chips)
Seat 4: blistein ($52.19 in chips)
Seat 5: nonentitly ($50.75 in chips)
Seat 6: Gerafont ($50.61 in chips)
goldmel: posts small blind $0.25
bobo12315: posts big blind $0.50
*** HOLE CARDS ***
blistein: raises $0.65 to $1.15
nonentitly: folds
Gerafont: folds
SeEevg: folds
goldmel: calls $0.90
bobo12315: calls $0.65
*** FLOP *** [4h 4c As]
goldmel: checks
bobo12315: checks
blistein: checks
*** TURN *** [4h 4c As] [Kh]
goldmel: checks
bobo12315: checks
blistein: checks
*** RIVER *** [4h 4c As Kh] [6s]
goldmel: checks
bobo12315: checks
blistein: checks
*** SHOW DOWN ***
goldmel: shows [Ts Ks] (two pair, Kings and Fours)
bobo12315: shows [3s Ah] (two pair, Aces and Fours)
blistein: mucks hand
bobo12315 collected $3.28 from pot
*** SUMMARY ***
Total pot $3.45 | Rake $0.17
Board [4h 4c As Kh 6s]
Seat 1: SeEevg (button) folded before Flop (didn't bet)
Seat 2: goldmel (small blind) showed [Ts Ks] and lost with two pair, Kings and Fours
Seat 3: bobo12315 (big blind) showed [3s Ah] and won ($3.28) with two pair, Aces and Fours
Seat 4: blistein mucked
Seat 5: nonentitly folded before Flop (didn't bet)
Seat 6: Gerafont folded before Flop (didn't bet)


PokerStars Hand #232256211279:  Hold'em No Limit ($0.25/$0.50 USD) - 2021/12/16 2:08:43 ET
Table 'Seraphina II' 6-max Seat #1 is the button
Seat 1: SeEevg ($61.53 in chips)
Seat 2: goldmel ($50.25 in chips)
Seat 3: bobo12315 ($39.08 in chips)
Seat 4: blistein ($51.04 in chips)
Seat 5: nonentitly ($50 in chips)
Seat 6: Gerafont ($51.36 in chips)
goldmel: posts small blind $0.25
bobo12315: posts big blind $0.50
*** HOLE CARDS ***
blistein: folds
nonentitly: folds
Gerafont: folds
SeEevg: raises $0.75 to $1.25
goldmel: calls $1
bobo12315: calls $0.75
*** FLOP *** [9d Th 3h]
goldmel: bets $2.67
bobo12315: calls $2.67
SeEevg: calls $2.67
*** TURN *** [9d Th 3h] [7d]
goldmel: checks
bobo12315: checks
SeEevg: bets $8.38
goldmel: calls $8.38
bobo12315: calls $8.38
*** RIVER *** [9d Th 3h 7d] [6h]
goldmel: checks
bobo12315: checks
SeEevg: checks
*** SHOW DOWN ***
goldmel: shows [Jh Ts] (a pair of Tens)
bobo12315: shows [8d Tc] (a straight, Six to Ten)
SeEevg: shows [Jd 8h] (a straight, Seven to Jack)
SeEevg collected $35.06 from pot
*** SUMMARY ***
Total pot $36.90 | Rake $1.84
Board [9d Th 3h 7d 6h]
Seat 1: SeEevg (button) showed [Jd 8h] and won ($35.06) with a straight, Seven to Jack
Seat 2: goldmel (small blind) showed [Jh Ts] and lost with a pair of Tens
Seat 3: bobo12315 (big blind) showed [8d Tc] and lost with a straight, Six to Ten
Seat 4: blistein folded before Flop (didn't bet)
Seat 5: nonentitly folded before Flop (didn't bet)
Seat 6: Gerafont folded before Flop (didn't bet)


PokerStars Hand #232256235314:  Hold'em No Limit ($0.25/$0.50 USD) - 2021/12/16 2:11:38 ET
Table 'Seraphina II' 6-max Seat #5 is the button
Seat 2: goldmel ($50 in chips)
Seat 3: bobo12315 ($27.28 in chips)
Seat 4: blistein ($50.29 in chips)
Seat 5: nonentitly ($50 in chips)
Seat 6: Gerafont ($52.36 in chips)
Gerafont: posts small blind $0.25
SeEevg: is sitting out
goldmel: posts big blind $0.50
*** HOLE CARDS ***
SeEevg leaves the table
bobo12315: calls $0.50
ffs_shoked joins the table at seat #1
blistein: raises $1.25 to $1.75
nonentitly: folds
Gerafont: folds
goldmel: calls $1.25
bobo12315: raises $5.50 to $7.25
blistein: folds
goldmel: calls $5.50
*** FLOP *** [Td Qh 9s]
goldmel: checks
bobo12315: bets $15.68
goldmel: raises $15.68 to $31.36
bobo12315: calls $4.35 and is all-in
Uncalled bet ($11.33) returned to goldmel
*** TURN *** [Td Qh 9s] [4c]
*** RIVER *** [Td Qh 9s 4c] [6h]
*** SHOW DOWN ***
goldmel: shows [Qd Kd] (a pair of Queens)
bobo12315: shows [Jd 7d] (high card Queen)
goldmel collected $54.56 from pot
*** SUMMARY ***
Total pot $56.56 | Rake $2
Board [Td Qh 9s 4c 6h]
Seat 2: goldmel (big blind) showed [Qd Kd] and won ($54.56) with a pair of Queens
Seat 3: bobo12315 showed [Jd 7d] and lost with high card Queen
Seat 4: blistein folded before Flop
Seat 5: nonentitly (button) folded before Flop (didn't bet)
Seat 6: Gerafont (small blind) folded before Flop


PokerStars Hand #220488733918:  Hold'em No Limit ($0.25/$0.50 USD) - 2020/11/17 6:41:51 ET
Table 'Hermia II' 6-max Seat #6 is the button
Seat 1: Subbbota ($50 in chips)
Seat 2: gussg27 ($30.51 in chips)
Seat 3: BillyBonesss ($51.25 in chips)
Seat 4: summer150 ($35.14 in chips)
Seat 5: blistein ($50 in chips)
Seat 6: Popokluev ($53.78 in chips)
Subbbota: posts small blind $0.25
gussg27: posts big blind $0.50
*** HOLE CARDS ***
BillyBonesss: folds
summer150: folds
blistein: folds
Popokluev: raises $0.50 to $1
Subbbota: folds
gussg27: calls $0.50
*** FLOP *** [4h Ah 2d]
gussg27: checks
Popokluev: checks
*** TURN *** [4h Ah 2d] [Tc]
gussg27: checks
Popokluev: checks
*** RIVER *** [4h Ah 2d Tc] [5c]
gussg27: checks
Popokluev: checks
*** SHOW DOWN ***
gussg27: shows [8h 9s] (high card Ace)
Popokluev: shows [2c Kc] (a pair of Deuces)
Popokluev collected $2.14 from pot
*** SUMMARY ***
Total pot $2.25 | Rake $0.11
Board [4h Ah 2d Tc 5c]
Seat 1: Subbbota (small blind) folded before Flop
Seat 2: gussg27 (big blind) showed [8h 9s] and lost with high card Ace
Seat 3: BillyBonesss folded before Flop (didn't bet)
Seat 4: summer150 folded before Flop (didn't bet)
Seat 5: blistein folded before Flop (didn't bet)
Seat 6: Popokluev (button) showed [2c Kc] and won ($2.14) with a pair of Deuces


PokerStars Hand #220488866279:  Hold'em No Limit ($0.25/$0.50 USD) - 2020/11/17 6:49:13 ET
Table 'Hermia II' 6-max Seat #4 is the button
Seat 1: Subbbota ($59.13 in chips)
Seat 2: gussg27 ($43.44 in chips)
Seat 3: Godlike1379 ($50.75 in chips)
Seat 4: summer150 ($37.64 in chips)
Seat 5: blistein ($52.25 in chips)
Seat 6: Popokluev ($50.75 in chips)
blistein: posts small blind $0.25
Popokluev: posts big blind $0.50
*** HOLE CARDS ***
Subbbota: folds
gussg27: folds
Godlike1379: raises $0.74 to $1.24
summer150: calls $1.24
blistein: folds
Popokluev: folds
*** FLOP *** [Kc 6s Th]
Godlike1379: checks
summer150: bets $3
Godlike1379: calls $3
*** TURN *** [Kc 6s Th] [Qs]
Godlike1379: checks
summer150: checks
*** RIVER *** [Kc 6s Th Qs] [Ts]
Godlike1379: bets $7
summer150: calls $7
*** SHOW DOWN ***
Godlike1379: shows [Ks 4s] (a flush, King high)
summer150: mucks hand
Godlike1379 collected $22.07 from pot
*** SUMMARY ***
Total pot $23.23 | Rake $1.16
Board [Kc 6s Th Qs Ts]
Seat 1: Subbbota folded before Flop (didn't bet)
Seat 2: gussg27 folded before Flop (didn't bet)
Seat 3: Godlike1379 showed [Ks 4s] and won ($22.07) with a flush, King high
Seat 4: summer150 (button) mucked
Seat 5: blistein (small blind) folded before Flop
Seat 6: Popokluev (big blind) folded before Flop


PokerStars Hand #220489009580:  Hold'em No Limit ($0.25/$0.50 USD) - 2020/11/17 6:57:19 ET
Table 'Hermia II' 6-max Seat #6 is the button
Seat 3: crush6969 ($52.26 in chips)
Seat 4: summer150 ($17.75 in chips)
Seat 5: blistein ($50 in chips)
Seat 6: Popokluev ($55.50 in chips)
crush6969: posts small blind $0.25
summer150: posts big blind $0.50
*** HOLE CARDS ***
blistein: raises $1 to $1.50
Lethargiemen joins the table at seat #2
Popokluev: raises $3 to $4.50
crush6969: folds
summer150: calls $4
blistein: raises $45.50 to $50 and is all-in
Popokluev: calls $45.50
summer150: calls $13.25 and is all-in
*** FLOP *** [Ad 7h 7c]
*** TURN *** [Ad 7h 7c] [6s]
*** RIVER *** [Ad 7h 7c 6s] [2d]
*** SHOW DOWN ***
blistein: shows [Kh Ks] (two pair, Kings and Sevens)
Popokluev: shows [Kc Kd] (two pair, Kings and Sevens)
blistein collected $32.25 from side pot
Popokluev collected $32.25 from side pot
summer150: shows [Ts Js] (a pair of Sevens)
blistein collected $26.38 from main pot
Popokluev collected $26.37 from main pot
*** SUMMARY ***
Total pot $118 Main pot $52.75. Side pot $64.50. | Rake $0.75
Board [Ad 7h 7c 6s 2d]
Seat 3: crush6969 (small blind) folded before Flop
Seat 4: summer150 (big blind) showed [Ts Js] and lost with a pair of Sevens
Seat 5: blistein showed [Kh Ks] and won ($58.63) with two pair, Kings and Sevens
Seat 6: Popokluev (button) showed [Kc Kd] and won ($58.62) with two pair, Kings and Sevens


PokerStars Hand #220489031330:  Hold'em No Limit ($0.25/$0.50 USD) - 2020/11/17 6:58:39 ET
Table 'Hermia II' 6-max Seat #2 is the button
Seat 2: Lethargiemen ($48.75 in chips)
Seat 3: crush6969 ($48.76 in chips)
Seat 5: blistein ($58.38 in chips)
Seat 6: Popokluev ($68.43 in chips)
crush6969: posts small blind $0.25
blistein: posts big blind $0.50
Geconiel: sits out
*** HOLE CARDS ***
Popokluev: folds
Lethargiemen: raises $0.50 to $1
crush6969: calls $0.75
blistein: folds
*** FLOP *** [5s 5h 3c]
crush6969: checks
Lethargiemen: checks
*** TURN *** [5s 5h 3c] [Qd]
crush6969: checks
Lethargiemen: checks
*** RIVER *** [5s 5h 3c Qd] [6h]
crush6969: checks
Lethargiemen: checks
*** SHOW DOWN ***
crush6969: shows [Tc 9d] (a pair of Fives)
Lethargiemen: shows [7h Ac] (a pair of Fives - Ace kicker)
Lethargiemen collected $2.38 from pot
*** SUMMARY ***
Total pot $2.50 | Rake $0.12
Board [5s 5h 3c Qd 6h]
Seat 2: Lethargiemen (button) showed [7h Ac] and won ($2.38) with a pair of Fives
Seat 3: crush6969 (small blind) showed [Tc 9d] and lost with a pair of Fives
Seat 5: blistein (big blind) folded before Flop
Seat 6: Popokluev folded before Flop (didn't bet)


PokerStars Hand #220489087812:  Hold'em No Limit ($0.25/$0.50 USD) - 2020/11/17 7:01:59 ET
Table 'Hermia II' 6-max Seat #2 is the button
Seat 1: Geconiel ($51.38 in chips)
Seat 2: Lethargiemen ($47.13 in chips)
Seat 3: crush6969 ($52.52 in chips)
Seat 4: RikkStroken ($50 in chips)
Seat 5: blistein ($60.38 in chips)
Seat 6: Popokluev ($64.68 in chips)
crush6969: posts small blind $0.25
RikkStroken: posts big blind $0.50
*** HOLE CARDS ***
blistein: folds
Popokluev: raises $0.75 to $1.25
Geconiel: folds
Lethargiemen: folds
crush6969: calls $1
RikkStroken: folds
*** FLOP *** [9c Qh 7d]
crush6969: checks
Popokluev: bets $0.94
crush6969: calls $0.94
*** TURN *** [9c Qh 7d] [9h]
crush6969: checks
Popokluev: bets $3.71
crush6969: calls $3.71
*** RIVER *** [9c Qh 7d 9h] [Jh]
crush6969: bets $5.84
Popokluev: raises $18.69 to $24.53
crush6969: calls $18.69
*** SHOW DOWN ***
Popokluev: shows [7h Ah] (a flush, Ace high)
crush6969: mucks hand
Popokluev collected $59.36 from pot
*** SUMMARY ***
Total pot $61.36 | Rake $2
Board [9c Qh 7d 9h Jh]
Seat 1: Geconiel folded before Flop (didn't bet)
Seat 2: Lethargiemen (button) folded before Flop (didn't bet)
Seat 3: crush6969 (small blind) mucked
Seat 4: RikkStroken (big blind) folded before Flop
Seat 5: blistein folded before Flop (didn't bet)
Seat 6: Popokluev showed [7h Ah] and won ($59.36) with a flush, Ace high


PokerStars Hand #220489201140:  Hold'em No Limit ($0.25/$0.50 USD) - 2020/11/17 7:08:07 ET
Table 'Hermia II' 6-max Seat #4 is the button
Seat 1: Geconiel ($50 in chips)
Seat 2: Lethargiemen ($51.17 in chips)
Seat 3: crush6969 ($56.81 in chips)
Seat 4: RikkStroken ($46.75 in chips)
Seat 5: blistein ($59.95 in chips)
Seat 6: Popokluev ($72.75 in chips)
blistein: posts small blind $0.25
Popokluev: posts big blind $0.50
*** HOLE CARDS ***
Geconiel: folds
Lethargiemen: raises $0.50 to $1
crush6969: calls $1
RikkStroken: folds
blistein: folds
Popokluev: folds
*** FLOP *** [9h Ad Jh]
Lethargiemen: checks
crush6969: bets $1
Lethargiemen: calls $1
*** TURN *** [9h Ad Jh] [3h]
Lethargiemen: checks
crush6969: bets $1
Lethargiemen: calls $1
*** RIVER *** [9h Ad Jh 3h] [5c]
Lethargiemen: checks
crush6969: bets $0.50
Lethargiemen: raises $3.50 to $4
crush6969: calls $3.50
*** SHOW DOWN ***
Lethargiemen: shows [Jd Jc] (three of a kind, Jacks)
crush6969: mucks hand
Lethargiemen collected $14.01 from pot
*** SUMMARY ***
Total pot $14.75 | Rake $0.74
Board [9h Ad Jh 3h 5c]
Seat 1: Geconiel folded before Flop (didn't bet)
Seat 2: Lethargiemen showed [Jd Jc] and won ($14.01) with three of a kind, Jacks
Seat 3: crush6969 mucked
Seat 4: RikkStroken (button) folded before Flop (didn't bet)
Seat 5: blistein (small blind) folded before Flop
Seat 6: Popokluev (big blind) folded before Flop


PokerStars Hand #220489252613:  Hold'em No Limit ($0.25/$0.50 USD) - 2020/11/17 7:10:54 ET
Table 'Hermia II' 6-max Seat #1 is the button
Seat 1: Geconiel ($50 in chips)
Seat 2: Lethargiemen ($57.81 in chips)
Seat 3: crush6969 ($48.90 in chips)
Seat 4: RikkStroken ($49.71 in chips)
Seat 5: blistein ($59.70 in chips)
Seat 6: Popokluev ($72.75 in chips)
Lethargiemen: posts small blind $0.25
crush6969: posts big blind $0.50
*** HOLE CARDS ***
RikkStroken: folds
blistein: raises $1 to $1.50
Popokluev: folds
Geconiel: calls $1.50
Lethargiemen: folds
crush6969: calls $1
*** FLOP *** [As Qd Ad]
crush6969: checks
blistein: checks
Geconiel: checks
*** TURN *** [As Qd Ad] [Jc]
crush6969: bets $0.50
blistein: calls $0.50
Geconiel: calls $0.50
*** RIVER *** [As Qd Ad Jc] [Ts]
crush6969: checks
blistein: checks
Geconiel: checks
*** SHOW DOWN ***
crush6969: shows [7s 5h] (a pair of Aces)
blistein: shows [Td 9d] (two pair, Aces and Tens)
Geconiel: mucks hand
blistein collected $5.94 from pot
*** SUMMARY ***
Total pot $6.25 | Rake $0.31
Board [As Qd Ad Jc Ts]
Seat 1: Geconiel (button) mucked
Seat 2: Lethargiemen (small blind) folded before Flop
Seat 3: crush6969 (big blind) showed [7s 5h] and lost with a pair of Aces
Seat 4: RikkStroken folded before Flop (didn't bet)
Seat 5: blistein showed [Td 9d] and won ($5.94) with two pair, Aces and Tens
Seat 6: Popokluev folded before Flop (didn't bet)


PokerStars Hand #220489289717:  Hold'em No Limit ($0.25/$0.50 USD) - 2020/11/17 7:12:53 ET
Table 'Hermia II' 6-max Seat #1 is the button
Seat 1: Geconiel ($50 in chips)
Seat 2: Lethargiemen ($56.06 in chips)
Seat 3: crush6969 ($47.10 in chips)
Seat 4: RikkStroken ($48.96 in chips)
Seat 5: blistein ($66.39 in chips)
Seat 6: Popokluev ($72 in chips)
Lethargiemen: posts small blind $0.25
crush6969: posts big blind $0.50
*** HOLE CARDS ***
RikkStroken: folds
blistein: raises $1 to $1.50
Popokluev: folds
Geconiel: folds
Lethargiemen: folds
crush6969: calls $1
*** FLOP *** [Js 7d 6s]
crush6969: checks
blistein: bets $2.50
crush6969: calls $2.50
*** TURN *** [Js 7d 6s] [4s]
crush6969: checks
blistein: bets $5.25
crush6969: calls $5.25
*** RIVER *** [Js 7d 6s 4s] [6d]
crush6969: checks
blistein: bets $6.23
crush6969: calls $6.23
*** SHOW DOWN ***
blistein: shows [Ah Jd] (two pair, Jacks and Sixes)
crush6969: shows [Ad Jh] (two pair, Jacks and Sixes)
crush6969 collected $14.83 from pot
blistein collected $14.82 from pot
*** SUMMARY ***
Total pot $31.21 | Rake $1.56
Board [Js 7d 6s 4s 6d]
Seat 1: Geconiel (button) folded before Flop (didn't bet)
Seat 2: Lethargiemen (small blind) folded before Flop
Seat 3: crush6969 (big blind) showed [Ad Jh] and won ($14.83) with two pair, Jacks and Sixes
Seat 4: RikkStroken folded before Flop (didn't bet)
Seat 5: blistein showed [Ah Jd] and won ($14.82) with two pair, Jacks and Sixes
Seat 6: Popokluev folded before Flop (didn't bet)


PokerStars Hand #220489483432:  Hold'em No Limit ($0.25/$0.50 USD) - 2020/11/17 7:23:06 ET
Table 'Hermia II' 6-max Seat #4 is the button
Seat 1: Geconiel ($50.57 in chips)
Seat 3: crush6969 ($62.18 in chips)
Seat 4: RikkStroken ($45.47 in chips)
Seat 5: blistein ($64.18 in chips)
Seat 6: Popokluev ($78.49 in chips)
blistein: posts small blind $0.25
Popokluev: posts big blind $0.50
Sh1t Fold: sits out
*** HOLE CARDS ***
Geconiel: folds
crush6969: raises $1 to $1.50
RikkStroken: raises $3 to $4.50
blistein: folds
Popokluev: folds
crush6969: calls $3
*** FLOP *** [Td Jh 8c]
crush6969: bets $1
RikkStroken: calls $1
*** TURN *** [Td Jh 8c] [Kh]
crush6969: bets $2
RikkStroken: calls $2
*** RIVER *** [Td Jh 8c Kh] [2h]
crush6969: checks
RikkStroken: bets $7.78
crush6969: raises $15.26 to $23.04
RikkStroken: calls $15.26
*** SHOW DOWN ***
crush6969: shows [5h Th] (a flush, King high)
RikkStroken: mucks hand
crush6969 collected $59.83 from pot
*** SUMMARY ***
Total pot $61.83 | Rake $2
Board [Td Jh 8c Kh 2h]
Seat 1: Geconiel folded before Flop (didn't bet)
Seat 3: crush6969 showed [5h Th] and won ($59.83) with a flush, King high
Seat 4: RikkStroken (button) mucked
Seat 5: blistein (small blind) folded before Flop
Seat 6: Popokluev (big blind) folded before Flop


PokerStars Hand #220489516525:  Hold'em No Limit ($0.25/$0.50 USD) - 2020/11/17 7:24:50 ET
Table 'Hermia II' 6-max Seat #6 is the button
Seat 1: Geconiel ($50.07 in chips)
Seat 2: Sh1t Fold ($29.87 in chips)
Seat 3: crush6969 ($92.22 in chips)
Seat 4: RikkStroken ($50 in chips)
Seat 5: blistein ($63.93 in chips)
Seat 6: Popokluev ($77.74 in chips)
Geconiel: posts small blind $0.25
Sh1t Fold: posts big blind $0.50
*** HOLE CARDS ***
crush6969: raises $1 to $1.50
RikkStroken: folds
blistein: folds
Popokluev: calls $1.50
Geconiel: folds
Sh1t Fold: folds
*** FLOP *** [Ad Tc 3s]
crush6969: bets $1
Popokluev: calls $1
*** TURN *** [Ad Tc 3s] [4c]
crush6969: checks
Popokluev: checks
*** RIVER *** [Ad Tc 3s 4c] [2d]
crush6969: checks
Popokluev: checks
*** SHOW DOWN ***
crush6969: shows [8h 6h] (high card Ace)
Popokluev: shows [Ts Jh] (a pair of Tens)
Popokluev collected $5.46 from pot
*** SUMMARY ***
Total pot $5.75 | Rake $0.29
Board [Ad Tc 3s 4c 2d]
Seat 1: Geconiel (small blind) folded before Flop
Seat 2: Sh1t Fold (big blind) folded before Flop
Seat 3: crush6969 showed [8h 6h] and lost with high card Ace
Seat 4: RikkStroken folded before Flop (didn't bet)
Seat 5: blistein folded before Flop (didn't bet)
Seat 6: Popokluev (button) showed [Ts Jh] and won ($5.46) with a pair of Tens


PokerStars Hand #220489547811:  Hold'em No Limit ($0.25/$0.50 USD) - 2020/11/17 7:26:27 ET
Table 'Hermia II' 6-max Seat #3 is the button
Seat 1: Geconiel ($50 in chips)
Seat 2: Sh1t Fold ($29.12 in chips)
Seat 3: crush6969 ($95.26 in chips)
Seat 4: RikkStroken ($49.50 in chips)
Seat 5: blistein ($60.93 in chips)
Seat 6: Popokluev ($81.45 in chips)
RikkStroken: posts small blind $0.25
blistein: posts big blind $0.50
*** HOLE CARDS ***
Popokluev: folds
Geconiel: raises $0.63 to $1.13
Sh1t Fold: folds
crush6969: calls $1.13
RikkStroken: folds
blistein: folds
*** FLOP *** [5h 8c Jc]
Geconiel: checks
crush6969: checks
*** TURN *** [5h 8c Jc] [Ks]
Geconiel: checks
crush6969: checks
*** RIVER *** [5h 8c Jc Ks] [3c]
Geconiel: checks
crush6969: checks
*** SHOW DOWN ***
Geconiel: shows [3h Ah] (a pair of Threes)
crush6969: mucks hand
Geconiel collected $2.86 from pot
*** SUMMARY ***
Total pot $3.01 | Rake $0.15
Board [5h 8c Jc Ks 3c]
Seat 1: Geconiel showed [3h Ah] and won ($2.86) with a pair of Threes
Seat 2: Sh1t Fold folded before Flop (didn't bet)
Seat 3: crush6969 (button) mucked
Seat 4: RikkStroken (small blind) folded before Flop
Seat 5: blistein (big blind) folded before Flop
Seat 6: Popokluev folded before Flop (didn't bet)


PokerStars Hand #220489599044:  Hold'em No Limit ($0.25/$0.50 USD) - 2020/11/17 7:29:08 ET
Table 'Hermia II' 6-max Seat #4 is the button
Seat 1: Geconiel ($50.98 in chips)
Seat 3: crush6969 ($106.03 in chips)
Seat 4: RikkStroken ($50 in chips)
Seat 5: blistein ($59.68 in chips)
Seat 6: Popokluev ($73.38 in chips)
blistein: posts small blind $0.25
Popokluev: posts big blind $0.50
Jasiuo3: sits out
*** HOLE CARDS ***
Geconiel: folds
crush6969: raises $1 to $1.50
RikkStroken: folds
blistein: folds
Popokluev: calls $1
*** FLOP *** [Kd 9h Th]
Jasiuo3 leaves the table
Popokluev: checks
crush6969: bets $1.50
Popokluev: calls $1.50
*** TURN *** [Kd 9h Th] [8d]
Popokluev: checks
crush6969: bets $2.50
Popokluev: calls $2.50
*** RIVER *** [Kd 9h Th 8d] [As]
Popokluev: checks
crush6969: checks
*** SHOW DOWN ***
Popokluev: shows [9d Qd] (a pair of Nines)
crush6969: shows [Jd Ts] (a pair of Tens)
crush6969 collected $10.69 from pot
*** SUMMARY ***
Total pot $11.25 | Rake $0.56
Board [Kd 9h Th 8d As]
Seat 1: Geconiel folded before Flop (didn't bet)
Seat 3: crush6969 showed [Jd Ts] and won ($10.69) with a pair of Tens
Seat 4: RikkStroken (button) folded before Flop (didn't bet)
Seat 5: blistein (small blind) folded before Flop
Seat 6: Popokluev (big blind) showed [9d Qd] and lost with a pair of Nines


PokerStars Hand #220489611365:  Hold'em No Limit ($0.25/$0.50 USD) - 2020/11/17 7:29:46 ET
Table 'Hermia II' 6-max Seat #6 is the button
Seat 1: Geconiel ($50.48 in chips)
Seat 2: amsterdamzuid ($35.50 in chips)
Seat 3: crush6969 ($111.97 in chips)
Seat 4: RikkStroken ($50 in chips)
Seat 5: blistein ($59.43 in chips)
Seat 6: Popokluev ($67.63 in chips)
Geconiel: posts small blind $0.25
amsterdamzuid: posts big blind $0.50
*** HOLE CARDS ***
crush6969: folds
RikkStroken: folds
blistein: raises $0.75 to $1.25
Popokluev: folds
Geconiel: calls $1
amsterdamzuid: calls $0.75
*** FLOP *** [8d Jc 5d]
Geconiel: checks
amsterdamzuid: checks
blistein: bets $1.25
Geconiel: calls $1.25
amsterdamzuid: folds
*** TURN *** [8d Jc 5d] [9d]
Geconiel: checks
blistein: checks
*** RIVER *** [8d Jc 5d 9d] [Jd]
Geconiel: checks
blistein: checks
*** SHOW DOWN ***
Geconiel: shows [5s As] (two pair, Jacks and Fives)
blistein: shows [Qc Ts] (a straight, Eight to Queen)
blistein collected $5.94 from pot
*** SUMMARY ***
Total pot $6.25 | Rake $0.31
Board [8d Jc 5d 9d Jd]
Seat 1: Geconiel (small blind) showed [5s As] and lost with two pair, Jacks and Fives
Seat 2: amsterdamzuid (big blind) folded on the Flop
Seat 3: crush6969 folded before Flop (didn't bet)
Seat 4: RikkStroken folded before Flop (didn't bet)
Seat 5: blistein showed [Qc Ts] and won ($5.94) with a straight, Eight to Queen
Seat 6: Popokluev (button) folded before Flop (didn't bet)


PokerStars Hand #220489633744:  Hold'em No Limit ($0.25/$0.50 USD) - 2020/11/17 7:30:55 ET
Table 'Hermia II' 6-max Seat #1 is the button
Seat 1: Geconiel ($50 in chips)
Seat 2: amsterdamzuid ($34.25 in chips)
Seat 3: crush6969 ($111.97 in chips)
Seat 4: RikkStroken ($50 in chips)
Seat 5: blistein ($62.87 in chips)
Seat 6: Popokluev ($67.63 in chips)
amsterdamzuid: posts small blind $0.25
crush6969: posts big blind $0.50
*** HOLE CARDS ***
RikkStroken: folds
blistein: raises $1 to $1.50
Popokluev: folds
Geconiel: calls $1.50
amsterdamzuid: folds
crush6969: calls $1
*** FLOP *** [Ad Ts Td]
crush6969: checks
blistein: bets $3.25
Geconiel: calls $3.25
crush6969: folds
*** TURN *** [Ad Ts Td] [8s]
blistein: bets $7.16
Geconiel: calls $7.16
*** RIVER *** [Ad Ts Td 8s] [Ac]
blistein: checks
Geconiel: bets $5
blistein: calls $5
*** SHOW DOWN ***
Geconiel: shows [9d 7d] (two pair, Aces and Tens)
blistein: shows [Tc Js] (a full house, Tens full of Aces)
blistein collected $33.79 from pot
*** SUMMARY ***
Total pot $35.57 | Rake $1.78
Board [Ad Ts Td 8s Ac]
Seat 1: Geconiel (button) showed [9d 7d] and lost with two pair, Aces and Tens
Seat 2: amsterdamzuid (small blind) folded before Flop
Seat 3: crush6969 (big blind) folded on the Flop
Seat 4: RikkStroken folded before Flop (didn't bet)
Seat 5: blistein showed [Tc Js] and won ($33.79) with a full house, Tens full of Aces
Seat 6: Popokluev folded before Flop (didn't bet)


PokerStars Hand #220489687975:  Hold'em No Limit ($0.25/$0.50 USD) - 2020/11/17 7:33:42 ET
Table 'Hermia II' 6-max Seat #5 is the button
Seat 1: Geconiel ($50 in chips)
Seat 2: amsterdamzuid ($38.37 in chips)
Seat 3: crush6969 ($107.89 in chips)
Seat 4: RikkStroken ($49 in chips)
Seat 5: blistein ($79 in chips)
Seat 6: Popokluev ($67.13 in chips)
Popokluev: posts small blind $0.25
Geconiel: posts big blind $0.50
*** HOLE CARDS ***
amsterdamzuid: calls $0.50
crush6969: folds
RikkStroken: folds
blistein: raises $1.50 to $2
Popokluev: folds
Geconiel: raises $5 to $7
amsterdamzuid: folds
blistein: calls $5
*** FLOP *** [4h 5h 5d]
Geconiel: bets $7.01
blistein: calls $7.01
*** TURN *** [4h 5h 5d] [8c]
Geconiel: checks
blistein: checks
*** RIVER *** [4h 5h 5d 8c] [9s]
Geconiel: checks
blistein: checks
*** SHOW DOWN ***
Geconiel: shows [Kd Ah] (a pair of Fives)
blistein: shows [Td Tc] (two pair, Tens and Fives)
blistein collected $27.33 from pot
*** SUMMARY ***
Total pot $28.77 | Rake $1.44
Board [4h 5h 5d 8c 9s]
Seat 1: Geconiel (big blind) showed [Kd Ah] and lost with a pair of Fives
Seat 2: amsterdamzuid folded before Flop
Seat 3: crush6969 folded before Flop (didn't bet)
Seat 4: RikkStroken folded before Flop (didn't bet)
Seat 5: blistein (button) showed [Td Tc] and won ($27.33) with two pair, Tens and Fives
Seat 6: Popokluev (small blind) folded before Flop


PokerStars Hand #220489715885:  Hold'em No Limit ($0.25/$0.50 USD) - 2020/11/17 7:35:08 ET
Table 'Hermia II' 6-max Seat #6 is the button
Seat 1: Geconiel ($50 in chips)
Seat 2: amsterdamzuid ($37.87 in chips)
Seat 3: crush6969 ($107.89 in chips)
Seat 4: RikkStroken ($49 in chips)
Seat 5: blistein ($92.32 in chips)
Seat 6: Popokluev ($66.88 in chips)
Geconiel: posts small blind $0.25
amsterdamzuid: posts big blind $0.50
*** HOLE CARDS ***
crush6969: folds
RikkStroken: folds
blistein: folds
Popokluev: folds
Geconiel: raises $0.75 to $1.25
amsterdamzuid: raises $0.75 to $2
Geconiel: raises $5 to $7
amsterdamzuid: calls $5
*** FLOP *** [9d 7d 2c]
Geconiel: bets $8
amsterdamzuid: raises $22.87 to $30.87 and is all-in
Geconiel: calls $22.87
*** TURN *** [9d 7d 2c] [Ts]
*** RIVER *** [9d 7d 2c Ts] [5s]
*** SHOW DOWN ***
Geconiel: shows [Jc Jd] (a pair of Jacks)
amsterdamzuid: shows [7h 4h] (a pair of Sevens)
Geconiel collected $73.74 from pot
*** SUMMARY ***
Total pot $75.74 | Rake $2
Board [9d 7d 2c Ts 5s]
Seat 1: Geconiel (small blind) showed [Jc Jd] and won ($73.74) with a pair of Jacks
Seat 2: amsterdamzuid (big blind) showed [7h 4h] and lost with a pair of Sevens
Seat 3: crush6969 folded before Flop (didn't bet)
Seat 4: RikkStroken folded before Flop (didn't bet)
Seat 5: blistein folded before Flop (didn't bet)
Seat 6: Popokluev (button) folded before Flop (didn't bet)


PokerStars Hand #220489790641:  Hold'em No Limit ($0.25/$0.50 USD) - 2020/11/17 7:38:56 ET
Table 'Hermia II' 6-max Seat #5 is the button
Seat 1: Geconiel ($86.61 in chips)
Seat 2: amsterdamzuid ($26.40 in chips)
Seat 3: crush6969 ($104.76 in chips)
Seat 5: blistein ($90.07 in chips)
Seat 6: Popokluev ($64.63 in chips)
Popokluev: posts small blind $0.25
Geconiel: posts big blind $0.50
*** HOLE CARDS ***
amsterdamzuid: raises $0.50 to $1
crush6969: folds
blistein: folds
Popokluev: folds
Geconiel: calls $0.50
*** FLOP *** [4d 8h 9s]
Geconiel: checks
amsterdamzuid: bets $2.14
Geconiel: calls $2.14
*** TURN *** [4d 8h 9s] [7d]
Geconiel: bets $1.50
amsterdamzuid: calls $1.50
*** RIVER *** [4d 8h 9s 7d] [Ah]
Geconiel: checks
amsterdamzuid: checks
*** SHOW DOWN ***
Geconiel: shows [3h 4h] (a pair of Fours)
amsterdamzuid: shows [Qc 9c] (a pair of Nines)
amsterdamzuid collected $9.05 from pot
*** SUMMARY ***
Total pot $9.53 | Rake $0.48
Board [4d 8h 9s 7d Ah]
Seat 1: Geconiel (big blind) showed [3h 4h] and lost with a pair of Fours
Seat 2: amsterdamzuid showed [Qc 9c] and won ($9.05) with a pair of Nines
Seat 3: crush6969 folded before Flop (didn't bet)
Seat 5: blistein (button) folded before Flop (didn't bet)
Seat 6: Popokluev (small blind) folded before Flop


PokerStars Hand #220489803860:  Hold'em No Limit ($0.25/$0.50 USD) - 2020/11/17 7:39:36 ET
Table 'Hermia II' 6-max Seat #6 is the button
Seat 1: Geconiel ($81.97 in chips)
Seat 2: amsterdamzuid ($30.81 in chips)
Seat 3: crush6969 ($104.76 in chips)
Seat 5: blistein ($90.07 in chips)
Seat 6: Popokluev ($64.38 in chips)
Geconiel: posts small blind $0.25
amsterdamzuid: posts big blind $0.50
*** HOLE CARDS ***
crush6969: raises $1 to $1.50
blistein: folds
Popokluev: folds
Geconiel: calls $1.25
amsterdamzuid: raises $5 to $6.50
PinnacleUa joins the table at seat #4
crush6969: calls $5
Geconiel: folds
*** FLOP *** [2d Kc 9c]
amsterdamzuid: bets $24.31 and is all-in
crush6969: calls $24.31
*** TURN *** [2d Kc 9c] [5s]
*** RIVER *** [2d Kc 9c 5s] [8s]
*** SHOW DOWN ***
amsterdamzuid: shows [5h 5d] (three of a kind, Fives)
crush6969: shows [Ac 4c] (high card Ace)
amsterdamzuid collected $61.12 from pot
*** SUMMARY ***
Total pot $63.12 | Rake $2
Board [2d Kc 9c 5s 8s]
Seat 1: Geconiel (small blind) folded before Flop
Seat 2: amsterdamzuid (big blind) showed [5h 5d] and won ($61.12) with three of a kind, Fives
Seat 3: crush6969 showed [Ac 4c] and lost with high card Ace
Seat 5: blistein folded before Flop (didn't bet)
Seat 6: Popokluev (button) folded before Flop (didn't bet)


PokerStars Hand #221293306428:  Hold'em No Limit ($0.25/$0.50 USD) - 2020/12/10 11:50:05 ET
Table 'Algebar' 6-max Seat #4 is the button
Seat 1: JrnPtk ($26.05 in chips)
Seat 4: easy_sarcasm ($50.25 in chips)
Seat 5: On1yHuman ($51.85 in chips)
Seat 6: EatMyStake ($50 in chips)
On1yHuman: posts small blind $0.25
EatMyStake: posts big blind $0.50
blistein: sits out
spartaknv: sits out
*** HOLE CARDS ***
JrnPtk: calls $0.50
easy_sarcasm: folds
On1yHuman: raises $1.50 to $2
EatMyStake: calls $1.50
JrnPtk: calls $1.50
*** FLOP *** [Jd 3h 6d]
spartaknv leaves the table
blistein leaves the table
On1yHuman: bets $1.88
spartaknv joins the table at seat #3
EatMyStake: calls $1.88
JrnPtk: calls $1.88
*** TURN *** [Jd 3h 6d] [7h]
KOCTA47 joins the table at seat #2
On1yHuman: checks
EatMyStake: checks
JrnPtk: checks
*** RIVER *** [Jd 3h 6d 7h] [5d]
On1yHuman: checks
EatMyStake: checks
JrnPtk: checks
*** SHOW DOWN ***
On1yHuman: shows [Ts 9s] (high card Jack)
EatMyStake: shows [5s 6s] (two pair, Sixes and Fives)
JrnPtk: mucks hand
EatMyStake collected $11.06 from pot
*** SUMMARY ***
Total pot $11.64 | Rake $0.58
Board [Jd 3h 6d 7h 5d]
Seat 1: JrnPtk mucked
Seat 4: easy_sarcasm (button) folded before Flop (didn't bet)
Seat 5: On1yHuman (small blind) showed [Ts 9s] and lost with high card Jack
Seat 6: EatMyStake (big blind) showed [5s 6s] and won ($11.06) with two pair, Sixes and Fives


PokerStars Hand #233520387262:  Hold'em No Limit ($0.25/$0.50 USD) - 2022/01/27 4:16:26 ET
Table 'Mrkos II' 6-max Seat #1 is the button
Seat 1: vanes Samson ($62.76 in chips)
Seat 3: n14dal ($53.51 in chips)
Seat 4: pupan45 ($72.96 in chips)
Seat 5: cozezu ($84.61 in chips)
Seat 6: gretzis2017 ($53.38 in chips)
n14dal: posts small blind $0.25
pupan45: posts big blind $0.50
*** HOLE CARDS ***
1roma6 leaves the table
cozezu: folds
blistein joins the table at seat #2
gretzis2017: raises $1 to $1.50
vanes Samson: folds
n14dal: folds
pupan45: calls $1
*** FLOP *** [5d Qc 4c]
pupan45: checks
gretzis2017: checks
*** TURN *** [5d Qc 4c] [3s]
pupan45: checks
gretzis2017: checks
*** RIVER *** [5d Qc 4c 3s] [4s]
pupan45: checks
gretzis2017: checks
*** SHOW DOWN ***
pupan45: shows [9c As] (a pair of Fours)
gretzis2017: mucks hand
pupan45 collected $3.09 from pot
*** SUMMARY ***
Total pot $3.25 | Rake $0.16
Board [5d Qc 4c 3s 4s]
Seat 1: vanes Samson (button) folded before Flop (didn't bet)
Seat 3: n14dal (small blind) folded before Flop
Seat 4: pupan45 (big blind) showed [9c As] and won ($3.09) with a pair of Fours
Seat 5: cozezu folded before Flop (didn't bet)
Seat 6: gretzis2017 mucked


PokerStars Hand #233520398940:  Hold'em No Limit ($0.25/$0.50 USD) - 2022/01/27 4:17:28 ET
Table 'Mrkos II' 6-max Seat #4 is the button
Seat 1: vanes Samson ($62.76 in chips)
Seat 3: n14dal ($53.26 in chips)
Seat 4: pupan45 ($74.30 in chips)
Seat 5: cozezu ($84.11 in chips)
Seat 6: gretzis2017 ($52.63 in chips)
cozezu: posts small blind $0.25
gretzis2017: posts big blind $0.50
blistein: sits out
*** HOLE CARDS ***
vanes Samson: raises $1 to $1.50
n14dal: folds
pupan45: folds
cozezu: folds
gretzis2017: calls $1
*** FLOP *** [Ac Td 8c]
gretzis2017: checks
vanes Samson: bets $2.25
gretzis2017: calls $2.25
*** TURN *** [Ac Td 8c] [7c]
gretzis2017: checks
vanes Samson: checks
*** RIVER *** [Ac Td 8c 7c] [2d]
gretzis2017: bets $6
vanes Samson: calls $6
*** SHOW DOWN ***
gretzis2017: shows [2c 3c] (a flush, Ace high)
vanes Samson: mucks hand
gretzis2017 collected $18.76 from pot
*** SUMMARY ***
Total pot $19.75 | Rake $0.99
Board [Ac Td 8c 7c 2d]
Seat 1: vanes Samson mucked
Seat 3: n14dal folded before Flop (didn't bet)
Seat 4: pupan45 (button) folded before Flop (didn't bet)
Seat 5: cozezu (small blind) folded before Flop
Seat 6: gretzis2017 (big blind) showed [2c 3c] and won ($18.76) with a flush, Ace high


PokerStars Hand #233520453223:  Hold'em No Limit ($0.25/$0.50 USD) - 2022/01/27 4:22:09 ET
Table 'Mrkos II' 6-max Seat #2 is the button
Seat 1: TexasNLHEKing ($36.39 in chips)
Seat 2: blistein ($50 in chips)
Seat 3: n14dal ($50.88 in chips)
Seat 4: pupan45 ($71.65 in chips)
Seat 5: cozezu ($83.88 in chips)
Seat 6: gretzis2017 ($68.75 in chips)
n14dal: posts small blind $0.25
pupan45: posts big blind $0.50
*** HOLE CARDS ***
cozezu: folds
gretzis2017: raises $1 to $1.50
TexasNLHEKing: folds
blistein: folds
n14dal: folds
pupan45: calls $1
*** FLOP *** [Ac 8s Jd]
pupan45: checks
gretzis2017: bets $1.50
pupan45: calls $1.50
*** TURN *** [Ac 8s Jd] [Jc]
pupan45: checks
gretzis2017: checks
*** RIVER *** [Ac 8s Jd Jc] [6h]
pupan45: checks
gretzis2017: bets $3.50
pupan45: calls $3.50
*** SHOW DOWN ***
gretzis2017: shows [Ad Ts] (two pair, Aces and Jacks)
pupan45: mucks hand
gretzis2017 collected $12.59 from pot
*** SUMMARY ***
Total pot $13.25 | Rake $0.66
Board [Ac 8s Jd Jc 6h]
Seat 1: TexasNLHEKing folded before Flop (didn't bet)
Seat 2: blistein (button) folded before Flop (didn't bet)
Seat 3: n14dal (small blind) folded before Flop
Seat 4: pupan45 (big blind) mucked
Seat 5: cozezu folded before Flop (didn't bet)
Seat 6: gretzis2017 showed [Ad Ts] and won ($12.59) with two pair, Aces and Jacks


PokerStars Hand #233522754016:  Hold'em No Limit ($0.25/$0.50 USD) - 2022/01/27 7:04:52 ET
Table 'Mrkos II' 6-max Seat #4 is the button
Seat 1: MordOleg ($66.11 in chips)
Seat 3: Eltiobugs ($55.03 in chips)
Seat 4: kovshikov77 ($38.10 in chips)
Seat 5: FastGame123 ($98.34 in chips)
Seat 6: random4iq ($50 in chips)
FastGame123: posts small blind $0.25
random4iq: posts big blind $0.50
blistein: sits out
*** HOLE CARDS ***
MordOleg: raises $0.75 to $1.25
Eltiobugs: folds
kovshikov77: calls $1.25
FastGame123: folds
random4iq: folds
*** FLOP *** [4c Ac Ts]
MordOleg: checks
kovshikov77: bets $3.09
MordOleg: calls $3.09
*** TURN *** [4c Ac Ts] [9h]
MordOleg: checks
kovshikov77: checks
*** RIVER *** [4c Ac Ts 9h] [Qs]
MordOleg: checks
kovshikov77: checks
*** SHOW DOWN ***
MordOleg: shows [Ah Ks] (a pair of Aces)
kovshikov77: mucks hand
MordOleg collected $8.96 from pot
*** SUMMARY ***
Total pot $9.43 | Rake $0.47
Board [4c Ac Ts 9h Qs]
Seat 1: MordOleg showed [Ah Ks] and won ($8.96) with a pair of Aces
Seat 3: Eltiobugs folded before Flop (didn't bet)
Seat 4: kovshikov77 (button) mucked
Seat 5: FastGame123 (small blind) folded before Flop
Seat 6: random4iq (big blind) folded before Flop


PokerStars Hand #233522764130:  Hold'em No Limit ($0.25/$0.50 USD) - 2022/01/27 7:05:27 ET
Table 'Mrkos II' 6-max Seat #5 is the button
Seat 1: MordOleg ($70.73 in chips)
Seat 3: Eltiobugs ($55.03 in chips)
Seat 4: kovshikov77 ($33.76 in chips)
Seat 5: FastGame123 ($98.09 in chips)
Seat 6: random4iq ($50 in chips)
random4iq: posts small blind $0.25
MordOleg: posts big blind $0.50
blistein: sits out
*** HOLE CARDS ***
Eltiobugs: folds
kovshikov77: folds
FastGame123: folds
random4iq: raises $1 to $1.50
MordOleg: calls $1
*** FLOP *** [Qh Jd 3c]
random4iq: checks
MordOleg: checks
*** TURN *** [Qh Jd 3c] [8d]
random4iq: checks
MordOleg: checks
*** RIVER *** [Qh Jd 3c 8d] [Ts]
random4iq: checks
MordOleg: checks
*** SHOW DOWN ***
random4iq: shows [4s 4c] (a pair of Fours)
MordOleg: mucks hand
random4iq collected $2.85 from pot
*** SUMMARY ***
Total pot $3 | Rake $0.15
Board [Qh Jd 3c 8d Ts]
Seat 1: MordOleg (big blind) mucked
Seat 3: Eltiobugs folded before Flop (didn't bet)
Seat 4: kovshikov77 folded before Flop (didn't bet)
Seat 5: FastGame123 (button) folded before Flop (didn't bet)
Seat 6: random4iq (small blind) showed [4s 4c] and won ($2.85) with a pair of Fours


PokerStars Hand #233522806272:  Hold'em No Limit ($0.25/$0.50 USD) - 2022/01/27 7:07:58 ET
Table 'Mrkos II' 6-max Seat #5 is the button
Seat 1: MordOleg ($67.73 in chips)
Seat 2: blistein ($50 in chips)
Seat 3: Eltiobugs ($65.03 in chips)
Seat 4: kovshikov77 ($33.26 in chips)
Seat 5: FastGame123 ($97.34 in chips)
Seat 6: random4iq ($50.85 in chips)
random4iq: posts small blind $0.25
MordOleg: posts big blind $0.50
*** HOLE CARDS ***
blistein: raises $0.65 to $1.15
Eltiobugs: folds
kovshikov77: folds
FastGame123: folds
random4iq: folds
MordOleg: calls $0.65
*** FLOP *** [7s Th 2s]
MordOleg: checks
blistein: checks
*** TURN *** [7s Th 2s] [Td]
MordOleg: bets $1.21
blistein: calls $1.21
*** RIVER *** [7s Th 2s Td] [5d]
MordOleg: checks
blistein: checks
*** SHOW DOWN ***
MordOleg: shows [8c 8d] (two pair, Tens and Eights)
blistein: mucks hand
MordOleg collected $4.72 from pot
*** SUMMARY ***
Total pot $4.97 | Rake $0.25
Board [7s Th 2s Td 5d]
Seat 1: MordOleg (big blind) showed [8c 8d] and won ($4.72) with two pair, Tens and Eights
Seat 2: blistein mucked
Seat 3: Eltiobugs folded before Flop (didn't bet)
Seat 4: kovshikov77 folded before Flop (didn't bet)
Seat 5: FastGame123 (button) folded before Flop (didn't bet)
Seat 6: random4iq (small blind) folded before Flop


PokerStars Hand #233522815746:  Hold'em No Limit ($0.25/$0.50 USD) - 2022/01/27 7:08:31 ET
Table 'Mrkos II' 6-max Seat #6 is the button
Seat 1: MordOleg ($70.09 in chips)
Seat 3: Eltiobugs ($65.03 in chips)
Seat 4: kovshikov77 ($33.26 in chips)
Seat 5: FastGame123 ($97.34 in chips)
Seat 6: random4iq ($50.60 in chips)
MordOleg: posts small blind $0.25
blistein: is sitting out
blistein leaves the table
Eltiobugs: posts big blind $0.50
*** HOLE CARDS ***
kovshikov77: raises $0.50 to $1
FastGame123: folds
random4iq: folds
MordOleg: calls $0.75
Eltiobugs: folds
*** FLOP *** [Ts 2d Qd]
MordOleg: checks
hesperus132 joins the table at seat #2
kovshikov77: checks
*** TURN *** [Ts 2d Qd] [9s]
MordOleg: checks
kovshikov77: checks
*** RIVER *** [Ts 2d Qd 9s] [3s]
MordOleg: checks
kovshikov77: checks
*** SHOW DOWN ***
MordOleg: shows [5c 6c] (high card Queen)
kovshikov77: shows [Ah 3d] (a pair of Threes)
kovshikov77 collected $2.38 from pot
*** SUMMARY ***
Total pot $2.50 | Rake $0.12
Board [Ts 2d Qd 9s 3s]
Seat 1: MordOleg (small blind) showed [5c 6c] and lost with high card Queen
Seat 3: Eltiobugs (big blind) folded before Flop
Seat 4: kovshikov77 showed [Ah 3d] and won ($2.38) with a pair of Threes
Seat 5: FastGame123 folded before Flop (didn't bet)
Seat 6: random4iq (button) folded before Flop (didn't bet)


PokerStars Hand #214266512327:  Hold'em No Limit ($0.25/$0.50 USD) - 2020/05/22 3:40:38 ET
Table 'Mothallah III' 6-max Seat #3 is the button
Seat 1: vicktor2018 ($46.09 in chips)
Seat 2: alf51321 ($50 in chips)
Seat 3: Soulfrozz ($53.99 in chips)
Seat 4: ilaviiitech ($50 in chips)
Seat 5: blistein ($50 in chips)
Seat 6: ag2585 ($40 in chips)
ilaviiitech: posts small blind $0.25
blistein: posts big blind $0.50
*** HOLE CARDS ***
ag2585: folds
vicktor2018: calls $0.50
alf51321: folds
Soulfrozz: folds
ilaviiitech: folds
blistein: checks
*** FLOP *** [7s Qc 5s]
blistein: checks
vicktor2018: checks
*** TURN *** [7s Qc 5s] [3s]
blistein: checks
vicktor2018: checks
*** RIVER *** [7s Qc 5s 3s] [2c]
blistein: checks
vicktor2018: checks
*** SHOW DOWN ***
blistein: shows [Ts 3c] (a pair of Threes)
vicktor2018: mucks hand
blistein collected $1.19 from pot
*** SUMMARY ***
Total pot $1.25 | Rake $0.06
Board [7s Qc 5s 3s 2c]
Seat 1: vicktor2018 mucked
Seat 2: alf51321 folded before Flop (didn't bet)
Seat 3: Soulfrozz (button) folded before Flop (didn't bet)
Seat 4: ilaviiitech (small blind) folded before Flop
Seat 5: blistein (big blind) showed [Ts 3c] and won ($1.19) with a pair of Threes
Seat 6: ag2585 folded before Flop (didn't bet)


PokerStars Hand #214266534429:  Hold'em No Limit ($0.25/$0.50 USD) - 2020/05/22 3:41:49 ET
Table 'Mothallah III' 6-max Seat #6 is the button
Seat 1: vicktor2018 ($46.22 in chips)
Seat 2: alf51321 ($50 in chips)
Seat 3: Soulfrozz ($53.99 in chips)
Seat 4: ilaviiitech ($50 in chips)
Seat 5: blistein ($52.19 in chips)
Seat 6: ag2585 ($39.25 in chips)
vicktor2018: posts small blind $0.25
alf51321: posts big blind $0.50
*** HOLE CARDS ***
Soulfrozz: raises $0.70 to $1.20
ilaviiitech: folds
blistein: folds
ag2585: folds
vicktor2018: calls $0.95
alf51321: calls $0.70
*** FLOP *** [5d Jd 9s]
vicktor2018: checks
alf51321: checks
Soulfrozz: bets $2.57
vicktor2018: calls $2.57
alf51321: folds
*** TURN *** [5d Jd 9s] [Td]
vicktor2018: checks
Soulfrozz: checks
*** RIVER *** [5d Jd 9s Td] [Qd]
vicktor2018: bets $0.50
Soulfrozz: raises $6.98 to $7.48
vicktor2018: raises $6.98 to $14.46
Soulfrozz: raises $35.76 to $50.22 and is all-in
vicktor2018: calls $27.99 and is all-in
Uncalled bet ($7.77) returned to Soulfrozz
*** SHOW DOWN ***
Soulfrozz: shows [Ad Jh] (a flush, Ace high)
vicktor2018: shows [As Kd] (a flush, King high)
Soulfrozz collected $91.64 from pot
*** SUMMARY ***
Total pot $93.64 | Rake $2
Board [5d Jd 9s Td Qd]
Seat 1: vicktor2018 (small blind) showed [As Kd] and lost with a flush, King high
Seat 2: alf51321 (big blind) folded on the Flop
Seat 3: Soulfrozz showed [Ad Jh] and won ($91.64) with a flush, Ace high
Seat 4: ilaviiitech folded before Flop (didn't bet)
Seat 5: blistein folded before Flop (didn't bet)
Seat 6: ag2585 (button) folded before Flop (didn't bet)


PokerStars Hand #214266573346:  Hold'em No Limit ($0.25/$0.50 USD) - 2020/05/22 3:43:53 ET
Table 'Mothallah III' 6-max Seat #4 is the button
Seat 1: vicktor2018 ($50 in chips)
Seat 2: alf51321 ($50 in chips)
Seat 3: Soulfrozz ($99.16 in chips)
Seat 4: ilaviiitech ($50 in chips)
Seat 5: blistein ($51.69 in chips)
Seat 6: ag2585 ($41.81 in chips)
blistein: posts small blind $0.25
ag2585: posts big blind $0.50
*** HOLE CARDS ***
vicktor2018: calls $0.50
alf51321: folds
Soulfrozz: folds
ilaviiitech: raises $1.50 to $2
blistein: folds
ag2585: folds
vicktor2018: calls $1.50
*** FLOP *** [Ah Qc Tc]
vicktor2018: checks
ilaviiitech: bets $2.71
vicktor2018: calls $2.71
*** TURN *** [Ah Qc Tc] [3s]
vicktor2018: checks
ilaviiitech: bets $6.44
vicktor2018: calls $6.44
*** RIVER *** [Ah Qc Tc 3s] [8h]
vicktor2018: checks
ilaviiitech: checks
*** SHOW DOWN ***
vicktor2018: shows [Ad 2d] (a pair of Aces)
ilaviiitech: shows [As Jc] (a pair of Aces - Queen+Jack kicker)
ilaviiitech collected $21.90 from pot
*** SUMMARY ***
Total pot $23.05 | Rake $1.15
Board [Ah Qc Tc 3s 8h]
Seat 1: vicktor2018 showed [Ad 2d] and lost with a pair of Aces
Seat 2: alf51321 folded before Flop (didn't bet)
Seat 3: Soulfrozz folded before Flop (didn't bet)
Seat 4: ilaviiitech (button) showed [As Jc] and won ($21.90) with a pair of Aces
Seat 5: blistein (small blind) folded before Flop
Seat 6: ag2585 (big blind) folded before Flop


PokerStars Hand #214266611675:  Hold'em No Limit ($0.25/$0.50 USD) - 2020/05/22 3:45:53 ET
Table 'Mothallah III' 6-max Seat #3 is the button
Seat 1: vicktor2018 ($31.15 in chips)
Seat 2: alf51321 ($50 in chips)
Seat 3: Soulfrozz ($97.96 in chips)
Seat 4: ilaviiitech ($61 in chips)
Seat 5: blistein ($51.44 in chips)
Seat 6: ag2585 ($49.16 in chips)
ilaviiitech: posts small blind $0.25
blistein: posts big blind $0.50
*** HOLE CARDS ***
ag2585: folds
vicktor2018: calls $0.50
alf51321: folds
Soulfrozz: raises $2 to $2.50
ilaviiitech: folds
blistein: folds
vicktor2018: calls $2
*** FLOP *** [6h As Ks]
vicktor2018: checks
Soulfrozz: checks
*** TURN *** [6h As Ks] [9s]
vicktor2018: checks
Soulfrozz: checks
*** RIVER *** [6h As Ks 9s] [3h]
vicktor2018: checks
Soulfrozz: bets $1.42
vicktor2018: calls $1.42
*** SHOW DOWN ***
Soulfrozz: shows [Js Kc] (a pair of Kings)
vicktor2018: shows [Ad Jd] (a pair of Aces)
vicktor2018 collected $8.16 from pot
*** SUMMARY ***
Total pot $8.59 | Rake $0.43
Board [6h As Ks 9s 3h]
Seat 1: vicktor2018 showed [Ad Jd] and won ($8.16) with a pair of Aces
Seat 2: alf51321 folded before Flop (didn't bet)
Seat 3: Soulfrozz (button) showed [Js Kc] and lost with a pair of Kings
Seat 4: ilaviiitech (small blind) folded before Flop
Seat 5: blistein (big blind) folded before Flop
Seat 6: ag2585 folded before Flop (didn't bet)


PokerStars Hand #214266626627:  Hold'em No Limit ($0.25/$0.50 USD) - 2020/05/22 3:46:40 ET
Table 'Mothallah III' 6-max Seat #5 is the button
Seat 1: vicktor2018 ($35.39 in chips)
Seat 2: alf51321 ($50 in chips)
Seat 3: Soulfrozz ($94.79 in chips)
Seat 4: ilaviiitech ($60.75 in chips)
Seat 5: blistein ($50.69 in chips)
Seat 6: ag2585 ($48.66 in chips)
ag2585: posts small blind $0.25
vicktor2018: posts big blind $0.50
*** HOLE CARDS ***
alf51321: folds
Soulfrozz: folds
ilaviiitech: folds
blistein: raises $0.75 to $1.25
ag2585: folds
vicktor2018: calls $0.75
*** FLOP *** [3s 4c Th]
vicktor2018: checks
blistein: bets $0.91
vicktor2018: calls $0.91
*** TURN *** [3s 4c Th] [7c]
vicktor2018: checks
blistein: bets $3
vicktor2018: calls $3
*** RIVER *** [3s 4c Th 7c] [Ks]
vicktor2018: checks
blistein: checks
*** SHOW DOWN ***
vicktor2018: shows [Td 9h] (a pair of Tens)
blistein: mucks hand
vicktor2018 collected $10.04 from pot
*** SUMMARY ***
Total pot $10.57 | Rake $0.53
Board [3s 4c Th 7c Ks]
Seat 1: vicktor2018 (big blind) showed [Td 9h] and won ($10.04) with a pair of Tens
Seat 2: alf51321 folded before Flop (didn't bet)
Seat 3: Soulfrozz folded before Flop (didn't bet)
Seat 4: ilaviiitech folded before Flop (didn't bet)
Seat 5: blistein (button) mucked
Seat 6: ag2585 (small blind) folded before Flop


PokerStars Hand #214266640657:  Hold'em No Limit ($0.25/$0.50 USD) - 2020/05/22 3:47:17 ET
Table 'Mothallah III' 6-max Seat #6 is the button
Seat 1: vicktor2018 ($40.27 in chips)
Seat 2: alf51321 ($50 in chips)
Seat 3: Soulfrozz ($94.79 in chips)
Seat 4: ilaviiitech ($60.75 in chips)
Seat 5: blistein ($50 in chips)
Seat 6: ag2585 ($48.41 in chips)
vicktor2018: posts small blind $0.25
alf51321: posts big blind $0.50
*** HOLE CARDS ***
Soulfrozz: folds
ilaviiitech: folds
blistein: folds
ag2585: raises $1.25 to $1.75
vicktor2018: calls $1.50
alf51321: calls $1.25
*** FLOP *** [Qh Td 3d]
vicktor2018: checks
alf51321: checks
ag2585: checks
*** TURN *** [Qh Td 3d] [Ks]
vicktor2018: checks
alf51321: checks
ag2585: bets $1.50
vicktor2018: calls $1.50
alf51321: folds
*** RIVER *** [Qh Td 3d Ks] [Qd]
vicktor2018: checks
ag2585: checks
*** SHOW DOWN ***
vicktor2018: shows [Kd 5d] (a flush, King high)
ag2585: mucks hand
vicktor2018 collected $7.84 from pot
*** SUMMARY ***
Total pot $8.25 | Rake $0.41
Board [Qh Td 3d Ks Qd]
Seat 1: vicktor2018 (small blind) showed [Kd 5d] and won ($7.84) with a flush, King high
Seat 2: alf51321 (big blind) folded on the Turn
Seat 3: Soulfrozz folded before Flop (didn't bet)
Seat 4: ilaviiitech folded before Flop (didn't bet)
Seat 5: blistein folded before Flop (didn't bet)
Seat 6: ag2585 (button) mucked


PokerStars Hand #214266680921:  Hold'em No Limit ($0.25/$0.50 USD) - 2020/05/22 3:49:23 ET
Table 'Mothallah III' 6-max Seat #4 is the button
Seat 1: vicktor2018 ($44.86 in chips)
Seat 2: alf51321 ($50.75 in chips)
Seat 3: Soulfrozz ($93.54 in chips)
Seat 4: ilaviiitech ($60 in chips)
Seat 5: blistein ($50 in chips)
Seat 6: ag2585 ($46.97 in chips)
blistein: posts small blind $0.25
ag2585: posts big blind $0.50
*** HOLE CARDS ***
vicktor2018: calls $0.50
alf51321: folds
Soulfrozz: folds
ilaviiitech: folds
blistein: calls $0.25
ag2585: checks
*** FLOP *** [Jh 6h Js]
blistein: checks
ag2585: checks
vicktor2018: checks
*** TURN *** [Jh 6h Js] [Td]
blistein: checks
ag2585: bets $1.50
vicktor2018: calls $1.50
blistein: folds
*** RIVER *** [Jh 6h Js Td] [2s]
ag2585: bets $4.50
vicktor2018: calls $4.50
*** SHOW DOWN ***
ag2585: shows [8h Qs] (a pair of Jacks)
vicktor2018: shows [Kd Tc] (two pair, Jacks and Tens)
vicktor2018 collected $12.82 from pot
*** SUMMARY ***
Total pot $13.50 | Rake $0.68
Board [Jh 6h Js Td 2s]
Seat 1: vicktor2018 showed [Kd Tc] and won ($12.82) with two pair, Jacks and Tens
Seat 2: alf51321 folded before Flop (didn't bet)
Seat 3: Soulfrozz folded before Flop (didn't bet)
Seat 4: ilaviiitech (button) folded before Flop (didn't bet)
Seat 5: blistein (small blind) folded on the Turn
Seat 6: ag2585 (big blind) showed [8h Qs] and lost with a pair of Jacks


PokerStars Hand #214266699738:  Hold'em No Limit ($0.25/$0.50 USD) - 2020/05/22 3:50:23 ET
Table 'Mothallah III' 6-max Seat #6 is the button
Seat 1: vicktor2018 ($50.18 in chips)
Seat 2: alf51321 ($50.75 in chips)
Seat 3: Soulfrozz ($93.54 in chips)
Seat 4: ilaviiitech ($60 in chips)
Seat 5: blistein ($50 in chips)
Seat 6: ag2585 ($41.37 in chips)
vicktor2018: posts small blind $0.25
alf51321: posts big blind $0.50
*** HOLE CARDS ***
Soulfrozz: folds
ilaviiitech: folds
blistein: folds
ag2585: folds
vicktor2018: calls $0.25
alf51321: checks
*** FLOP *** [8s 6h 3h]
vicktor2018: checks
alf51321: bets $0.50
vicktor2018: calls $0.50
*** TURN *** [8s 6h 3h] [2d]
vicktor2018: checks
alf51321: checks
*** RIVER *** [8s 6h 3h 2d] [Ts]
vicktor2018: checks
alf51321: checks
*** SHOW DOWN ***
vicktor2018: shows [Ks 4s] (high card King)
alf51321: mucks hand
vicktor2018 collected $1.90 from pot
*** SUMMARY ***
Total pot $2 | Rake $0.10
Board [8s 6h 3h 2d Ts]
Seat 1: vicktor2018 (small blind) showed [Ks 4s] and won ($1.90) with high card King
Seat 2: alf51321 (big blind) mucked
Seat 3: Soulfrozz folded before Flop (didn't bet)
Seat 4: ilaviiitech folded before Flop (didn't bet)
Seat 5: blistein folded before Flop (didn't bet)
Seat 6: ag2585 (button) folded before Flop (didn't bet)


PokerStars Hand #214266722487:  Hold'em No Limit ($0.25/$0.50 USD) - 2020/05/22 3:51:35 ET
Table 'Mothallah III' 6-max Seat #3 is the button
Seat 1: vicktor2018 ($50.58 in chips)
Seat 2: alf51321 ($50.50 in chips)
Seat 3: Soulfrozz ($92.79 in chips)
Seat 5: blistein ($50.69 in chips)
Seat 6: ag2585 ($41.37 in chips)
blistein: posts small blind $0.25
ag2585: posts big blind $0.50
*** HOLE CARDS ***
vicktor2018: calls $0.50
alf51321: folds
Soulfrozz: folds
blistein: calls $0.25
ag2585: raises $0.50 to $1
braindamage8 joins the table at seat #4
vicktor2018: calls $0.50
blistein: calls $0.50
*** FLOP *** [2c 7d 3s]
blistein: checks
ag2585: checks
vicktor2018: checks
*** TURN *** [2c 7d 3s] [Kc]
blistein: checks
ag2585: checks
vicktor2018: checks
*** RIVER *** [2c 7d 3s Kc] [7c]
blistein: checks
ag2585: bets $3
vicktor2018: calls $3
blistein: folds
*** SHOW DOWN ***
ag2585: shows [4c Tc] (a flush, King high)
vicktor2018: mucks hand
ag2585 collected $8.55 from pot
*** SUMMARY ***
Total pot $9 | Rake $0.45
Board [2c 7d 3s Kc 7c]
Seat 1: vicktor2018 mucked
Seat 2: alf51321 folded before Flop (didn't bet)
Seat 3: Soulfrozz (button) folded before Flop (didn't bet)
Seat 5: blistein (small blind) folded on the River
Seat 6: ag2585 (big blind) showed [4c Tc] and won ($8.55) with a flush, King high


PokerStars Hand #214266737126:  Hold'em No Limit ($0.25/$0.50 USD) - 2020/05/22 3:52:21 ET
Table 'Mothallah III' 6-max Seat #5 is the button
Seat 1: vicktor2018 ($46.58 in chips)
Seat 2: alf51321 ($50.50 in chips)
Seat 3: Soulfrozz ($92.79 in chips)
Seat 5: blistein ($50 in chips)
Seat 6: ag2585 ($45.92 in chips)
ag2585: posts small blind $0.25
vicktor2018: posts big blind $0.50
braindamage8: sits out
*** HOLE CARDS ***
alf51321: folds
Soulfrozz: raises $0.70 to $1.20
blistein: folds
ag2585: calls $0.95
vicktor2018: calls $0.70
*** FLOP *** [Kd 2c Kc]
ag2585: checks
vicktor2018: checks
Soulfrozz: checks
*** TURN *** [Kd 2c Kc] [Ad]
ag2585: bets $1.50
vicktor2018: calls $1.50
Soulfrozz: folds
*** RIVER *** [Kd 2c Kc Ad] [7h]
ag2585: bets $1.50
vicktor2018: calls $1.50
*** SHOW DOWN ***
ag2585: shows [Tc Ac] (two pair, Aces and Kings)
vicktor2018: mucks hand
ag2585 collected $9.12 from pot
*** SUMMARY ***
Total pot $9.60 | Rake $0.48
Board [Kd 2c Kc Ad 7h]
Seat 1: vicktor2018 (big blind) mucked
Seat 2: alf51321 folded before Flop (didn't bet)
Seat 3: Soulfrozz folded on the Turn
Seat 5: blistein (button) folded before Flop (didn't bet)
Seat 6: ag2585 (small blind) showed [Tc Ac] and won ($9.12) with two pair, Aces and Kings


PokerStars Hand #214266755486:  Hold'em No Limit ($0.25/$0.50 USD) - 2020/05/22 3:53:20 ET
Table 'Mothallah III' 6-max Seat #1 is the button
Seat 1: vicktor2018 ($42.13 in chips)
Seat 2: alf51321 ($50 in chips)
Seat 3: Soulfrozz ($90.39 in chips)
Seat 5: blistein ($50 in chips)
Seat 6: ag2585 ($52.63 in chips)
alf51321: posts small blind $0.25
Soulfrozz: posts big blind $0.50
braindamage8: sits out
*** HOLE CARDS ***
blistein: folds
ag2585: folds
vicktor2018: calls $0.50
alf51321: folds
Soulfrozz: checks
*** FLOP *** [6s Td 8d]
Soulfrozz: checks
vicktor2018: checks
*** TURN *** [6s Td 8d] [Tc]
Soulfrozz: checks
vicktor2018: checks
*** RIVER *** [6s Td 8d Tc] [4h]
Soulfrozz: checks
vicktor2018: checks
*** SHOW DOWN ***
Soulfrozz: shows [5d 9c] (a pair of Tens)
vicktor2018: shows [7s 4d] (two pair, Tens and Fours)
vicktor2018 collected $1.19 from pot
*** SUMMARY ***
Total pot $1.25 | Rake $0.06
Board [6s Td 8d Tc 4h]
Seat 1: vicktor2018 (button) showed [7s 4d] and won ($1.19) with two pair, Tens and Fours
Seat 2: alf51321 (small blind) folded before Flop
Seat 3: Soulfrozz (big blind) showed [5d 9c] and lost with a pair of Tens
Seat 5: blistein folded before Flop (didn't bet)
Seat 6: ag2585 folded before Flop (didn't bet)


PokerStars Hand #214266765962:  Hold'em No Limit ($0.25/$0.50 USD) - 2020/05/22 3:53:53 ET
Table 'Mothallah III' 6-max Seat #2 is the button
Seat 1: vicktor2018 ($42.82 in chips)
Seat 2: alf51321 ($50 in chips)
Seat 3: Soulfrozz ($89.89 in chips)
Seat 4: braindamage8 ($50 in chips)
Seat 5: blistein ($50 in chips)
Seat 6: ag2585 ($52.63 in chips)
Soulfrozz: posts small blind $0.25
braindamage8: posts big blind $0.50
*** HOLE CARDS ***
blistein: folds
ag2585: folds
vicktor2018: calls $0.50
alf51321: calls $0.50
Soulfrozz: folds
braindamage8: checks
*** FLOP *** [8c 9h 7s]
braindamage8: bets $1.16
vicktor2018: calls $1.16
alf51321: folds
*** TURN *** [8c 9h 7s] [7d]
braindamage8: bets $3
vicktor2018: calls $3
*** RIVER *** [8c 9h 7s 7d] [Qs]
braindamage8: bets $7
vicktor2018: calls $7
*** SHOW DOWN ***
braindamage8: shows [9d 7h] (a full house, Sevens full of Nines)
vicktor2018: mucks hand
braindamage8 collected $22.87 from pot
*** SUMMARY ***
Total pot $24.07 | Rake $1.20
Board [8c 9h 7s 7d Qs]
Seat 1: vicktor2018 mucked
Seat 2: alf51321 (button) folded on the Flop
Seat 3: Soulfrozz (small blind) folded before Flop
Seat 4: braindamage8 (big blind) showed [9d 7h] and won ($22.87) with a full house, Sevens full of Nines
Seat 5: blistein folded before Flop (didn't bet)
Seat 6: ag2585 folded before Flop (didn't bet)


PokerStars Hand #214266781977:  Hold'em No Limit ($0.25/$0.50 USD) - 2020/05/22 3:54:44 ET
Table 'Mothallah III' 6-max Seat #3 is the button
Seat 1: vicktor2018 ($31.16 in chips)
Seat 2: alf51321 ($50 in chips)
Seat 3: Soulfrozz ($89.64 in chips)
Seat 4: braindamage8 ($61.21 in chips)
Seat 5: blistein ($50 in chips)
Seat 6: ag2585 ($52.63 in chips)
braindamage8: posts small blind $0.25
blistein: posts big blind $0.50
*** HOLE CARDS ***
ag2585: folds
vicktor2018: calls $0.50
alf51321: folds
Soulfrozz: folds
braindamage8: raises $2 to $2.50
blistein: folds
vicktor2018: calls $2
*** FLOP *** [2c Js 5c]
braindamage8: checks
vicktor2018: checks
*** TURN *** [2c Js 5c] [Ts]
braindamage8: bets $1
vicktor2018: calls $1
*** RIVER *** [2c Js 5c Ts] [6d]
braindamage8: checks
vicktor2018: checks
*** SHOW DOWN ***
braindamage8: shows [Ah Qh] (high card Ace)
vicktor2018: mucks hand
braindamage8 collected $7.12 from pot
*** SUMMARY ***
Total pot $7.50 | Rake $0.38
Board [2c Js 5c Ts 6d]
Seat 1: vicktor2018 mucked
Seat 2: alf51321 folded before Flop (didn't bet)
Seat 3: Soulfrozz (button) folded before Flop (didn't bet)
Seat 4: braindamage8 (small blind) showed [Ah Qh] and won ($7.12) with high card Ace
Seat 5: blistein (big blind) folded before Flop
Seat 6: ag2585 folded before Flop (didn't bet)


PokerStars Hand #214266826268:  Hold'em No Limit ($0.25/$0.50 USD) - 2020/05/22 3:57:24 ET
Table 'Mothallah III' 6-max Seat #2 is the button
Seat 1: vicktor2018 ($25.21 in chips)
Seat 2: alf51321 ($50 in chips)
Seat 4: braindamage8 ($69.04 in chips)
Seat 5: blistein ($51.70 in chips)
Seat 6: ag2585 ($51.88 in chips)
braindamage8: posts small blind $0.25
blistein: posts big blind $0.50
*** HOLE CARDS ***
ag2585: raises $1.25 to $1.75
vicktor2018: folds
alf51321: calls $1.75
braindamage8: folds
blistein: folds
*** FLOP *** [4d 7c Qd]
ag2585: bets $2.50
alf51321: calls $2.50
*** TURN *** [4d 7c Qd] [8h]
ag2585: bets $3
alf51321: calls $3
*** RIVER *** [4d 7c Qd 8h] [4s]
ag2585: bets $3
alf51321: calls $3
*** SHOW DOWN ***
ag2585: shows [Qc Kc] (two pair, Queens and Fours)
alf51321: mucks hand
ag2585 collected $20.19 from pot
*** SUMMARY ***
Total pot $21.25 | Rake $1.06
Board [4d 7c Qd 8h 4s]
Seat 1: vicktor2018 folded before Flop (didn't bet)
Seat 2: alf51321 (button) mucked
Seat 4: braindamage8 (small blind) folded before Flop
Seat 5: blistein (big blind) folded before Flop
Seat 6: ag2585 showed [Qc Kc] and won ($20.19) with two pair, Queens and Fours


PokerStars Hand #214266857330:  Hold'em No Limit ($0.25/$0.50 USD) - 2020/05/22 3:59:18 ET
Table 'Mothallah III' 6-max Seat #6 is the button
Seat 1: vicktor2018 ($23.96 in chips)
Seat 2: alf51321 ($50 in chips)
Seat 4: braindamage8 ($68.79 in chips)
Seat 5: blistein ($50 in chips)
Seat 6: ag2585 ($65.05 in chips)
vicktor2018: posts small blind $0.25
alf51321: posts big blind $0.50
Soulfrozz: sits out
*** HOLE CARDS ***
braindamage8: raises $0.75 to $1.25
blistein: folds
ag2585: folds
vicktor2018: raises $0.75 to $2
alf51321: folds
braindamage8: calls $0.75
*** FLOP *** [As 5d Qh]
vicktor2018: checks
braindamage8: checks
*** TURN *** [As 5d Qh] [Td]
vicktor2018: checks
braindamage8: bets $3.50
vicktor2018: raises $3.50 to $7
braindamage8: calls $3.50
*** RIVER *** [As 5d Qh Td] [2c]
vicktor2018: checks
braindamage8: bets $15
vicktor2018: calls $14.96 and is all-in
Uncalled bet ($0.04) returned to braindamage8
*** SHOW DOWN ***
braindamage8: shows [Jh Kc] (a straight, Ten to Ace)
vicktor2018: shows [Ah Ks] (a pair of Aces)
braindamage8 collected $46.42 from pot
*** SUMMARY ***
Total pot $48.42 | Rake $2
Board [As 5d Qh Td 2c]
Seat 1: vicktor2018 (small blind) showed [Ah Ks] and lost with a pair of Aces
Seat 2: alf51321 (big blind) folded before Flop
Seat 4: braindamage8 showed [Jh Kc] and won ($46.42) with a straight, Ten to Ace
Seat 5: blistein folded before Flop (didn't bet)
Seat 6: ag2585 (button) folded before Flop (didn't bet)


PokerStars Hand #214268242215:  Hold'em No Limit ($0.25/$0.50 USD) - 2020/05/22 5:08:15 ET
Table 'Mothallah III' 6-max Seat #1 is the button
Seat 1: MiSta8888 ($58.81 in chips)
Seat 2: VR13 ($55.21 in chips)
Seat 3: Vegas Jph ($50.11 in chips)
Seat 5: coouloro ($56.19 in chips)
Seat 6: yagerman007 ($52.08 in chips)
VR13: posts small blind $0.25
Vegas Jph: posts big blind $0.50
blistein: sits out
*** HOLE CARDS ***
coouloro: folds
yagerman007: raises $0.75 to $1.25
MiSta8888: folds
VR13: folds
Vegas Jph: calls $0.75
*** FLOP *** [Th 3s Ac]
Vegas Jph: checks
yagerman007: bets $1
Vegas Jph: calls $1
*** TURN *** [Th 3s Ac] [Ah]
Vegas Jph: checks
yagerman007: checks
*** RIVER *** [Th 3s Ac Ah] [8s]
Vegas Jph: checks
yagerman007: checks
*** SHOW DOWN ***
Vegas Jph: shows [3h 5d] (two pair, Aces and Threes)
yagerman007: mucks hand
Vegas Jph collected $4.51 from pot
*** SUMMARY ***
Total pot $4.75 | Rake $0.24
Board [Th 3s Ac Ah 8s]
Seat 1: MiSta8888 (button) folded before Flop (didn't bet)
Seat 2: VR13 (small blind) folded before Flop
Seat 3: Vegas Jph (big blind) showed [3h 5d] and won ($4.51) with two pair, Aces and Threes
Seat 5: coouloro folded before Flop (didn't bet)
Seat 6: yagerman007 mucked


PokerStars Hand #214268258210:  Hold'em No Limit ($0.25/$0.50 USD) - 2020/05/22 5:08:59 ET
Table 'Mothallah III' 6-max Seat #2 is the button
Seat 1: MiSta8888 ($58.81 in chips)
Seat 2: VR13 ($54.96 in chips)
Seat 3: Vegas Jph ($52.37 in chips)
Seat 4: blistein ($50 in chips)
Seat 5: coouloro ($56.19 in chips)
Seat 6: yagerman007 ($49.83 in chips)
Vegas Jph: posts small blind $0.25
blistein: posts big blind $0.50
*** HOLE CARDS ***
coouloro: folds
yagerman007: folds
MiSta8888: raises $0.75 to $1.25
VR13: folds
Vegas Jph: calls $1
blistein: calls $0.75
*** FLOP *** [Ad 6c Jd]
Vegas Jph: checks
blistein: checks
MiSta8888: checks
*** TURN *** [Ad 6c Jd] [4d]
Vegas Jph: checks
blistein: checks
MiSta8888: checks
*** RIVER *** [Ad 6c Jd 4d] [Qs]
Vegas Jph: checks
blistein: checks
MiSta8888: checks
*** SHOW DOWN ***
Vegas Jph: shows [Qh 7d] (a pair of Queens)
blistein: mucks hand
MiSta8888: shows [Ac Ts] (a pair of Aces)
MiSta8888 collected $3.56 from pot
*** SUMMARY ***
Total pot $3.75 | Rake $0.19
Board [Ad 6c Jd 4d Qs]
Seat 1: MiSta8888 showed [Ac Ts] and won ($3.56) with a pair of Aces
Seat 2: VR13 (button) folded before Flop (didn't bet)
Seat 3: Vegas Jph (small blind) showed [Qh 7d] and lost with a pair of Queens
Seat 4: blistein (big blind) mucked
Seat 5: coouloro folded before Flop (didn't bet)
Seat 6: yagerman007 folded before Flop (didn't bet)


PokerStars Hand #231180222115:  Hold'em No Limit ($0.25/$0.50 USD) - 2021/11/06 6:28:42 ET
Table 'Mashona' 6-max Seat #2 is the button
Seat 1: Loboloco151 ($29.23 in chips)
Seat 2: kyleahn1975 ($44.73 in chips)
Seat 3: blistein ($57.53 in chips)
Seat 4: StupidGirl666 ($60.46 in chips)
Seat 5: PugoGrasse ($60.96 in chips)
blistein: posts small blind $0.25
StupidGirl666: posts big blind $0.50
JuniorLis: sits out
*** HOLE CARDS ***
PugoGrasse: raises $0.75 to $1.25
Loboloco151: folds
kyleahn1975: raises $3.25 to $4.50
blistein: folds
StupidGirl666: folds
PugoGrasse: calls $3.25
*** FLOP *** [9c 8c Ad]
PugoGrasse: checks
kyleahn1975: bets $5.09
PugoGrasse: calls $5.09
*** TURN *** [9c 8c Ad] [7c]
PugoGrasse: checks
kyleahn1975: bets $6.44
PugoGrasse: raises $44.93 to $51.37 and is all-in
kyleahn1975: calls $28.70 and is all-in
Uncalled bet ($16.23) returned to PugoGrasse
*** RIVER *** [9c 8c Ad 7c] [Kh]
*** SHOW DOWN ***
PugoGrasse: shows [Kd Ah] (two pair, Aces and Kings)
kyleahn1975: shows [5c 6c] (a straight flush, Five to Nine)
kyleahn1975 collected $88.21 from pot
*** SUMMARY ***
Total pot $90.21 | Rake $2
Board [9c 8c Ad 7c Kh]
Seat 1: Loboloco151 folded before Flop (didn't bet)
Seat 2: kyleahn1975 (button) showed [5c 6c] and won ($88.21) with a straight flush, Five to Nine
Seat 3: blistein (small blind) folded before Flop
Seat 4: StupidGirl666 (big blind) folded before Flop
Seat 5: PugoGrasse showed [Kd Ah] and lost with two pair, Aces and Kings


PokerStars Hand #231180270395:  Hold'em No Limit ($0.25/$0.50 USD) - 2021/11/06 6:32:21 ET
Table 'Mashona' 6-max Seat #4 is the button
Seat 1: Loboloco151 ($29.98 in chips)
Seat 2: kyleahn1975 ($88.21 in chips)
Seat 3: blistein ($56.53 in chips)
Seat 4: StupidGirl666 ($64.43 in chips)
Seat 5: PugoGrasse ($50 in chips)
Seat 6: JuniorLis ($50 in chips)
PugoGrasse: posts small blind $0.25
JuniorLis: posts big blind $0.50
*** HOLE CARDS ***
Loboloco151: folds
kyleahn1975: raises $0.60 to $1.10
blistein: folds
StupidGirl666: folds
PugoGrasse: folds
JuniorLis: calls $0.60
*** FLOP *** [Ks 7d Tc]
JuniorLis: checks
kyleahn1975: bets $1.28
JuniorLis: calls $1.28
*** TURN *** [Ks 7d Tc] [3s]
JuniorLis: checks
kyleahn1975: bets $2.62
JuniorLis: calls $2.62
*** RIVER *** [Ks 7d Tc 3s] [5s]
JuniorLis: checks
kyleahn1975: bets $5.36
JuniorLis: calls $5.36
*** SHOW DOWN ***
kyleahn1975: shows [Kh Qs] (a pair of Kings)
JuniorLis: shows [Kc Qh] (a pair of Kings)
JuniorLis collected $9.96 from pot
kyleahn1975 collected $9.96 from pot
*** SUMMARY ***
Total pot $20.97 | Rake $1.05
Board [Ks 7d Tc 3s 5s]
Seat 1: Loboloco151 folded before Flop (didn't bet)
Seat 2: kyleahn1975 showed [Kh Qs] and won ($9.96) with a pair of Kings
Seat 3: blistein folded before Flop (didn't bet)
Seat 4: StupidGirl666 (button) folded before Flop (didn't bet)
Seat 5: PugoGrasse (small blind) folded before Flop
Seat 6: JuniorLis (big blind) showed [Kc Qh] and won ($9.96) with a pair of Kings


PokerStars Hand #231308357506:  Hold'em No Limit ($0.25/$0.50 USD) - 2021/11/11 0:22:15 ET
Table 'Kiangsu' 6-max Seat #1 is the button
Seat 1: Hygucmek ($52.36 in chips)
Seat 2: Yagomooca ($73.75 in chips)
Seat 4: thomassnkr ($86.09 in chips)
Seat 5: LostBoyzVP13 ($38.10 in chips)
Seat 6: Brdz1 ($58.64 in chips)
Yagomooca: posts small blind $0.25
Andrii1937: is sitting out
thomassnkr: posts big blind $0.50
*** HOLE CARDS ***
Andrii1937 leaves the table
LostBoyzVP13: folds
Brdz1: raises $0.60 to $1.10
Hygucmek: folds
Yagomooca: folds
blistein joins the table at seat #3
thomassnkr: calls $0.60
*** FLOP *** [2c 7d Ts]
thomassnkr: checks
Brdz1: bets $0.79
thomassnkr: calls $0.79
*** TURN *** [2c 7d Ts] [5h]
thomassnkr: checks
Brdz1: checks
*** RIVER *** [2c 7d Ts 5h] [Kd]
thomassnkr: checks
Brdz1: checks
*** SHOW DOWN ***
thomassnkr: shows [6d Ad] (high card Ace)
Brdz1: shows [7c Ac] (a pair of Sevens)
Brdz1 collected $3.83 from pot
*** SUMMARY ***
Total pot $4.03 | Rake $0.20
Board [2c 7d Ts 5h Kd]
Seat 1: Hygucmek (button) folded before Flop (didn't bet)
Seat 2: Yagomooca (small blind) folded before Flop
Seat 4: thomassnkr (big blind) showed [6d Ad] and lost with high card Ace
Seat 5: LostBoyzVP13 folded before Flop (didn't bet)
Seat 6: Brdz1 showed [7c Ac] and won ($3.83) with a pair of Sevens


PokerStars Hand #231308379675:  Hold'em No Limit ($0.25/$0.50 USD) - 2021/11/11 0:24:56 ET
Table 'Kiangsu' 6-max Seat #5 is the button
Seat 1: Hygucmek ($52.36 in chips)
Seat 2: Yagomooca ($80.96 in chips)
Seat 4: thomassnkr ($83.95 in chips)
Seat 5: LostBoyzVP13 ($30.61 in chips)
Seat 6: Brdz1 ($60.08 in chips)
Brdz1: posts small blind $0.25
Hygucmek: posts big blind $0.50
blistein: sits out
*** HOLE CARDS ***
Yagomooca: folds
thomassnkr: calls $0.50
LostBoyzVP13: raises $1.50 to $2
Brdz1: folds
Hygucmek: folds
thomassnkr: calls $1.50
*** FLOP *** [2h 9c 9s]
thomassnkr: checks
LostBoyzVP13: checks
*** TURN *** [2h 9c 9s] [Ks]
thomassnkr: checks
LostBoyzVP13: checks
*** RIVER *** [2h 9c 9s Ks] [6h]
thomassnkr: checks
LostBoyzVP13: checks
*** SHOW DOWN ***
thomassnkr: shows [6c 7h] (two pair, Nines and Sixes)
LostBoyzVP13: mucks hand
thomassnkr collected $4.51 from pot
*** SUMMARY ***
Total pot $4.75 | Rake $0.24
Board [2h 9c 9s Ks 6h]
Seat 1: Hygucmek (big blind) folded before Flop
Seat 2: Yagomooca folded before Flop (didn't bet)
Seat 4: thomassnkr showed [6c 7h] and won ($4.51) with two pair, Nines and Sixes
Seat 5: LostBoyzVP13 (button) mucked
Seat 6: Brdz1 (small blind) folded before Flop


PokerStars Hand #231308407714:  Hold'em No Limit ($0.25/$0.50 USD) - 2021/11/11 0:28:19 ET
Table 'Kiangsu' 6-max Seat #5 is the button
Seat 1: Hygucmek ($51.61 in chips)
Seat 2: Yagomooca ($83.20 in chips)
Seat 3: blistein ($51.16 in chips)
Seat 4: thomassnkr ($82.71 in chips)
Seat 5: LostBoyzVP13 ($26.06 in chips)
Seat 6: Brdz1 ($62.58 in chips)
Brdz1: posts small blind $0.25
Hygucmek: posts big blind $0.50
*** HOLE CARDS ***
Yagomooca: folds
blistein: folds
thomassnkr: calls $0.50
LostBoyzVP13: calls $0.50
Brdz1: raises $2 to $2.50
Hygucmek: folds
thomassnkr: calls $2
LostBoyzVP13: calls $2
*** FLOP *** [9h 4c Qd]
Brdz1: checks
thomassnkr: bets $5
LostBoyzVP13: calls $5
Brdz1: folds
*** TURN *** [9h 4c Qd] [5d]
thomassnkr: checks
LostBoyzVP13: checks
*** RIVER *** [9h 4c Qd 5d] [7d]
thomassnkr: checks
LostBoyzVP13: checks
*** SHOW DOWN ***
thomassnkr: shows [Qh Ad] (a pair of Queens)
LostBoyzVP13: mucks hand
thomassnkr collected $17.10 from pot
*** SUMMARY ***
Total pot $18 | Rake $0.90
Board [9h 4c Qd 5d 7d]
Seat 1: Hygucmek (big blind) folded before Flop
Seat 2: Yagomooca folded before Flop (didn't bet)
Seat 3: blistein folded before Flop (didn't bet)
Seat 4: thomassnkr showed [Qh Ad] and won ($17.10) with a pair of Queens
Seat 5: LostBoyzVP13 (button) mucked
Seat 6: Brdz1 (small blind) folded on the Flop


PokerStars Hand #231308951226:  Hold'em No Limit ($0.25/$0.50 USD) - 2021/11/11 1:33:02 ET
Table 'Kiangsu' 6-max Seat #5 is the button
Seat 1: ciggs&beer ($51.22 in chips)
Seat 2: blistein ($53.41 in chips)
Seat 3: nastja336 ($50.75 in chips)
Seat 4: Demon39888 ($51.50 in chips)
Seat 5: aki--21_GG ($37 in chips)
Seat 6: CJC97 ($50 in chips)
CJC97: posts small blind $0.25
ciggs&beer: posts big blind $0.50
*** HOLE CARDS ***
blistein: raises $1 to $1.50
nastja336: folds
Demon39888: folds
aki--21_GG: calls $1.50
CJC97: folds
ciggs&beer: calls $1
*** FLOP *** [5s 6s 7c]
ciggs&beer: checks
blistein: bets $1.50
aki--21_GG: folds
ciggs&beer: calls $1.50
*** TURN *** [5s 6s 7c] [9h]
ciggs&beer: checks
blistein: checks
*** RIVER *** [5s 6s 7c 9h] [Qd]
ciggs&beer: checks
blistein: checks
*** SHOW DOWN ***
ciggs&beer: shows [4h 7h] (a pair of Sevens)
blistein: shows [As 7s] (a pair of Sevens - Ace kicker)
blistein collected $7.36 from pot
*** SUMMARY ***
Total pot $7.75 | Rake $0.39
Board [5s 6s 7c 9h Qd]
Seat 1: ciggs&beer (big blind) showed [4h 7h] and lost with a pair of Sevens
Seat 2: blistein showed [As 7s] and won ($7.36) with a pair of Sevens
Seat 3: nastja336 folded before Flop (didn't bet)
Seat 4: Demon39888 folded before Flop (didn't bet)
Seat 5: aki--21_GG (button) folded on the Flop
Seat 6: CJC97 (small blind) folded before Flop


PokerStars Hand #231308988933:  Hold'em No Limit ($0.25/$0.50 USD) - 2021/11/11 1:37:42 ET
Table 'Kiangsu' 6-max Seat #1 is the button
Seat 1: ciggs&beer ($47.22 in chips)
Seat 2: blistein ($54.52 in chips)
Seat 4: Demon39888 ($50.30 in chips)
Seat 5: aki--21_GG ($42.09 in chips)
Seat 6: CJC97 ($50 in chips)
blistein: posts small blind $0.25
Demon39888: posts big blind $0.50
*** HOLE CARDS ***
aki--21_GG: calls $0.50
CJC97: folds
ciggs&beer: folds
blistein: raises $2 to $2.50
Demon39888: folds
aki--21_GG: calls $2
*** FLOP *** [9h 8c 9s]
blistein: checks
aki--21_GG: bets $0.50
blistein: calls $0.50
*** TURN *** [9h 8c 9s] [5s]
blistein: checks
aki--21_GG: checks
*** RIVER *** [9h 8c 9s 5s] [Ts]
blistein: checks
aki--21_GG: checks
*** SHOW DOWN ***
blistein: shows [Ah Js] (a pair of Nines)
aki--21_GG: mucks hand
blistein collected $6.18 from pot
*** SUMMARY ***
Total pot $6.50 | Rake $0.32
Board [9h 8c 9s 5s Ts]
Seat 1: ciggs&beer (button) folded before Flop (didn't bet)
Seat 2: blistein (small blind) showed [Ah Js] and won ($6.18) with a pair of Nines
Seat 4: Demon39888 (big blind) folded before Flop
Seat 5: aki--21_GG mucked
Seat 6: CJC97 folded before Flop (didn't bet)


PokerStars Hand #231308996941:  Hold'em No Limit ($0.25/$0.50 USD) - 2021/11/11 1:38:41 ET
Table 'Kiangsu' 6-max Seat #4 is the button
Seat 1: ciggs&beer ($47.22 in chips)
Seat 2: blistein ($57.70 in chips)
Seat 4: Demon39888 ($50.50 in chips)
Seat 5: aki--21_GG ($38.59 in chips)
Seat 6: CJC97 ($50 in chips)
aki--21_GG: posts small blind $0.25
CJC97: posts big blind $0.50
*** HOLE CARDS ***
ciggs&beer: folds
blistein: folds
Demon39888: raises $0.70 to $1.20
aki--21_GG: calls $0.95
CJC97: calls $0.70
*** FLOP *** [2c Ah Qh]
aki--21_GG: bets $1.71
CJC97: folds
Demon39888: raises $3.42 to $5.13
aki--21_GG: calls $3.42
*** TURN *** [2c Ah Qh] [4c]
aki--21_GG: checks
Demon39888: bets $6.59
aki--21_GG: calls $6.59
*** RIVER *** [2c Ah Qh 4c] [Ts]
aki--21_GG: checks
Demon39888: checks
*** SHOW DOWN ***
aki--21_GG: shows [Th 7h] (a pair of Tens)
Demon39888: shows [Qd 7s] (a pair of Queens)
Demon39888 collected $25.69 from pot
*** SUMMARY ***
Total pot $27.04 | Rake $1.35
Board [2c Ah Qh 4c Ts]
Seat 1: ciggs&beer folded before Flop (didn't bet)
Seat 2: blistein folded before Flop (didn't bet)
Seat 4: Demon39888 (button) showed [Qd 7s] and won ($25.69) with a pair of Queens
Seat 5: aki--21_GG (small blind) showed [Th 7h] and lost with a pair of Tens
Seat 6: CJC97 (big blind) folded on the Flop


PokerStars Hand #231309822605:  Hold'em No Limit ($0.25/$0.50 USD) - 2021/11/11 3:13:05 ET
Table 'Kiangsu' 6-max Seat #6 is the button
Seat 1: Munits61 ($41.81 in chips)
Seat 2: UMVEDER ($50 in chips)
Seat 3: hitano2020 ($51.78 in chips)
Seat 5: SuperrSicc ($78.69 in chips)
Seat 6: GunSsSeR ($59.69 in chips)
Munits61: posts small blind $0.25
UMVEDER: posts big blind $0.50
blistein: sits out
*** HOLE CARDS ***
hitano2020: folds
SuperrSicc: raises $0.75 to $1.25
GunSsSeR: folds
Munits61: calls $1
UMVEDER: folds
*** FLOP *** [Tc 7s Qc]
Munits61: checks
SuperrSicc: checks
*** TURN *** [Tc 7s Qc] [4s]
Munits61: checks
SuperrSicc: checks
*** RIVER *** [Tc 7s Qc 4s] [Qd]
Munits61: bets $0.50
SuperrSicc: calls $0.50
*** SHOW DOWN ***
Munits61: shows [2c As] (a pair of Queens)
SuperrSicc: shows [2d 2h] (two pair, Queens and Deuces)
SuperrSicc collected $3.80 from pot
*** SUMMARY ***
Total pot $4 | Rake $0.20
Board [Tc 7s Qc 4s Qd]
Seat 1: Munits61 (small blind) showed [2c As] and lost with a pair of Queens
Seat 2: UMVEDER (big blind) folded before Flop
Seat 3: hitano2020 folded before Flop (didn't bet)
Seat 5: SuperrSicc showed [2d 2h] and won ($3.80) with two pair, Queens and Deuces
Seat 6: GunSsSeR (button) folded before Flop (didn't bet)


PokerStars Hand #231309840910:  Hold'em No Limit ($0.25/$0.50 USD) - 2021/11/11 3:15:04 ET
Table 'Kiangsu' 6-max Seat #4 is the button
Seat 1: Munits61 ($52.52 in chips)
Seat 2: UMVEDER ($50 in chips)
Seat 3: hitano2020 ($51.03 in chips)
Seat 4: blistein ($55.95 in chips)
Seat 5: SuperrSicc ($80.99 in chips)
Seat 6: GunSsSeR ($58.44 in chips)
SuperrSicc: posts small blind $0.25
GunSsSeR: posts big blind $0.50
*** HOLE CARDS ***
Munits61: raises $1 to $1.50
UMVEDER: folds
hitano2020: calls $1.50
blistein: calls $1.50
SuperrSicc: raises $6.25 to $7.75
GunSsSeR: folds
Munits61: calls $6.25
hitano2020: folds
blistein: folds
*** FLOP *** [Jd Ks 5d]
SuperrSicc: checks
Munits61: checks
*** TURN *** [Jd Ks 5d] [6s]
SuperrSicc: bets $5.60
Munits61: calls $5.60
*** RIVER *** [Jd Ks 5d 6s] [Kh]
SuperrSicc: checks
Munits61: checks
*** SHOW DOWN ***
SuperrSicc: shows [Qh Qs] (two pair, Kings and Queens)
Munits61: mucks hand
SuperrSicc collected $28.69 from pot
*** SUMMARY ***
Total pot $30.20 | Rake $1.51
Board [Jd Ks 5d 6s Kh]
Seat 1: Munits61 mucked
Seat 2: UMVEDER folded before Flop (didn't bet)
Seat 3: hitano2020 folded before Flop
Seat 4: blistein (button) folded before Flop
Seat 5: SuperrSicc (small blind) showed [Qh Qs] and won ($28.69) with two pair, Kings and Queens
Seat 6: GunSsSeR (big blind) folded before Flop


PokerStars Hand #231309874831:  Hold'em No Limit ($0.25/$0.50 USD) - 2021/11/11 3:18:43 ET
Table 'Kiangsu' 6-max Seat #2 is the button
Seat 1: Munits61 ($48.07 in chips)
Seat 2: UMVEDER ($50 in chips)
Seat 3: hitano2020 ($49.03 in chips)
Seat 5: SuperrSicc ($96.33 in chips)
Seat 6: GunSsSeR ($57.69 in chips)
hitano2020: posts small blind $0.25
blistein: is sitting out
SuperrSicc: posts big blind $0.50
*** HOLE CARDS ***
blistein leaves the table
GunSsSeR: folds
SGralex joins the table at seat #4
Munits61: raises $1.25 to $1.75
UMVEDER: folds
hitano2020: calls $1.50
SuperrSicc: folds
*** FLOP *** [5s Kd 9h]
hitano2020: checks
Munits61: checks
*** TURN *** [5s Kd 9h] [2d]
hitano2020: checks
Munits61: bets $1.90
hitano2020: raises $2.40 to $4.30
Munits61: calls $2.40
*** RIVER *** [5s Kd 9h 2d] [8c]
hitano2020: checks
Munits61: checks
*** SHOW DOWN ***
hitano2020: shows [8h 9s] (two pair, Nines and Eights)
Munits61: mucks hand
hitano2020 collected $11.81 from pot
*** SUMMARY ***
Total pot $12.60 | Rake $0.79
Board [5s Kd 9h 2d 8c]
Seat 1: Munits61 mucked
Seat 2: UMVEDER (button) folded before Flop (didn't bet)
Seat 3: hitano2020 (small blind) showed [8h 9s] and won ($11.81) with two pair, Nines and Eights
Seat 5: SuperrSicc (big blind) folded before Flop
Seat 6: GunSsSeR folded before Flop (didn't bet)


PokerStars Hand #218843200863:  Hold'em No Limit ($0.25/$0.50 USD) - 2020/09/27 8:55:06 ET
Table 'Ibarruri IV' 6-max Seat #5 is the button
Seat 2: rndmwn ($59.34 in chips)
Seat 3: ACnuJkee ($56.98 in chips)
Seat 4: pacior1 ($14.65 in chips)
Seat 5: Nyusziful91 ($50 in chips)
Seat 6: blistein ($50.42 in chips)
blistein: posts small blind $0.25
rndmwn: posts big blind $0.50
*** HOLE CARDS ***
ACnuJkee: folds
pacior1: raises $0.50 to $1
Nyusziful91: raises $2.25 to $3.25
blistein: folds
rndmwn: folds
pacior1: calls $2.25
*** FLOP *** [7h 4c Kc]
pacior1: bets $2.50
Nyusziful91: calls $2.50
*** TURN *** [7h 4c Kc] [7d]
pacior1: bets $8.90 and is all-in
Nyusziful91: calls $8.90
*** RIVER *** [7h 4c Kc 7d] [2d]
*** SHOW DOWN ***
pacior1: shows [Jd 8h] (a pair of Sevens)
Nyusziful91: shows [Kd Kh] (a full house, Kings full of Sevens)
Nyusziful91 collected $28.55 from pot
*** SUMMARY ***
Total pot $30.05 | Rake $1.50
Board [7h 4c Kc 7d 2d]
Seat 2: rndmwn (big blind) folded before Flop
Seat 3: ACnuJkee folded before Flop (didn't bet)
Seat 4: pacior1 showed [Jd 8h] and lost with a pair of Sevens
Seat 5: Nyusziful91 (button) showed [Kd Kh] and won ($28.55) with a full house, Kings full of Sevens
Seat 6: blistein (small blind) folded before Flop


PokerStars Hand #218843218581:  Hold'em No Limit ($0.25/$0.50 USD) - 2020/09/27 8:56:04 ET
Table 'Ibarruri IV' 6-max Seat #2 is the button
Seat 2: rndmwn ($58.59 in chips)
Seat 5: Nyusziful91 ($64.15 in chips)
Seat 6: blistein ($50.17 in chips)
Nyusziful91: posts small blind $0.25
blistein: posts big blind $0.50
*** HOLE CARDS ***
rndmwn: raises $0.75 to $1.25
Nyusziful91: folds
blistein: calls $0.75
*** FLOP *** [Jd 8d Ks]
blistein: checks
rndmwn: checks
*** TURN *** [Jd 8d Ks] [8s]
blistein: checks
rndmwn: bets $0.86
blistein: calls $0.86
*** RIVER *** [Jd 8d Ks 8s] [2s]
mVs0n joins the table at seat #3
blistein: checks
rndmwn: checks
*** SHOW DOWN ***
blistein: shows [9s Kd] (two pair, Kings and Eights)
rndmwn: mucks hand
blistein collected $4.25 from pot
*** SUMMARY ***
Total pot $4.47 | Rake $0.22
Board [Jd 8d Ks 8s 2s]
Seat 2: rndmwn (button) mucked
Seat 5: Nyusziful91 (small blind) folded before Flop
Seat 6: blistein (big blind) showed [9s Kd] and won ($4.25) with two pair, Kings and Eights


PokerStars Hand #218843262786:  Hold'em No Limit ($0.25/$0.50 USD) - 2020/09/27 8:58:11 ET
Table 'Ibarruri IV' 6-max Seat #3 is the button
Seat 2: rndmwn ($55.23 in chips)
Seat 3: mVs0n ($50 in chips)
Seat 4: pacior1 ($22.70 in chips)
Seat 5: Nyusziful91 ($65.79 in chips)
Seat 6: blistein ($52.06 in chips)
pacior1: posts small blind $0.25
Nyusziful91: posts big blind $0.50
*** HOLE CARDS ***
blistein: folds
rndmwn: folds
mVs0n: raises $1 to $1.50
pacior1: calls $1.25
Nyusziful91: folds
*** FLOP *** [9d 6c Ts]
pacior1: bets $2
mVs0n: calls $2
*** TURN *** [9d 6c Ts] [Th]
pacior1: bets $4
mVs0n: calls $4
*** RIVER *** [9d 6c Ts Th] [7s]
pacior1: bets $8
mVs0n: calls $8
*** SHOW DOWN ***
pacior1: shows [3d 3h] (two pair, Tens and Threes)
mVs0n: shows [Ac As] (two pair, Aces and Tens)
mVs0n collected $29.92 from pot
*** SUMMARY ***
Total pot $31.50 | Rake $1.58
Board [9d 6c Ts Th 7s]
Seat 2: rndmwn folded before Flop (didn't bet)
Seat 3: mVs0n (button) showed [Ac As] and won ($29.92) with two pair, Aces and Tens
Seat 4: pacior1 (small blind) showed [3d 3h] and lost with two pair, Tens and Threes
Seat 5: Nyusziful91 (big blind) folded before Flop
Seat 6: blistein folded before Flop (didn't bet)


PokerStars Hand #218843294917:  Hold'em No Limit ($0.25/$0.50 USD) - 2020/09/27 8:59:57 ET
Table 'Ibarruri IV' 6-max Seat #6 is the button
Seat 2: rndmwn ($54.73 in chips)
Seat 3: mVs0n ($64.42 in chips)
Seat 4: pacior1 ($8.70 in chips)
Seat 5: Nyusziful91 ($65.04 in chips)
Seat 6: blistein ($51.31 in chips)
rndmwn: posts small blind $0.25
mVs0n: posts big blind $0.50
*** HOLE CARDS ***
pacior1: raises $1 to $1.50
Ireful joins the table at seat #1
Ireful leaves the table
Nyusziful91: folds
blistein: folds
rndmwn: raises $7.75 to $9.25
mVs0n: folds
max21rus1988 joins the table at seat #1
pacior1: calls $7.20 and is all-in
Uncalled bet ($0.55) returned to rndmwn
*** FLOP *** [Td 2s 2d]
*** TURN *** [Td 2s 2d] [Qs]
*** RIVER *** [Td 2s 2d Qs] [2c]
*** SHOW DOWN ***
rndmwn: shows [Jd Jc] (a full house, Deuces full of Jacks)
pacior1: shows [Ad Th] (a full house, Deuces full of Tens)
rndmwn cashed out the hand for $11.97 | Cash Out Fee $0.12
*** SUMMARY ***
Total pot $17.90 | Rake $0.90
Board [Td 2s 2d Qs 2c]
Seat 2: rndmwn (small blind) showed [Jd Jc] and won ($17) with a full house, Deuces full of Jacks (pot not awarded as player cashed out)
Seat 3: mVs0n (big blind) folded before Flop
Seat 4: pacior1 showed [Ad Th] and lost with a full house, Deuces full of Tens
Seat 5: Nyusziful91 folded before Flop (didn't bet)
Seat 6: blistein (button) folded before Flop (didn't bet)


PokerStars Hand #218843326062:  Hold'em No Limit ($0.25/$0.50 USD) - 2020/09/27 9:01:33 ET
Table 'Ibarruri IV' 6-max Seat #5 is the button
Seat 1: DimaTka4enko ($50 in chips)
Seat 2: rndmwn ($58 in chips)
Seat 3: mVs0n ($64.42 in chips)
Seat 5: Nyusziful91 ($64.29 in chips)
Seat 6: blistein ($51.56 in chips)
blistein: posts small blind $0.25
DimaTka4enko: posts big blind $0.50
pacior1: sits out
*** HOLE CARDS ***
rndmwn: raises $0.75 to $1.25
mVs0n: folds
Nyusziful91: folds
blistein: folds
DimaTka4enko: calls $0.75
*** FLOP *** [2c 8s Qs]
DimaTka4enko: checks
rndmwn: bets $0.86
DimaTka4enko: calls $0.86
*** TURN *** [2c 8s Qs] [7d]
DimaTka4enko: checks
rndmwn: checks
*** RIVER *** [2c 8s Qs 7d] [9c]
DimaTka4enko: checks
rndmwn: bets $2.98
DimaTka4enko: calls $2.98
*** SHOW DOWN ***
rndmwn: shows [Tc Jc] (a straight, Eight to Queen)
DimaTka4enko: mucks hand
rndmwn collected $9.91 from pot
*** SUMMARY ***
Total pot $10.43 | Rake $0.52
Board [2c 8s Qs 7d 9c]
Seat 1: DimaTka4enko (big blind) mucked
Seat 2: rndmwn showed [Tc Jc] and won ($9.91) with a straight, Eight to Queen
Seat 3: mVs0n folded before Flop (didn't bet)
Seat 5: Nyusziful91 (button) folded before Flop (didn't bet)
Seat 6: blistein (small blind) folded before Flop


PokerStars Hand #218843523359:  Hold'em No Limit ($0.25/$0.50 USD) - 2020/09/27 9:10:08 ET
Table 'Ibarruri IV' 6-max Seat #1 is the button
Seat 1: DimaTka4enko ($56.39 in chips)
Seat 2: Godlike1379 ($50 in chips)
Seat 3: mVs0n ($62.92 in chips)
Seat 4: pacior1 ($27.07 in chips)
Seat 5: Nyusziful91 ($56.29 in chips)
Seat 6: blistein ($50.61 in chips)
Godlike1379: posts small blind $0.25
mVs0n: posts big blind $0.50
*** HOLE CARDS ***
pacior1: raises $1 to $1.50
Nyusziful91: folds
blistein: folds
DimaTka4enko: folds
Godlike1379: folds
mVs0n: raises $4.50 to $6
pacior1: calls $4.50
*** FLOP *** [2h 7h 4h]
mVs0n: checks
pacior1: bets $5
mVs0n: calls $5
*** TURN *** [2h 7h 4h] [4s]
mVs0n: checks
pacior1: bets $5
mVs0n: calls $5
*** RIVER *** [2h 7h 4h 4s] [2c]
mVs0n: checks
pacior1: checks
*** SHOW DOWN ***
mVs0n: shows [Kh Ac] (two pair, Fours and Deuces)
pacior1: shows [5h 5d] (two pair, Fives and Fours)
pacior1 collected $30.64 from pot
*** SUMMARY ***
Total pot $32.25 | Rake $1.61
Board [2h 7h 4h 4s 2c]
Seat 1: DimaTka4enko (button) folded before Flop (didn't bet)
Seat 2: Godlike1379 (small blind) folded before Flop
Seat 3: mVs0n (big blind) showed [Kh Ac] and lost with two pair, Fours and Deuces
Seat 4: pacior1 showed [5h 5d] and won ($30.64) with two pair, Fives and Fours
Seat 5: Nyusziful91 folded before Flop (didn't bet)
Seat 6: blistein folded before Flop (didn't bet)


PokerStars Hand #218843559842:  Hold'em No Limit ($0.25/$0.50 USD) - 2020/09/27 9:11:42 ET
Table 'Ibarruri IV' 6-max Seat #2 is the button
Seat 1: DimaTka4enko ($56.39 in chips)
Seat 2: Godlike1379 ($50 in chips)
Seat 3: mVs0n ($50 in chips)
Seat 4: pacior1 ($41.71 in chips)
Seat 5: Nyusziful91 ($56.29 in chips)
Seat 6: blistein ($50.61 in chips)
mVs0n: posts small blind $0.25
pacior1: posts big blind $0.50
*** HOLE CARDS ***
Nyusziful91: folds
blistein: folds
DimaTka4enko: folds
Godlike1379: raises $0.74 to $1.24
mVs0n: calls $0.99
pacior1: calls $0.74
*** FLOP *** [6h Tc Kc]
mVs0n: checks
pacior1: bets $3
Godlike1379: folds
mVs0n: raises $6 to $9
pacior1: calls $6
*** TURN *** [6h Tc Kc] [6s]
mVs0n: bets $7.50
pacior1: raises $7.50 to $15
mVs0n: calls $7.50
*** RIVER *** [6h Tc Kc 6s] [5s]
mVs0n: checks
pacior1: checks
*** SHOW DOWN ***
mVs0n: shows [6c 6d] (four of a kind, Sixes)
pacior1: mucks hand
mVs0n collected $49.72 from pot
*** SUMMARY ***
Total pot $51.72 | Rake $2
Board [6h Tc Kc 6s 5s]
Seat 1: DimaTka4enko folded before Flop (didn't bet)
Seat 2: Godlike1379 (button) folded on the Flop
Seat 3: mVs0n (small blind) showed [6c 6d] and won ($49.72) with four of a kind, Sixes
Seat 4: pacior1 (big blind) mucked
Seat 5: Nyusziful91 folded before Flop (didn't bet)
Seat 6: blistein folded before Flop (didn't bet)


PokerStars Hand #218843632794:  Hold'em No Limit ($0.25/$0.50 USD) - 2020/09/27 9:14:50 ET
Table 'Ibarruri IV' 6-max Seat #4 is the button
Seat 1: DimaTka4enko ($56.39 in chips)
Seat 2: Godlike1379 ($50 in chips)
Seat 3: mVs0n ($74.48 in chips)
Seat 4: pacior1 ($20.97 in chips)
Seat 5: Nyusziful91 ($51.29 in chips)
Seat 6: blistein ($50.61 in chips)
Nyusziful91: posts small blind $0.25
blistein: posts big blind $0.50
*** HOLE CARDS ***
DimaTka4enko: folds
DimaTka4enko leaves the table
Godlike1379: folds
mVs0n: raises $0.85 to $1.35
pacior1: calls $1.35
Gaben ICM joins the table at seat #1
Nyusziful91: folds
blistein: folds
*** FLOP *** [9h Js 2c]
mVs0n: bets $1.08
pacior1: raises $1.08 to $2.16
Gaben ICM leaves the table
mVs0n: calls $1.08
*** TURN *** [9h Js 2c] [Jd]
Icefire00627 joins the table at seat #1
mVs0n: checks
pacior1: bets $2.50
mVs0n: calls $2.50
*** RIVER *** [9h Js 2c Jd] [Kc]
mVs0n: checks
pacior1: checks
*** SHOW DOWN ***
mVs0n: shows [8d 8c] (two pair, Jacks and Eights)
pacior1: shows [Ah 9d] (two pair, Jacks and Nines)
pacior1 collected $12.13 from pot
*** SUMMARY ***
Total pot $12.77 | Rake $0.64
Board [9h Js 2c Jd Kc]
Seat 1: DimaTka4enko folded before Flop (didn't bet)
Seat 2: Godlike1379 folded before Flop (didn't bet)
Seat 3: mVs0n showed [8d 8c] and lost with two pair, Jacks and Eights
Seat 4: pacior1 (button) showed [Ah 9d] and won ($12.13) with two pair, Jacks and Nines
Seat 5: Nyusziful91 (small blind) folded before Flop
Seat 6: blistein (big blind) folded before Flop


PokerStars Hand #218843651131:  Hold'em No Limit ($0.25/$0.50 USD) - 2020/09/27 9:15:36 ET
Table 'Ibarruri IV' 6-max Seat #5 is the button
Seat 1: Icefire00627 ($50 in chips)
Seat 2: Godlike1379 ($50 in chips)
Seat 3: mVs0n ($68.47 in chips)
Seat 4: pacior1 ($27.09 in chips)
Seat 5: Nyusziful91 ($51.04 in chips)
Seat 6: blistein ($50.11 in chips)
blistein: posts small blind $0.25
Icefire00627: posts big blind $0.50
*** HOLE CARDS ***
Godlike1379 has timed out
Godlike1379: folds
mVs0n: raises $1 to $1.50
pacior1: calls $1.50
Nyusziful91: folds
blistein: folds
Icefire00627: folds
*** FLOP *** [Js Ad 4d]
mVs0n: bets $1.17
pacior1: raises $1.17 to $2.34
mVs0n: calls $1.17
*** TURN *** [Js Ad 4d] [Ks]
mVs0n: bets $2.50
pacior1: calls $2.50
*** RIVER *** [Js Ad 4d Ks] [Tc]
mVs0n: checks
pacior1: bets $5
mVs0n: calls $5
*** SHOW DOWN ***
pacior1: shows [Jh Qd] (a straight, Ten to Ace)
mVs0n: mucks hand
pacior1 collected $22.26 from pot
*** SUMMARY ***
Total pot $23.43 | Rake $1.17
Board [Js Ad 4d Ks Tc]
Seat 1: Icefire00627 (big blind) folded before Flop
Seat 2: Godlike1379 folded before Flop (didn't bet)
Seat 3: mVs0n mucked
Seat 4: pacior1 showed [Jh Qd] and won ($22.26) with a straight, Ten to Ace
Seat 5: Nyusziful91 (button) folded before Flop (didn't bet)
Seat 6: blistein (small blind) folded before Flop


PokerStars Hand #218843721578:  Hold'em No Limit ($0.25/$0.50 USD) - 2020/09/27 9:18:37 ET
Table 'Ibarruri IV' 6-max Seat #2 is the button
Seat 1: Icefire00627 ($50 in chips)
Seat 2: Godlike1379 ($50 in chips)
Seat 3: mVs0n ($56.63 in chips)
Seat 4: pacior1 ($44.49 in chips)
Seat 5: Nyusziful91 ($51.04 in chips)
Seat 6: blistein ($50 in chips)
mVs0n: posts small blind $0.25
pacior1: posts big blind $0.50
*** HOLE CARDS ***
Nyusziful91: folds
blistein: folds
Icefire00627: raises $0.75 to $1.25
Godlike1379: folds
mVs0n: calls $1
pacior1: calls $0.75
*** FLOP *** [Jc Jd 3d]
mVs0n: bets $1.78
pacior1: calls $1.78
Icefire00627: calls $1.78
*** TURN *** [Jc Jd 3d] [3s]
mVs0n: bets $4
pacior1: folds
Icefire00627: calls $4
*** RIVER *** [Jc Jd 3d 3s] [8c]
mVs0n: checks
Icefire00627: checks
*** SHOW DOWN ***
mVs0n: shows [5d 5c] (two pair, Jacks and Fives)
Icefire00627: shows [7h 7d] (two pair, Jacks and Sevens)
Icefire00627 collected $16.24 from pot
*** SUMMARY ***
Total pot $17.09 | Rake $0.85
Board [Jc Jd 3d 3s 8c]
Seat 1: Icefire00627 showed [7h 7d] and won ($16.24) with two pair, Jacks and Sevens
Seat 2: Godlike1379 (button) folded before Flop (didn't bet)
Seat 3: mVs0n (small blind) showed [5d 5c] and lost with two pair, Jacks and Fives
Seat 4: pacior1 (big blind) folded on the Turn
Seat 5: Nyusziful91 folded before Flop (didn't bet)
Seat 6: blistein folded before Flop (didn't bet)


PokerStars Hand #218843819172:  Hold'em No Limit ($0.25/$0.50 USD) - 2020/09/27 9:22:44 ET
Table 'Ibarruri IV' 6-max Seat #1 is the button
Seat 1: Icefire00627 ($62.93 in chips)
Seat 2: Godlike1379 ($50 in chips)
Seat 3: mVs0n ($50 in chips)
Seat 4: pacior1 ($37.96 in chips)
Seat 5: Nyusziful91 ($52.64 in chips)
Seat 6: blistein ($50 in chips)
Godlike1379: posts small blind $0.25
mVs0n: posts big blind $0.50
*** HOLE CARDS ***
pacior1: calls $0.50
Nyusziful91: folds
blistein: raises $1.50 to $2
Icefire00627: folds
Godlike1379: folds
mVs0n: folds
pacior1: calls $1.50
*** FLOP *** [6d Tc 6s]
pacior1: checks
blistein: bets $1.58
pacior1: calls $1.58
*** TURN *** [6d Tc 6s] [3d]
pacior1: checks
blistein: checks
*** RIVER *** [6d Tc 6s 3d] [5s]
pacior1: bets $4
blistein: calls $4
*** SHOW DOWN ***
pacior1: shows [2d 6h] (three of a kind, Sixes)
blistein: mucks hand
pacior1 collected $15.11 from pot
*** SUMMARY ***
Total pot $15.91 | Rake $0.80
Board [6d Tc 6s 3d 5s]
Seat 1: Icefire00627 (button) folded before Flop (didn't bet)
Seat 2: Godlike1379 (small blind) folded before Flop
Seat 3: mVs0n (big blind) folded before Flop
Seat 4: pacior1 showed [2d 6h] and won ($15.11) with three of a kind, Sixes
Seat 5: Nyusziful91 folded before Flop (didn't bet)
Seat 6: blistein mucked


PokerStars Hand #229943658441:  Hold'em No Limit ($0.25/$0.50 USD) - 2021/09/18 6:45:53 ET
Table 'Chloe III' 6-max Seat #4 is the button
Seat 1: CJC97 ($61.02 in chips)
Seat 2: neopasnoo ($70.80 in chips)
Seat 3: ishuha ($51.09 in chips)
Seat 4: razukhin ($67.94 in chips)
Seat 5: bgarrett1994 ($56.88 in chips)
bgarrett1994: posts small blind $0.25
CJC97: posts big blind $0.50
*** HOLE CARDS ***
neopasnoo: folds
ishuha: raises $0.75 to $1.25
razukhin: folds
uman_da_guru leaves the table
bgarrett1994: folds
blistein joins the table at seat #6
CJC97: calls $0.75
*** FLOP *** [7s 6d 5s]
CJC97: checks
ishuha: checks
*** TURN *** [7s 6d 5s] [As]
CJC97: checks
ishuha: checks
*** RIVER *** [7s 6d 5s As] [Jh]
CJC97: checks
ishuha: checks
*** SHOW DOWN ***
CJC97: shows [Qc Jc] (a pair of Jacks)
ishuha: mucks hand
CJC97 collected $2.61 from pot
*** SUMMARY ***
Total pot $2.75 | Rake $0.14
Board [7s 6d 5s As Jh]
Seat 1: CJC97 (big blind) showed [Qc Jc] and won ($2.61) with a pair of Jacks
Seat 2: neopasnoo folded before Flop (didn't bet)
Seat 3: ishuha mucked
Seat 4: razukhin (button) folded before Flop (didn't bet)
Seat 5: bgarrett1994 (small blind) folded before Flop


PokerStars Hand #229943704069:  Hold'em No Limit ($0.25/$0.50 USD) - 2021/09/18 6:49:15 ET
Table 'Chloe III' 6-max Seat #6 is the button
Seat 1: CJC97 ($62.38 in chips)
Seat 3: ishuha ($50 in chips)
Seat 4: razukhin ($64.19 in chips)
Seat 5: bgarrett1994 ($58.19 in chips)
Seat 6: blistein ($62.56 in chips)
CJC97: posts small blind $0.25
neopasnoo: is sitting out
ishuha: posts big blind $0.50
*** HOLE CARDS ***
razukhin: raises $0.75 to $1.25
bgarrett1994: folds
blistein: calls $1.25
CJC97: folds
ishuha: calls $0.75
*** FLOP *** [6s Ks 2h]
ishuha: bets $2.66
razukhin: folds
neopasnoo leaves the table
blistein: calls $2.66
*** TURN *** [6s Ks 2h] [2d]
ishuha: bets $3.98
blistein: calls $3.98
*** RIVER *** [6s Ks 2h 2d] [4d]
wizard782 joins the table at seat #2
ishuha: checks
blistein: bets $8.54
ishuha: calls $8.54
*** SHOW DOWN ***
blistein: shows [6d 6h] (a full house, Sixes full of Deuces)
ishuha: mucks hand
blistein collected $32.64 from pot
*** SUMMARY ***
Total pot $34.36 | Rake $1.72
Board [6s Ks 2h 2d 4d]
Seat 1: CJC97 (small blind) folded before Flop
Seat 3: ishuha (big blind) mucked
Seat 4: razukhin folded on the Flop
Seat 5: bgarrett1994 folded before Flop (didn't bet)
Seat 6: blistein (button) showed [6d 6h] and won ($32.64) with a full house, Sixes full of Deuces


PokerStars Hand #225685730009:  Hold'em No Limit ($0.25/$0.50 USD) - 2021/04/10 3:58:47 ET
Table 'Sceptrum' 6-max Seat #2 is the button
Seat 1: muzy45 ($51.50 in chips)
Seat 2: Str8ShooterX ($43.55 in chips)
Seat 3: khrisanfov ($61.59 in chips)
Seat 5: YZF_AJ ($26.73 in chips)
Seat 6: secco172 ($13.26 in chips)
khrisanfov: posts small blind $0.25
YZF_AJ: posts big blind $0.50
*** HOLE CARDS ***
secco172: raises $0.50 to $1
muzy45: folds
Str8ShooterX: calls $1
khrisanfov: calls $0.75
YZF_AJ: folds
*** FLOP *** [3c 7s Ts]
khrisanfov: checks
secco172: bets $1.66
blistein joins the table at seat #4
Str8ShooterX: calls $1.66
khrisanfov: folds
*** TURN *** [3c 7s Ts] [3h]
secco172: checks
Str8ShooterX: checks
*** RIVER *** [3c 7s Ts 3h] [Jd]
secco172: checks
Str8ShooterX: checks
*** SHOW DOWN ***
secco172: shows [Kc Qs] (a pair of Threes)
Str8ShooterX: shows [As Qh] (a pair of Threes - Ace kicker)
Str8ShooterX collected $6.48 from pot
*** SUMMARY ***
Total pot $6.82 | Rake $0.34
Board [3c 7s Ts 3h Jd]
Seat 1: muzy45 folded before Flop (didn't bet)
Seat 2: Str8ShooterX (button) showed [As Qh] and won ($6.48) with a pair of Threes
Seat 3: khrisanfov (small blind) folded on the Flop
Seat 5: YZF_AJ (big blind) folded before Flop
Seat 6: secco172 showed [Kc Qs] and lost with a pair of Threes


PokerStars Hand #228942034655:  Hold'em No Limit ($0.25/$0.50 USD) - 2021/08/09 20:00:40 ET
Table 'Kordula IV' 6-max Seat #4 is the button
Seat 1: blistein ($67.01 in chips)
Seat 2: sportivu13 ($50 in chips)
Seat 3: MuUkR ($85.12 in chips)
Seat 4: malemians ($178.88 in chips)
Seat 5: andrey Lo ($85.71 in chips)
Seat 6: zMukeha ($56.14 in chips)
andrey Lo: posts small blind $0.25
zMukeha: posts big blind $0.50
*** HOLE CARDS ***
blistein: folds
sportivu13: folds
MuUkR: folds
malemians: calls $0.50
andrey Lo: folds
zMukeha: checks
*** FLOP *** [Kh 9c 4d]
zMukeha: checks
malemians: checks
*** TURN *** [Kh 9c 4d] [6d]
zMukeha: checks
malemians: checks
*** RIVER *** [Kh 9c 4d 6d] [Ad]
zMukeha: checks
malemians: checks
*** SHOW DOWN ***
zMukeha: shows [6s Qd] (a pair of Sixes)
malemians: mucks hand
zMukeha collected $1.19 from pot
*** SUMMARY ***
Total pot $1.25 | Rake $0.06
Board [Kh 9c 4d 6d Ad]
Seat 1: blistein folded before Flop (didn't bet)
Seat 2: sportivu13 folded before Flop (didn't bet)
Seat 3: MuUkR folded before Flop (didn't bet)
Seat 4: malemians (button) mucked
Seat 5: andrey Lo (small blind) folded before Flop
Seat 6: zMukeha (big blind) showed [6s Qd] and won ($1.19) with a pair of Sixes


PokerStars Hand #228942065160:  Hold'em No Limit ($0.25/$0.50 USD) - 2021/08/09 20:02:00 ET
Table 'Kordula IV' 6-max Seat #1 is the button
Seat 1: blistein ($66.26 in chips)
Seat 2: sportivu13 ($50 in chips)
Seat 3: MuUkR ($85.12 in chips)
Seat 4: malemians ($183.45 in chips)
Seat 5: andrey Lo ($81.01 in chips)
Seat 6: zMukeha ($56.58 in chips)
sportivu13: posts small blind $0.25
MuUkR: posts big blind $0.50
*** HOLE CARDS ***
malemians: raises $0.50 to $1
andrey Lo: raises $3 to $4
zMukeha: folds
blistein: folds
sportivu13: folds
MuUkR: folds
malemians: calls $3
*** FLOP *** [3c 6c 4c]
malemians: checks
andrey Lo: bets $4.32
malemians: calls $4.32
*** TURN *** [3c 6c 4c] [6s]
malemians: checks
andrey Lo: checks
*** RIVER *** [3c 6c 4c 6s] [Ks]
malemians: bets $16.52
andrey Lo: calls $16.52
*** SHOW DOWN ***
malemians: shows [8c As] (a pair of Sixes)
andrey Lo: shows [Ac Kd] (two pair, Kings and Sixes)
andrey Lo collected $48.43 from pot
*** SUMMARY ***
Total pot $50.43 | Rake $2
Board [3c 6c 4c 6s Ks]
Seat 1: blistein (button) folded before Flop (didn't bet)
Seat 2: sportivu13 (small blind) folded before Flop
Seat 3: MuUkR (big blind) folded before Flop
Seat 4: malemians showed [8c As] and lost with a pair of Sixes
Seat 5: andrey Lo showed [Ac Kd] and won ($48.43) with two pair, Kings and Sixes
Seat 6: zMukeha folded before Flop (didn't bet)


PokerStars Hand #228942131006:  Hold'em No Limit ($0.25/$0.50 USD) - 2021/08/09 20:05:47 ET
Table 'Kordula IV' 6-max Seat #4 is the button
Seat 1: blistein ($72.23 in chips)
Seat 2: sportivu13 ($50 in chips)
Seat 3: MuUkR ($80.89 in chips)
Seat 4: malemians ($156.36 in chips)
Seat 5: andrey Lo ($103.35 in chips)
Seat 6: zMukeha ($56.58 in chips)
andrey Lo: posts small blind $0.25
zMukeha: posts big blind $0.50
*** HOLE CARDS ***
blistein: folds
sportivu13: raises $0.90 to $1.40
MuUkR: folds
malemians: calls $1.40
andrey Lo: folds
zMukeha: folds
*** FLOP *** [2s Qh Ad]
sportivu13: checks
malemians: bets $3.37
sportivu13: calls $3.37
*** TURN *** [2s Qh Ad] [9s]
sportivu13: checks
malemians: bets $5.89
sportivu13: calls $5.89
*** RIVER *** [2s Qh Ad 9s] [Qs]
sportivu13: checks
malemians: bets $20.97
sportivu13: calls $20.97
*** SHOW DOWN ***
malemians: shows [Jd 6d] (a pair of Queens)
sportivu13: shows [Ah 2h] (two pair, Aces and Queens)
sportivu13 collected $62.01 from pot
*** SUMMARY ***
Total pot $64.01 | Rake $2
Board [2s Qh Ad 9s Qs]
Seat 1: blistein folded before Flop (didn't bet)
Seat 2: sportivu13 showed [Ah 2h] and won ($62.01) with two pair, Aces and Queens
Seat 3: MuUkR folded before Flop (didn't bet)
Seat 4: malemians (button) showed [Jd 6d] and lost with a pair of Queens
Seat 5: andrey Lo (small blind) folded before Flop
Seat 6: zMukeha (big blind) folded before Flop


PokerStars Hand #228942154494:  Hold'em No Limit ($0.25/$0.50 USD) - 2021/08/09 20:06:50 ET
Table 'Kordula IV' 6-max Seat #5 is the button
Seat 1: blistein ($72.23 in chips)
Seat 2: sportivu13 ($80.38 in chips)
Seat 3: MuUkR ($80.89 in chips)
Seat 4: malemians ($124.73 in chips)
Seat 5: andrey Lo ($103.10 in chips)
Seat 6: zMukeha ($56.08 in chips)
zMukeha: posts small blind $0.25
blistein: posts big blind $0.50
*** HOLE CARDS ***
sportivu13: raises $0.90 to $1.40
MuUkR: folds
malemians: calls $1.40
andrey Lo: folds
zMukeha: folds
blistein: folds
*** FLOP *** [3s Kc Td]
sportivu13: checks
malemians: checks
*** TURN *** [3s Kc Td] [Ah]
sportivu13: checks
malemians: checks
*** RIVER *** [3s Kc Td Ah] [Qh]
sportivu13: checks
malemians: checks
*** SHOW DOWN ***
sportivu13: shows [8s 8h] (a pair of Eights)
malemians: mucks hand
sportivu13 collected $3.37 from pot
*** SUMMARY ***
Total pot $3.55 | Rake $0.18
Board [3s Kc Td Ah Qh]
Seat 1: blistein (big blind) folded before Flop
Seat 2: sportivu13 showed [8s 8h] and won ($3.37) with a pair of Eights
Seat 3: MuUkR folded before Flop (didn't bet)
Seat 4: malemians mucked
Seat 5: andrey Lo (button) folded before Flop (didn't bet)
Seat 6: zMukeha (small blind) folded before Flop
